(supertux-level
  (version 3)
  (name (_ "Via Nostalgica"))
  (author "SuperTux Team")
  (license "GPL 2+ / CC-by-sa 3.0")
  (target-time 60)
  (allow-item-pocket "inherit")
  (icon "")
  (icon-locked "")
  (statistics
    (enable-coins #t)
    (enable-secrets #t)
  )
  (sector
    (name "main")
    (ambient-light
      (color 1 1 1)
    )
    (bouncingsnowball
      (z-pos 50)
      (x 5367)
      (y 349)
      (glinting #f)
    )
    (bouncingsnowball
      (z-pos 50)
      (x 5269)
      (y 381)
      (glinting #f)
    )
    (camera
      (name "Camera")
      (mode "normal")
    )
    (firefly
      (z-pos 0)
      (x 6445)
      (y 359)
    )
    (gradient
      (top_color 0.5 0.7 1)
      (bottom_color 1 1 1)
    )
    (mrbomb
      (z-pos 50)
      (x 9398)
      (y 434)
      (glinting #f)
    )
    (mrbomb
      (z-pos 50)
      (x 4384)
      (y 530)
      (glinting #f)
    )
    (mrbomb
      (z-pos 50)
      (x 8081)
      (y 529)
      (glinting #f)
    )
    (mrbomb
      (z-pos 50)
      (x 7888)
      (y 527)
      (glinting #f)
    )
    (mriceblock
      (z-pos 50)
      (x 10464)
      (y 256)
      (glinting #f)
    )
    (mriceblock
      (z-pos 50)
      (x 3616)
      (y 288)
      (glinting #f)
    )
    (mriceblock
      (z-pos 50)
      (x 2240)
      (y 544)
      (glinting #f)
    )
    (mriceblock
      (z-pos 50)
      (x 2720)
      (y 544)
      (glinting #f)
    )
    (mriceblock
      (z-pos 50)
      (x 4224)
      (y 544)
      (glinting #f)
    )
    (mriceblock
      (z-pos 50)
      (x 4288)
      (y 544)
      (glinting #f)
    )
    (mriceblock
      (z-pos 50)
      (x 8518)
      (y 541)
      (glinting #f)
    )
    (music
      (file "music/chipdisko.ogg")
    )
    (smartball
      (z-pos 50)
      (x 6075)
      (y 539)
      (glinting #f)
    )
    (snowball
      (z-pos 50)
      (x 1037)
      (y 538)
      (glinting #f)
    )
    (snowball
      (z-pos 50)
      (x 981)
      (y 537)
      (glinting #f)
    )
    (snowball
      (z-pos 50)
      (x 3672)
      (y 539)
      (glinting #f)
    )
    (snowball
      (z-pos 50)
      (x 6199)
      (y 539)
      (glinting #f)
    )
    (snowball
      (z-pos 50)
      (x 6145)
      (y 539)
      (glinting #f)
    )
    (snowball
      (z-pos 50)
      (x 8879)
      (y 537)
      (glinting #f)
    )
    (snowball
      (z-pos 50)
      (x 8820)
      (y 538)
      (glinting #f)
    )
    (snowball
      (z-pos 50)
      (x 8752)
      (y 538)
      (glinting #f)
    )
    (snowball
      (z-pos 50)
      (x 2783)
      (y 540)
      (glinting #f)
    )
    (snowball
      (z-pos 50)
      (x 2837)
      (y 538)
      (glinting #f)
    )
    (snowball
      (z-pos 50)
      (x 7636)
      (y 531)
      (glinting #f)
    )
    (snowball
      (z-pos 50)
      (x 9112)
      (y 533)
      (glinting #f)
    )
    (snowball
      (z-pos 50)
      (x 9165)
      (y 534)
      (glinting #f)
    )
    (snowball
      (z-pos 50)
      (x 10571)
      (y 535)
      (glinting #f)
    )
    (snowball
      (z-pos 50)
      (x 10932)
      (y 536)
      (glinting #f)
    )
    (snowball
      (z-pos 50)
      (x 9969)
      (y 538)
      (glinting #f)
    )
    (spawnpoint
      (name "main")
      (x 96)
      (y 512)
    )
    (tilemap
      (solid #f)
      (z-pos -100)
      (width 390)
      (height 25)
      (tiles -2306 0 130 -389 0 129 -389 0 129 -389 0 129 -389 0 129 -389 0 129 8 -233 0 106 107 108 -387 0 109 110 111 -21 0 25 -92 0 122 123 -4 0 122 123 -379 0 122 123 0 124 125 0 122 123 0 124 125 0 122 123 -341 0 25 -34 0 124 125 0 124 125 0 124 125 0 124 125 0 124 125 -70 0 122 123 -7 0 122 123 -22 0 122 123 -39 0 122 123 -181 0 122 123 -44 0 122 123 0 124 125 0 124 125 0 124 125 0 124 125 0 124 125 0 122 123 -27 0 106 107 108 -37 0 124 125 0 122 123 0 122 123 0 124 125 -19 0 122 123 0 124 125 -9 0 106 107 108 -11 0 106 107 108 -10 0 122 123 0 124 125 0 122 123 -23 0 106 107 108 -38 0 106 107 108 -34 0 106 107 108 -58 0 106 107 108 -10 0 122 123 0 124 125 0 122 123 -15 0 2062 2051 2070 2058 2066 2065 2066 2050 2064 -17 0 124 125 0 124 125 0 124 125 0 124 125 0 124 125 0 124 125 0 124 125 -27 0 109 110 111 -3 0 25 -9 0 -11 8 -6 0 24 -4 0 25 0 124 125 0 124 125 24 124 125 0 124 125 24 -4 0 24 -12 0 24 124 125 0 124 125 24 -8 0 109 110 111 -2 0 24 -8 0 109 110 111 -9 0 24 124 125 0 124 125 24 124 125 -18 0 24 -4 0 109 110 111 -12 0 25 -8 0 24 -14 0 24 0 109 110 111 -32 0 24 0 109 110 111 -21 0 25 -29 0 25 -6 0 109 110 111 -9 0 24 124 125 0 124 125 24 124 125 -16 0 2057 2058 2061 2060 2058 2060 2059 -12 0 25 -5 0 124 125 24 124 125 0 124 125 0 124 125 24 124 125 0 124 125 0 124 125 25 -369 0 124 125 -16 0 124 125 -2398 0)
    )
    (tilemap
      (solid #t)
      (z-pos 0)
      (width 390)
      (height 25)
      (tiles -1176 0 85 86 87 88 -48 0 85 86 87 88 -98 0 85 86 87 86 87 88 -134 0 85 86 87 88 -92 0 89 90 91 92 -48 0 89 90 91 92 -57 0 85 86 87 88 -37 0 89 90 91 90 91 92 -58 0 85 86 87 88 -72 0 89 90 91 92 -53 0 133 -25 0 -2 132 -124 0 89 90 91 92 -101 0 89 90 91 92 -129 0 133 -25 0 -2 132 -27 0 85 86 87 88 -40 0 85 86 87 88 -71 0 85 86 87 88 -36 0 85 86 87 88 -103 0 85 86 87 88 -65 0 133 -25 0 -2 132 -27 0 89 90 91 92 -40 0 89 90 91 92 -71 0 89 90 91 92 -29 0 44 -6 0 89 90 91 92 -103 0 89 90 91 92 -65 0 133 -25 0 -2 132 -41 0 85 86 87 88 -131 0 44 -4 0 44 -93 0 85 86 87 88 -83 0 133 -25 0 -2 132 -41 0 89 90 91 92 -53 0 85 86 87 88 -79 0 85 86 87 88 -60 0 85 86 87 88 -26 0 89 90 91 92 -44 0 -3 44 0 -3 44 -2 0 44 -29 0 133 -25 0 -2 132 -32 0 83 -65 0 89 90 91 92 -12 0 -8 78 -3 0 -5 78 83 -20 0 83 -20 0 44 -8 0 89 90 91 92 -60 0 89 90 91 92 -36 0 83 -37 0 44 -3 0 44 0 44 -2 0 44 -24 0 7 -4 8 133 9 -24 0 -2 132 -169 0 44 0 7 8 9 -9 0 44 -139 0 44 0 44 0 44 0 44 -2 0 44 -23 0 7 114 -5 14 15 -16 0 126 -7 0 -2 132 -166 0 44 0 7 -2 8 114 14 15 -31 0 7 -2 8 9 -16 0 7 9 -3 0 7 9 -91 0 44 0 44 0 44 0 44 -25 0 7 114 23 -5 11 12 -24 0 -2 132 -78 0 7 8 9 -17 0 7 8 9 -62 0 44 0 7 -2 8 114 -2 14 23 11 12 -30 0 7 114 -2 14 113 9 -14 0 7 114 15 -3 0 13 113 9 -90 0 -3 44 0 -3 44 -2 0 44 -21 0 7 114 23 -3 11 19 -2 11 12 -24 0 -2 132 -26 0 83 -3 0 77 102 77 83 77 -30 0 7 8 9 -10 0 13 14 15 -17 0 13 14 15 -10 0 77 102 77 -16 0 104 -9 0 83 103 -6 0 83 -2 0 83 -2 0 83 -7 0 7 -2 8 114 -2 14 23 -4 11 12 -11 0 44 -17 0 7 114 23 -2 11 20 113 9 -12 0 7 114 23 12 -3 0 10 20 113 9 -11 0 7 8 9 -2 0 77 83 -2 77 102 77 -3 0 7 8 9 -22 0 7 8 9 -4 0 2067 -7 2068 2069 -4 0 7 8 9 -15 0 -12 77 -19 0 7 114 23 -7 11 12 -24 0 -2 132 -55 0 7 8 9 -7 0 13 14 15 -10 0 10 11 12 -17 0 10 11 12 -61 0 13 -2 14 23 -7 11 12 -28 0 7 114 23 -4 11 20 113 9 -10 0 7 114 23 11 12 -3 0 10 11 20 113 9 -10 0 13 14 15 -11 0 13 14 15 -22 0 13 14 15 -4 0 2072 -7 2073 2074 -4 0 13 14 15 -45 0 7 114 23 -8 11 12 -24 0 -2 132 -55 0 13 14 15 -7 0 10 11 12 -10 0 10 11 12 -17 0 10 11 12 -61 0 10 -10 11 12 -27 0 7 114 23 -3 11 19 -2 11 20 113 9 -8 0 7 114 23 -2 11 12 -3 0 10 19 11 20 113 9 -9 0 10 11 12 -11 0 10 11 12 -22 0 10 11 12 -17 0 10 11 12 -44 0 7 114 23 -9 11 21 -16 8 -8 0 -2 132 -4 8 9 -50 8 22 11 21 -7 8 22 11 21 -10 8 22 11 21 -17 8 22 11 21 -3 8 9 -3 0 7 -12 8 9 -3 0 7 -36 8 22 -3 11 19 -6 11 12 -10 0 7 -16 8 114 23 -8 11 20 113 -8 8 114 23 -3 11 12 -3 0 10 -3 11 20 113 -9 8 22 11 21 -11 8 22 11 21 -22 8 22 11 21 -17 8 22 11 21 -44 8 114 23 -10 11 20 -30 14 15 -50 14 23 11 20 -7 14 23 11 20 -10 14 23 11 20 -17 14 23 11 20 -3 14 15 -3 0 13 -12 14 15 -3 0 13 -36 14 23 -10 11 12 -10 0 13 -16 14 23 -10 11 20 -8 14 23 -4 11 12 -3 0 10 -4 11 20 -9 14 23 11 20 -11 14 23 11 20 -22 14 23 11 20 -17 14 23 11 20 -44 14 23 -42 11 12 -99 11 12 -3 0 10 -12 11 12 -3 0 10 -47 11 12 -10 0 10 -41 11 12 -3 0 10 -163 11 12 -99 11 12 -3 0 10 -12 11 12 -3 0 10 -47 11 12 -10 0 10 -41 11 12 -3 0 10 -163 11 12 -99 11 12 -3 0 10 -12 11 12 -3 0 10 -47 11 12 -10 0 10 -41 11 12 -3 0 10 -163 11 12 -99 11 12 -3 0 10 -12 11 12 -3 0 10 -47 11 12 -10 0 10 -41 11 12 -3 0 10 -163 11 12 -99 11 12 -3 0 10 -12 11 12 -3 0 10 -47 11 12 -10 0 10 -41 11 12 -3 0 10 -163 11 12 -99 11 12 -3 0 10 -12 11 12 -3 0 10 -47 11 12 -10 0 10 -41 11 12 -3 0 10 -163 11 12)
    )
    (tilemap
      (solid #f)
      (z-pos 100)
      (width 390)
      (height 25)
      (tiles -2308 0 130 -389 0 129 -389 0 129 -389 0 129 -389 0 129 -389 0 129 -409 0 127 -5081 0)
    )
    (tilemap
      (solid #f)
      (speed-x 0.5)
      (speed-y 0.5)
      (z-pos -130)
      (name "background_para1")
      (width 260)
      (height 25)
      (tiles -2906 0 149 160 151 -7 0 149 160 151 -50 0 149 160 151 -7 0 149 160 151 -50 0 149 160 151 -7 0 149 160 151 -80 0 149 160 151 -7 0 149 160 151 -28 0 152 153 158 151 -6 0 152 153 158 151 -8 0 149 160 151 -7 0 149 160 151 -28 0 152 153 158 151 -6 0 152 153 158 151 -8 0 149 160 151 -7 0 149 160 151 -28 0 152 153 158 151 -6 0 152 153 158 151 -8 0 149 160 151 -8 0 149 160 151 -7 0 149 160 151 -17 0 149 160 151 -7 0 149 160 151 -17 0 152 153 158 151 -6 0 152 153 158 151 -6 0 149 160 151 -7 0 149 160 151 -7 0 149 159 -2 153 154 -5 0 149 159 -2 153 154 -8 0 152 153 158 151 -6 0 152 153 158 151 -6 0 149 160 151 -7 0 149 160 151 -7 0 149 159 -2 153 154 -5 0 149 159 -2 153 154 -8 0 152 153 158 151 -6 0 152 153 158 151 -6 0 149 160 151 -7 0 149 160 151 -7 0 149 159 -2 153 154 -5 0 149 159 -2 153 154 -8 0 152 153 158 151 -7 0 152 153 158 151 -6 0 152 153 158 151 -6 0 149 160 151 -7 0 152 153 158 151 -6 0 152 153 158 151 -6 0 149 160 151 -6 0 149 159 -2 153 154 -5 0 149 159 -2 153 154 -6 0 152 153 158 151 -6 0 152 153 158 151 -2 0 149 -3 160 159 -3 153 158 -5 160 159 -3 153 158 -3 160 151 -3 0 149 159 -2 153 154 -5 0 149 159 -2 153 154 -6 0 152 153 158 151 -6 0 152 153 158 151 -2 0 149 -3 160 159 -3 153 158 -5 160 159 -3 153 158 -3 160 151 -3 0 149 159 -2 153 154 -5 0 149 159 -2 153 154 -6 0 152 153 158 151 -6 0 152 153 158 151 -2 0 149 -3 160 159 -3 153 158 -5 160 159 -3 153 158 -3 160 151 -3 0 149 159 -2 153 154 -6 0 149 159 -2 153 154 -5 0 149 159 -2 153 154 -6 0 152 153 158 151 -5 0 149 159 -2 153 154 -5 0 149 159 -2 153 154 -6 0 152 153 158 151 0 -4 160 159 -3 153 158 -5 160 159 -3 153 158 -2 160 151 -2 0 149 159 -2 153 154 -5 0 149 159 -2 153 154 -2 0 152 -21 153 158 -3 160 159 -3 153 158 -5 160 159 -3 153 158 -2 160 151 -2 0 149 159 -2 153 154 -5 0 149 159 -2 153 154 -2 0 152 -21 153 158 -3 160 159 -3 153 158 -5 160 159 -3 153 158 -2 160 151 -2 0 149 159 -2 153 154 -5 0 149 159 -2 153 154 -2 0 152 -21 153 158 -3 160 159 -3 153 158 -6 160 159 -3 153 158 -5 160 159 -3 153 158 -2 160 151 -2 0 149 159 -2 153 154 0 149 -3 160 159 -3 153 158 -5 160 159 -3 153 158 -2 160 151 -2 0 149 159 -2 153 154 0 -21 153 158 -2 160 159 -3 153 158 -5 160 159 -3 153 158 -2 160 159 -42 153 158 -2 160 159 -3 153 158 -5 160 159 -3 153 158 -2 160 159 -42 153 158 -2 160 159 -3 153 158 -5 160 159 -3 153 158 -2 160 159 -53 153 158 -2 160 159 -3 153 158 160 159 -20 153 158 -2 160 159 -3 153 158 160 -2080 153)
    )
    (tilemap
      (solid #f)
      (speed-x 0.2)
      (speed-y 0.2)
      (z-pos -170)
      (name "background_para2")
      (width 130)
      (height 25)
      (tiles -940 0 161 163 -64 0 161 163 -7 0 161 163 -30 0 161 163 -20 0 161 171 170 163 -7 0 161 163 -36 0 161 163 -15 0 161 171 170 163 -5 0 161 171 170 163 -7 0 161 163 -19 0 161 171 170 163 -7 0 161 163 -5 0 161 -4 162 171 -2 165 170 162 163 -4 0 161 171 170 163 -12 0 161 163 -20 0 161 171 170 163 -7 0 161 163 -3 0 161 162 171 -2 165 170 -5 162 171 -2 165 170 162 163 -4 0 161 171 170 163 -12 0 -6 162 171 -2 165 170 162 163 -4 0 161 171 170 163 -4 0 164 -9 165 170 -4 162 171 -2 165 170 -4 162 163 -6 0 161 171 170 163 -7 0 161 163 -5 0 161 -4 162 171 -2 165 170 162 163 -4 0 161 171 170 163 -2 0 164 -15 165 170 -4 162 171 -2 165 170 -4 162 163 -7 0 -11 165 170 -4 162 171 -2 165 170 -4 162 171 -22 165 170 -6 162 171 -2 165 170 162 163 -4 0 161 171 170 163 -4 0 164 -9 165 170 -4 162 171 -2 165 170 -2 162 171 -28 165 170 -7 162 -59 165 170 -4 162 171 -2 165 170 -4 162 171 -1617 165)
    )
  )
)
