(supertux-level
  (version 3)
  (name (_ "Tobgle Road"))
  (author "SuperTux Team")
  (license "GPL 2+ / CC-by-sa 3.0")
  (target-time 60)
  (allow-item-pocket "inherit")
  (icon "")
  (icon-locked "")
  (statistics
    (enable-coins #t)
    (enable-secrets #t)
  )
  (sector
    (name "main")
    (ambient-light
      (color 1 1 1)
    )
    (camera
      (name "Camera")
      (mode "normal")
    )
    (firefly
      (z-pos 0)
      (x 4718)
      (y 464)
    )
    (gradient
      (top_color 0.5 0.7 1)
      (bottom_color 1 1 1)
    )
    (jumpy
      (z-pos 50)
      (x 6752)
      (y 160)
      (glinting #f)
    )
    (jumpy
      (z-pos 50)
      (x 6528)
      (y 320)
      (glinting #f)
    )
    (jumpy
      (z-pos 50)
      (x 288)
      (y 352)
      (glinting #f)
    )
    (jumpy
      (z-pos 50)
      (x 608)
      (y 352)
      (glinting #f)
    )
    (mrbomb
      (z-pos 50)
      (x 3060)
      (y 178)
      (glinting #f)
    )
    (mriceblock
      (z-pos 50)
      (x 4544)
      (y 544)
      (glinting #f)
    )
    (mriceblock
      (z-pos 50)
      (x 4848)
      (y 539)
      (glinting #f)
    )
    (mriceblock
      (z-pos 50)
      (x 5662)
      (y 540)
      (glinting #f)
    )
    (mriceblock
      (z-pos 50)
      (x 2098)
      (y 542)
      (glinting #f)
    )
    (music
      (file "music/chipdisko.ogg")
    )
    (path
      (name "gen17713485441566836282480")
      (path
        (adapt_speed #f)
        (node
          (x 6496)
          (y 416)
        )
      )
    )
    (secretarea
      (fade-tilemap "Secret")
      (width 508)
      (height 220)
      (x 6528)
      (y 480)
    )
    (smartball
      (z-pos 50)
      (x 1376)
      (y 384)
      (glinting #f)
    )
    (smartball
      (z-pos 50)
      (x 1504)
      (y 384)
      (glinting #f)
    )
    (smartball
      (z-pos 50)
      (x 3040)
      (y 416)
      (glinting #f)
    )
    (smartball
      (z-pos 50)
      (x 3968)
      (y 448)
      (glinting #f)
    )
    (snowball
      (z-pos 50)
      (x 2688)
      (y 512)
      (glinting #f)
    )
    (snowball
      (z-pos 50)
      (x 3168)
      (y 512)
      (glinting #f)
    )
    (snowball
      (z-pos 50)
      (x 2322)
      (y 539)
      (glinting #f)
    )
    (snowball
      (z-pos 50)
      (x 2219)
      (y 541)
      (glinting #f)
    )
    (snowball
      (z-pos 50)
      (x 2271)
      (y 540)
      (glinting #f)
    )
    (snowball
      (z-pos 50)
      (x 4032)
      (y 544)
      (glinting #f)
    )
    (snowball
      (z-pos 50)
      (x 5365)
      (y 541)
      (glinting #f)
    )
    (snowball
      (z-pos 50)
      (x 4992)
      (y 544)
      (glinting #f)
    )
    (snowball
      (z-pos 50)
      (x 5088)
      (y 544)
      (glinting #f)
    )
    (snowball
      (z-pos 50)
      (x 5184)
      (y 544)
      (glinting #f)
    )
    (snowball
      (z-pos 50)
      (x 5280)
      (y 544)
      (glinting #f)
    )
    (snowball
      (z-pos 50)
      (x 5886)
      (y 540)
      (glinting #f)
    )
    (snowball
      (z-pos 50)
      (x 6077)
      (y 541)
      (glinting #f)
    )
    (snowball
      (z-pos 50)
      (x 6272)
      (y 535)
      (glinting #f)
    )
    (spawnpoint
      (name "main")
      (x 64)
      (y 512)
    )
    (tilemap
      (solid #f)
      (z-pos -100)
      (name "Background")
      (width 270)
      (height 25)
      (tiles -1440 0 106 107 108 -265 0 24 0 109 110 111 -393 0 24 -535 0 -2 8 -98 0 122 123 -265 0 122 123 0 124 125 0 122 123 -132 0 122 123 -10 0 122 123 -15 0 -2 8 -29 0 130 -69 0 124 125 0 124 125 0 124 125 -129 0 122 123 0 124 125 0 122 123 -4 0 122 123 0 124 125 0 122 123 -43 0 129 -199 0 106 107 108 -4 0 124 125 0 124 125 0 124 125 -4 0 124 125 0 124 125 0 124 125 -8 0 -2 8 -16 0 122 123 -15 0 129 -136 0 -2 8 -2 0 -2 8 -57 0 109 110 111 -4 0 124 125 0 124 125 0 124 125 -4 0 124 125 0 124 125 0 124 125 -19 0 2179 2181 2189 2188 2195 2190 0 124 125 -15 0 129 -206 0 124 125 0 124 125 0 124 125 -4 0 124 125 0 124 125 0 124 125 -7 0 2192 2179 2180 2195 2187 2189 2195 -5 0 2195 2180 2179 2188 2180 2190 0 124 125 0 122 123 -12 0 129 -56 0 106 107 108 -29 0 106 107 108 -20 0 -21 8 -28 0 106 107 108 -43 0 124 125 0 124 125 0 124 125 -4 0 124 125 0 124 125 0 124 125 -7 0 2192 2179 2188 2195 2179 2181 2188 -5 0 2179 2195 2196 2195 2180 2190 0 124 125 0 124 125 0 122 123 0 122 123 -6 0 129 -31 0 25 -4 8 -20 0 109 110 111 -27 0 24 0 109 110 111 -10 0 25 -56 0 24 0 109 110 111 -11 0 24 -12 0 24 -8 0 25 -9 0 124 125 0 124 125 0 124 125 -4 0 124 125 0 124 125 0 124 125 -10 0 2196 2188 2180 2196 2197 2196 2180 2179 2189 2195 2181 2189 2180 2187 -2 0 124 125 0 124 125 24 124 125 0 124 125 0 122 123 -3 0 129 8 -10 0 25 -3 0 -10 8 -11 0 2019 -11 0 2019 -61 0 2142 -35 0 2142 -89 0 2180 2188 2197 2179 2188 2195 2188 2180 2195 2179 2180 2188 -2 2187 -46 0 2019 -9 0 2020 -11 0 2020 -61 0 2020 -35 0 2020 -89 0 2196 -2 2180 2197 2180 2189 2187 2181 2180 2196 2188 2181 2187 2189 -46 0 2020 -9 0 2020 7 -9 8 9 2020 -61 0 2020 -35 0 2020 -89 0 2187 2179 2195 2189 -2 2197 2188 2180 2188 2181 2195 2188 -48 0 2020 -9 0 2020 -11 0 2020 -61 0 2020 -35 0 2020 -89 0 2180 -2 2181 2188 -2 2197 -2 2187 2180 2189 2180 2188 -48 0 2020 -9 0 2020 -11 0 2020 -61 0 2020 -35 0 2020 -149 0 2020 -9 0 2020 -11 0 2020 -61 0 2020 -35 0 2020 -149 0 2020 -9 0 2020 -11 0 2020 -61 0 2020 -35 0 2020 -149 0 2020 -3 0)
    )
    (tilemap
      (solid #t)
      (z-pos 0)
      (width 270)
      (height 25)
      (tiles -240 0 133 -22 0 -2 132 -245 0 133 -22 0 -2 132 -245 0 133 -22 0 -2 132 -11 0 85 86 87 86 87 86 87 86 87 86 87 88 -6 0 85 86 87 88 -37 0 85 86 87 88 -171 0 133 -22 0 -2 132 -11 0 89 90 91 90 91 90 91 90 91 90 91 92 -6 0 89 90 91 92 -37 0 89 90 91 92 -171 0 133 -22 0 -2 132 -44 0 -2 44 -3 0 -2 44 -3 0 -2 44 -189 0 133 -22 0 -2 132 -44 0 27 29 -3 0 27 29 -3 0 27 29 -33 0 7 -16 8 9 -34 0 103 -103 0 133 -22 0 -2 132 -59 0 -4 78 105 -2 78 -23 0 13 -16 14 15 7 -3 8 2913 2914 -107 0 7 -4 8 9 -19 0 133 -22 0 -2 132 -39 0 -2 44 -47 0 7 22 -16 11 12 13 -3 14 2915 2916 1832 1827 -105 0 13 -4 14 15 -19 0 133 -22 0 -2 132 -18 0 44 0 44 -13 0 44 -4 0 27 29 -47 0 13 23 30 -15 17 18 10 -3 11 -2 1835 1836 1831 2917 2918 -3 8 9 -19 0 -3 44 -73 0 7 -2 44 8 22 -4 11 12 -19 0 133 -22 0 -2 132 -17 0 47 0 47 0 47 -12 0 47 -20 0 27 -2 28 29 -4 0 44 -3 0 44 -3 0 44 -3 0 44 -12 0 16 17 18 -16 0 10 -6 11 1835 2919 2920 -3 14 15 -19 0 27 28 29 -20 0 102 -52 0 13 -3 14 23 -4 11 12 -19 0 133 -22 0 -2 132 -29 0 102 -4 0 47 -48 0 7 8 9 -14 0 102 -6 0 10 -2 11 30 -9 17 18 -8 0 44 0 44 -8 0 47 -71 0 7 -2 44 8 22 -8 11 12 -19 0 133 -22 0 -2 132 -34 0 47 -8 0 2909 2910 -6 8 2913 2914 -10 0 47 -3 0 47 -3 0 47 -3 0 47 -7 0 13 14 15 -4 0 47 -16 0 16 -2 17 18 -17 0 27 -2 28 29 -8 0 47 -8 0 47 -12 0 -3 44 -47 0 13 -3 14 23 -8 11 12 -19 0 133 -14 0 126 -7 0 -2 132 -19 0 27 28 29 -11 0 27 28 29 -4 0 7 2921 2922 2911 2912 -6 14 2915 2916 2917 2918 9 -25 0 7 8 22 11 12 -4 0 47 -7 0 44 -3 0 44 -10 0 7 9 -25 0 47 0 27 28 29 -4 0 47 -8 0 -3 44 0 27 28 29 -43 0 7 -2 44 8 22 -12 11 12 -19 0 133 -22 0 -2 132 -16 0 27 28 29 -3 0 27 -4 28 29 -12 0 13 2923 2924 -10 11 2919 2920 15 -7 0 -2 44 -8 0 -2 44 -6 0 13 14 23 11 12 -4 0 27 -3 28 29 -2 0 27 -4 28 29 -4 0 7 -3 8 -2 44 114 113 -2 44 -3 8 9 -6 0 44 -3 0 44 -8 0 47 -8 0 47 -8 0 27 28 29 -13 0 7 8 9 -3 0 77 -2 83 77 -2 0 77 -2 83 77 -2 0 77 -2 83 77 -2 0 77 -2 83 77 -6 0 13 -3 14 23 -7 11 30 -4 17 18 -19 0 133 -22 0 -2 132 -9 0 7 8 9 27 -2 28 29 -11 0 27 28 29 -2 0 77 -2 83 77 -3 0 7 22 -14 11 12 -6 0 27 -2 28 29 -6 0 27 -2 28 29 -3 0 7 8 22 -3 11 12 -21 0 13 -5 14 23 20 -5 14 15 -5 0 27 -4 28 29 -8 0 47 -7 0 27 29 -2 0 7 9 -2 0 27 29 -16 0 13 14 15 -31 0 16 -5 17 31 -5 11 12 -24 0 133 -22 0 -2 132 -9 0 13 14 15 -27 0 13 23 -14 11 12 -23 0 13 14 23 -3 11 12 7 -4 0 -3 44 -5 0 -3 44 -5 0 22 -12 11 12 -31 0 13 15 -20 0 10 11 12 -27 0 7 9 -2 0 7 -2 8 9 -2 0 10 -5 11 12 -3 0 7 9 -19 0 133 -22 0 -2 132 -5 0 -4 8 22 11 12 -11 0 7 -15 8 22 -15 11 12 -5 0 7 -17 8 22 -5 11 12 13 -20 14 23 -12 11 12 7 -30 8 22 21 -20 8 22 11 21 -27 8 114 113 -2 8 114 -2 14 15 -2 0 16 -5 17 18 -3 0 13 113 -19 8 133 -14 8 -8 0 -2 132 8 9 -3 0 -4 14 23 11 12 -11 0 13 -15 14 23 -15 11 12 -5 0 13 -17 14 23 -5 11 12 10 2929 2930 -13 17 2925 2926 -16 11 12 13 -30 14 23 20 -20 14 23 11 20 -27 14 23 20 -2 14 23 -2 11 12 -5 0 128 -6 0 10 20 -45 14 15 2140 2141 2142 -6 11 12 -11 0 10 -31 11 12 -5 0 10 -23 11 12 16 2931 -15 0 2928 2933 -15 11 12 10 -89 11 12 -10 0 7 8 22 -46 11 12 -3 2020 -6 11 12 -11 2178 10 -31 11 12 -5 0 10 -23 11 12 -18 0 2934 2933 -14 11 12 10 -89 11 12 -10 0 13 14 23 -46 11 12 -3 2020 -6 11 12 13 -9 14 15 10 -31 11 12 -5 0 10 -23 11 12 -19 0 2934 2925 2926 -12 11 12 10 -89 11 21 -10 8 22 -48 11 12 -3 2020 -6 11 12 10 -9 11 12 10 -31 11 12 -5 0 10 -23 11 12 -21 0 2928 -12 17 18 10 -89 11 20 -10 14 23 -48 11 12 -3 2020 -6 11 12 10 -9 11 12 10 -31 11 12 -5 0 10 -23 11 12 -35 0 10 -149 11 12 -3 2020 -6 11 12 16 -9 17 18 10 -31 11 12 -5 2178 10 -23 11 12 -35 0 10 -149 11 12 -3 2020)
    )
    (tilemap
      (solid #f)
      (z-pos 100)
      (name "Foreground")
      (width 270)
      (height 25)
      (tiles -3211 0 130 -269 0 129 -16 0 127 -252 0 129 -269 0 129 -269 0 129 -269 0 129 -269 0 129 -35 0 2140 2141 2142 2019 2140 2141 2142 2019 2140 2141 2142 -63 0 2019 2140 2141 2142 2019 2140 2141 2142 2019 2140 2141 2142 2019 2140 2141 2142 2019 2140 2141 2142 2019 2140 2141 2142 2019 2140 2141 2142 2019 2140 2141 2142 2019 2140 2141 -161 0 -11 2020 -63 0 -35 2020 -161 0 -11 2020 -63 0 -35 2020 -161 0 -11 2020 -63 0 -35 2020 -161 0 -11 2020 -63 0 -35 2020 -161 0 -11 2020 -63 0 -35 2020 -161 0 -11 2020 -63 0 -35 2020 -154 0)
    )
    (tilemap
      (handle
        (scale_x 0)
        (scale_y 0)
        (offset_x 0)
        (offset_y 0)
      )
      (solid #f)
      (z-pos 60)
      (name "Secret")
      (path-ref "gen17713485441566836282480")
      (width 18)
      (height 10)
      (tiles -30 0 -5 11 12 10 -6 11 -5 0 -5 11 12 10 -6 11 -5 0 -5 11 12 22 -16 11 21 -3 0 -6 11 19 -7 11 -4 0 -14 11 -4 0 -14 11 -4 0 -12 11 -6 0 -12 11 -3 0)
    )
    (tilemap
      (solid #f)
      (z-pos -130)
      (name "Background2")
      (width 270)
      (height 25)
      (tiles -2261 0 -2 2199 -249 0 2185 2200 2197 2188 -2 2181 2179 2197 2179 2189 2195 2189 2181 2188 2195 2196 -2 2187 2189 2181 2180 2181 2196 2197 -245 0 2185 2200 2197 2195 2179 2196 2195 2180 -2 2181 2180 2196 -2 2187 -2 2195 2187 2195 2188 2195 2187 2195 -3 2179 -244 0 2185 2200 2179 2180 2188 2181 2187 2179 2180 2197 2180 2188 2181 2180 2179 2180 2195 2197 2179 2196 -2 2189 2181 2195 2181 -2 2195 2180 2195 2189 -2 2196 2187 2181 2189 2190 -234 0 2200 2197 2180 2181 2188 2187 2179 2187 2196 2180 2187 2195 2187 2196 2188 2180 2195 2188 2187 2181 2180 2188 2187 2196 -2 2179 2196 2187 2181 2195 2179 -2 2195 2189 2187 2190 -234 0 2188 2195 2187 -2 2189 2196 2197 2196 -2 2197 2189 2188 2179 2180 2196 2188 2195 2189 2181 2189 2181 -2 2188 2180 2188 -2 2195 -2 2180 2189 2196 2187 2195 2180 2195 2190 -234 0 -2 2180 2187 2195 -2 2196 2187 2195 2189 2196 2179 2196 2188 2197 2188 2187 2196 2189 2188 -2 2179 2189 2179 2195 2180 -3 2197 -2 2181 2179 2181 2195 2187 2195 2190 -234 0 2181 2187 2189 -2 2181 2189 2196 -2 2197 2188 2197 2179 2188 2187 2196 2197 2181 2197 2195 2187 2181 2188 2179 2188 2189 2180 2197 2187 2197 2196 2197 -3 2189 2179 2190 -234 0 2187 2180 2196 2187 2195 2179 2189 2197 2188 2181 2196 -2 2189 2187 2189 2179 2187 2179 2188 2179 2187 2197 2187 2181 2179 -2 2195 2189 2187 2188 2197 2180 2197 2196 2197 2190 -160 0 -13 2199 2186 -60 0 2196 2188 2197 2189 2195 2181 2195 2180 2187 2179 2187 2180 2189 -2 2195 -2 2181 2179 2187 2179 2188 -2 2181 2180 2181 2187 2188 2196 2180 2195 2197 2179 2181 2180 2197 2190 -160 0 2180 2197 2179 2187 2195 2196 2181 2189 2179 2197 2187 2188 2180 -61 0 -2 2179 2196 2188 2189 2180 2196 2181 -2 2189 -2 2180 -2 2195 2180 2195 2196 -2 2189 -2 2188 2189 2180 -2 2195 2181 2189 2196 2180 -2 2196 2181 -2 2196 2179 2198 2199 -159 0 2188 2180 2187 2195 2196 2181 2189 2181 2189 2187 2188 2180 2196 -61 0 -2 2179 2181 2195 -2 2196 2188 2189 2180 -2 2179 2189 -2 2195 2196 2181 2196 2181 2179 2180 -2 2179 2189 2188 2195 -2 2196 2181 -2 2196 2188 2189 2181 2196 2180 2196 2195 -159 0 2196 2188 2180 2196 2181 2189 2179 2197 2181 2189 2180 2196 2195 -61 0 2196 2195 2188 2189 -2 2196 2195 2180 2189 -2 2195 2181 -2 2195 2196 2179 2189 2195 2180 2196 2181 -2 2179 -2 2196 2180 -2 2196 2195 -3 2196 2189 2179 2189 -2 2196 -159 0 2187 2196 2188 2180 2188 2195 2197 2187 2196 2180 2196 2195 2179 -61 0 2179 2196 2189 2180 2179 2195 2181 -2 2196 -2 2188 2189 2180 2189 2180 -2 2179 2181 2196 2195 2189 2196 2195 2196 -2 2189 2188 -2 2196 2195 2196 2195 2180 2189 2188 -2 2196 -159 0 2197 2195 2181 2189 2180 2188 2195 2196 2180 2188 2181 2197 2179 -60 0 2191 2196 2179 -2 2195 2188 2189 2181 2196 2180 2196 2189 2188 2196 2181 -2 2189 2196 2179 2196 2189 2188 2196 -2 2179 2181 -2 2195 2180 2196 2180 2196 2179 2181 2188 2181 2180 2188 -159 0 2195 2181 2189 2196 2187 2180 2188 2180 2188 2196 2189 2181 2197 -61 0 2179 -2 2196 2195 -2 2189 2196 2189 2188 2181 2196 2180 -2 2195 2196 2181 2188 2179 2189 2195 2188 2189 2196 2179 2196 2181 2189 2195 2188 2189 2179 2180 -2 2195 2189 2179 2195 -159 0 2181 2189 2196 2179 2197 2187 2180 -2 2179 2195 2196 2189 2181 -61 0 -2 2179 -2 2196 2181 2196 2188 2189 2179 2196 2188 -2 2195 2189 2180 -2 2195 2196 2181 -2 2196 2195 2189 2180 2196 2188 -2 2195 2181 -4 2196 2180 2188 2195 2179 -153 0)
    )
    (tilemap
      (solid #f)
      (speed-x 0.5)
      (speed-y 0.5)
      (z-pos -150)
      (name "background_para1")
      (width 180)
      (height 25)
      (tiles -1846 0 149 160 151 -7 0 149 160 151 -50 0 149 160 151 -7 0 149 160 151 -50 0 149 160 151 -10 0 149 160 151 -7 0 149 160 151 -28 0 152 153 158 151 -6 0 152 153 158 151 -8 0 149 160 151 -7 0 149 160 151 -28 0 152 153 158 151 -6 0 152 153 158 151 -8 0 149 160 151 -7 0 149 160 151 -28 0 152 153 158 151 -9 0 152 153 158 151 -6 0 152 153 158 151 -6 0 149 160 151 -7 0 149 160 151 -7 0 149 159 -2 153 154 -5 0 149 159 -2 153 154 -8 0 152 153 158 151 -6 0 152 153 158 151 -6 0 149 160 151 -7 0 149 160 151 -7 0 149 159 -2 153 154 -5 0 149 159 -2 153 154 -8 0 152 153 158 151 -6 0 152 153 158 151 -6 0 149 160 151 -7 0 149 160 151 -7 0 149 159 -2 153 154 -8 0 149 159 -2 153 154 -5 0 149 159 -2 153 154 -6 0 152 153 158 151 -6 0 152 153 158 151 -2 0 149 -3 160 159 -3 153 158 -5 160 159 -3 153 158 -3 160 151 -3 0 149 159 -2 153 154 -5 0 149 159 -2 153 154 -6 0 152 153 158 151 -6 0 152 153 158 151 -2 0 149 -3 160 159 -3 153 158 -5 160 159 -3 153 158 -3 160 151 -3 0 149 159 -2 153 154 -5 0 149 159 -2 153 154 -6 0 152 153 158 151 -6 0 152 153 158 151 -2 0 149 -3 160 159 -3 153 158 -8 160 159 -3 153 158 -5 160 159 -3 153 158 -2 160 151 -2 0 149 159 -2 153 154 -5 0 149 159 -2 153 154 -2 0 152 -21 153 158 -3 160 159 -3 153 158 -5 160 159 -3 153 158 -2 160 151 -2 0 149 159 -2 153 154 -5 0 149 159 -2 153 154 -2 0 152 -21 153 158 -3 160 159 -3 153 158 -5 160 159 -3 153 158 -2 160 151 -2 0 149 159 -2 153 154 -5 0 149 159 -2 153 154 -2 0 152 -33 153 158 -2 160 159 -3 153 158 -5 160 159 -3 153 158 -2 160 159 -42 153 158 -2 160 159 -3 153 158 -5 160 159 -3 153 158 -2 160 159 -42 153 158 -2 160 159 -3 153 158 -5 160 159 -3 153 158 -2 160 159 -1632 153)
    )
    (tilemap
      (solid #f)
      (speed-x 0.2)
      (speed-y 0.2)
      (z-pos -170)
      (name "background_para2")
      (width 90)
      (height 25)
      (tiles -840 0 161 163 -65 0 161 163 -20 0 161 171 170 163 -7 0 161 163 -36 0 161 163 -16 0 161 171 170 163 -7 0 161 163 -5 0 161 -4 162 171 -2 165 170 162 163 -4 0 161 171 170 163 -12 0 161 163 -20 0 161 171 170 163 -7 0 161 163 -6 162 171 -2 165 170 162 163 -4 0 161 171 170 163 -4 0 164 -9 165 170 -4 162 171 -2 165 170 -4 162 163 -6 0 161 171 170 163 -7 0 161 163 -5 0 161 -4 162 171 -2 165 170 162 163 -4 0 161 171 170 -11 165 170 -4 162 171 -2 165 170 -4 162 171 -22 165 170 -6 162 171 -2 165 170 162 163 -4 0 161 171 170 163 -4 0 164 -9 165 170 -4 162 171 -61 165 170 -4 162 171 -2 165 170 -4 162 171 -917 165)
    )
  )
)
