(supertux-level
  (version 3)
  (name (_ "The Somewhat Smaller Bath"))
  (author "Philippe Saint-Pierre")
  (license "GPL 2+ / CC-by-sa 3.0")
  (target-time 60)
  (allow-item-pocket "inherit")
  (icon "")
  (icon-locked "")
  (statistics
    (enable-coins #t)
    (enable-secrets #t)
  )
  (sector
    (name "main")
    (ambient-light
      (color 1 1 1)
    )
    (bouncingsnowball
      (z-pos 50)
      (x 3123)
      (y 154)
      (glinting #f)
    )
    (camera
      (name "Camera")
      (mode "normal")
    )
    (captainsnowball
      (z-pos 50)
      (x 3008)
      (y 448)
      (glinting #f)
    )
    (firefly
      (z-pos 0)
      (x 5006)
      (y 397)
    )
    (gradient
      (top_color 0.5 0.7 1)
      (bottom_color 1 1 1)
    )
    (jumpy
      (z-pos 50)
      (x 9056)
      (y 287)
      (glinting #f)
    )
    (jumpy
      (z-pos 50)
      (x 1447)
      (y 415)
      (glinting #f)
    )
    (jumpy
      (z-pos 50)
      (x 2528)
      (y 417)
      (glinting #f)
    )
    (jumpy
      (z-pos 50)
      (x 4891)
      (y 410)
      (glinting #f)
    )
    (jumpy
      (z-pos 50)
      (x 1696)
      (y 352)
      (glinting #f)
    )
    (mrbomb
      (z-pos 50)
      (x 10211)
      (y 428)
      (glinting #f)
    )
    (mrbomb
      (z-pos 50)
      (x 9488)
      (y 433)
      (glinting #f)
    )
    (mrbomb
      (z-pos 50)
      (x 9547)
      (y 433)
      (glinting #f)
    )
    (mrbomb
      (z-pos 50)
      (x 5975)
      (y 427)
      (glinting #f)
    )
    (mriceblock
      (z-pos 50)
      (x 5408)
      (y 448)
      (glinting #f)
    )
    (mriceblock
      (z-pos 50)
      (x 7744)
      (y 448)
      (glinting #f)
    )
    (mriceblock
      (z-pos 50)
      (x 4255)
      (y 407)
      (glinting #f)
    )
    (music
      (file "music/chipdisko.ogg")
    )
    (smartball
      (z-pos 50)
      (x 8153)
      (y 281)
      (glinting #f)
    )
    (smartball
      (z-pos 50)
      (x 7680)
      (y 352)
      (glinting #f)
    )
    (smartball
      (z-pos 50)
      (x 2176)
      (y 448)
      (glinting #f)
    )
    (smartball
      (z-pos 50)
      (x 3872)
      (y 448)
      (glinting #f)
    )
    (smartball
      (z-pos 50)
      (x 4480)
      (y 448)
      (glinting #f)
    )
    (smartball
      (z-pos 50)
      (x 6336)
      (y 448)
      (glinting #f)
    )
    (smartball
      (z-pos 50)
      (x 6624)
      (y 448)
      (glinting #f)
    )
    (smartball
      (z-pos 50)
      (x 4800)
      (y 288)
      (glinting #f)
    )
    (snowball
      (z-pos 50)
      (x 640)
      (y 416)
      (glinting #f)
    )
    (snowball
      (z-pos 50)
      (x 1281)
      (y 468)
      (glinting #f)
    )
    (snowball
      (z-pos 50)
      (x 9022)
      (y 441)
      (glinting #f)
    )
    (spawnpoint
      (name "main")
      (x 96)
      (y 448)
    )
    (tilemap
      (solid #f)
      (z-pos -100)
      (width 355)
      (height 25)
      (tiles -2454 0 130 -354 0 129 -354 0 129 -354 0 129 -342 0 24 -11 0 129 -240 0 122 123 -112 0 129 -146 0 122 123 -47 0 122 123 -5 0 122 123 -33 0 122 123 0 124 125 0 122 123 -109 0 129 8 -105 0 106 107 108 -34 0 122 123 0 124 125 0 122 123 -22 0 106 107 108 -16 0 122 123 0 124 125 -5 0 124 125 0 122 123 -19 0 106 107 108 -8 0 124 125 0 124 125 0 124 125 -34 0 106 107 108 -38 0 106 107 108 -27 0 106 107 108 -13 0 106 107 108 -22 0 106 107 108 -37 0 106 107 108 -11 0 -3 8 25 -11 0 24 109 110 111 -6 0 24 -3 0 8 -23 0 124 125 0 124 125 0 124 125 -22 0 109 110 111 -5 0 24 -4 0 -2 8 -4 0 124 125 0 124 125 0 25 -3 0 124 125 0 124 125 -2 0 24 0 -3 8 -5 0 -3 8 -4 0 109 110 111 -4 0 25 -3 0 124 125 0 124 125 0 124 125 -17 0 25 -16 0 109 110 111 -4 0 25 -16 0 25 -16 0 109 110 111 -12 0 24 -14 0 109 110 111 -11 0 24 0 109 110 111 0 -10 8 -8 0 25 -2 0 109 110 111 -13 0 -4 17 -3 0 24 -4 0 -2 8 -6 0 8 -3 0 109 110 111 -712 0 25 0 8 -81 0 -11 2020 -8 0 -26 2020 -12 0 -24 2020 -70 0 -6 2020 -5 0 -41 2020 -116 0 -4 8 -31 0 -45 2020 -12 0 -26 2020 -68 0 -7 2020 -3 0 -45 2020 -71 0 -4 8 -74 0 -45 2020 -12 0 -26 2020 -68 0 -7 2020 -3 0 -44 2020 -150 0 -45 2020 -12 0 -26 2020 -68 0 -7 2020 -3 0 -44 2020 -150 0 -45 2020 -12 0 -26 2020 -68 0 -7 2020 -3 0 -44 2020 -150 0 -45 2020 -12 0 -26 2020 -68 0 -7 2020 -3 0 -44 2020 -150 0 -45 2020 -12 0 -26 2020 -68 0 -7 2020 -3 0 -44 2020 -150 0 -45 2020 -12 0 -26 2020 -68 0 -7 2020 -3 0 -44 2020 -16 0)
    )
    (tilemap
      (solid #t)
      (z-pos 0)
      (width 355)
      (height 25)
      (tiles -325 0 133 -22 0 -2 132 -330 0 133 -22 0 -2 132 -330 0 133 -22 0 -2 132 -330 0 133 -22 0 -2 132 -330 0 133 -22 0 -2 132 -151 0 44 0 44 0 44 -51 0 -5 44 -68 0 -4 44 -3 0 -4 44 -3 0 -5 44 -31 0 133 -22 0 -2 132 -95 0 -9 78 -27 0 -6 44 -14 0 -3 78 105 78 -174 0 133 -22 0 -2 132 -22 0 -3 83 102 -69 0 77 -7 44 77 -27 0 -6 78 -10 0 83 -182 0 133 -22 0 -2 132 -95 0 77 -7 44 77 -11 0 7 9 -15 0 13 -2 14 15 -70 0 -7 78 -117 0 133 -22 0 -2 132 -95 0 77 -7 44 77 -11 0 13 15 -15 0 10 -2 11 12 -55 0 78 -81 0 -2 78 -2 0 -3 84 -4 0 -3 84 -4 0 -3 84 -36 0 133 -14 0 126 -7 0 -2 132 -21 0 -6 78 -3 0 7 -2 8 9 -38 0 -3 78 -10 0 -3 44 -7 0 -9 77 -9 0 7 8 22 12 -3 0 -3 83 103 -8 0 10 -2 11 12 -15 0 -5 77 -13 0 -2 78 83 -2 78 83 -2 78 102 -2 78 -78 0 77 -2 78 102 -2 78 77 -52 0 7 9 -11 0 133 -22 0 -2 132 -30 0 13 -2 14 15 -8 0 -4 78 -67 0 13 14 23 12 -15 0 10 -2 11 12 -8 0 -4 78 -41 0 78 -3 0 78 -6 0 -4 78 -66 0 -2 78 -16 0 84 -28 0 13 15 -11 0 133 -22 0 -2 132 -30 0 10 11 30 18 -77 0 7 8 22 -2 11 12 -15 0 10 -2 11 12 -52 0 78 77 -3 44 77 78 -46 0 77 -4 78 104 -66 0 7 -3 8 22 12 -10 0 7 133 -3 8 9 -18 0 -2 132 -14 0 7 -2 8 9 -2 0 104 -5 0 7 -3 8 22 30 18 -22 0 -5 83 -6 0 78 -44 0 13 14 23 -2 11 12 -15 0 10 -2 11 12 -51 0 78 77 0 -3 44 0 77 78 -71 0 -2 78 -44 0 13 -3 14 23 12 -10 0 13 -4 14 15 -18 0 -2 132 -14 0 13 -2 14 15 -2 0 -6 77 13 -3 14 23 12 -15 0 78 -15 0 7 8 -3 77 -9 8 9 -2 0 7 -13 8 78 -6 8 9 -5 0 7 -3 8 22 -4 11 21 -12 8 9 -2 0 16 31 30 18 -2 0 7 -22 8 -2 78 -23 8 78 -2 77 -5 8 -2 77 78 -32 8 9 -6 0 7 8 9 -10 0 7 -14 8 9 -9 0 7 -38 8 22 -4 11 21 -10 8 22 -4 11 21 -10 8 -8 0 -2 132 -4 8 9 -9 8 22 -2 11 12 -8 0 84 -4 44 84 0 7 -5 8 -2 78 -6 8 78 -5 8 9 -9 0 13 -13 14 15 -2 0 13 -20 14 15 -5 0 13 -3 14 23 -4 11 20 -12 14 15 -3 0 16 18 -3 0 13 -90 14 15 -6 0 13 14 15 -10 0 13 -14 14 15 -9 0 13 -38 14 23 -4 11 20 -10 14 23 -4 11 20 -24 14 15 -9 14 23 -2 11 12 -15 0 13 -19 14 15 -4 0 77 -4 0 16 31 -10 11 30 17 18 -2 0 16 31 -19 11 21 8 9 -3 0 16 31 -20 11 12 -8 0 10 -90 11 21 9 -4 0 7 22 11 48 -10 0 48 -13 11 30 18 -9 0 16 31 -83 11 12 -12 11 48 -15 0 48 -19 11 21 -4 8 77 8 9 -3 0 16 31 -8 11 30 18 -5 0 16 17 31 -17 11 20 14 15 -4 0 10 -20 11 48 -8 0 48 11 30 -9 17 31 -8 11 30 -23 17 31 -13 11 30 -9 17 31 -3 11 30 -7 17 31 -9 11 20 15 -4 0 13 23 11 -12 48 -12 11 30 18 -11 0 16 -3 17 31 -11 11 30 -2 17 31 -7 11 30 -39 17 31 -9 11 30 -6 17 18 -12 11 -17 48 -19 11 20 -6 14 15 -4 0 10 -6 11 30 17 18 -8 0 16 31 -7 11 30 -6 17 31 -3 11 21 -4 2178 22 -20 11 -10 48 30 18 -9 0 16 -8 17 18 -23 0 10 -12 11 30 18 -9 0 16 31 11 30 18 -7 0 16 31 -8 11 30 18 -4 0 16 31 -25 11 12 -16 0 10 -10 11 30 18 -2 0 16 17 31 -3 11 30 17 18 -39 0 16 31 -8 11 12 -7 0 -55 11 21 -4 2178 22 -6 11 12 -11 0 10 -7 11 12 -6 0 10 -3 11 20 -4 14 23 -30 11 12 -43 0 10 -12 11 12 -11 0 10 11 12 -9 0 10 -8 11 12 -6 0 10 -25 11 12 -16 0 10 -10 11 12 -5 0 10 -3 11 12 -42 0 10 -8 11 12 -7 0 -55 11 20 -4 14 23 -6 11 12 -11 0 10 -7 11 12 -6 0 10 30 -8 17 31 -29 11 12 -43 0 10 -12 11 12 -11 0 10 11 12 -9 0 10 -8 11 12 -6 0 10 -25 11 12 -16 0 10 -10 11 12 -5 0 10 -3 11 12 -42 0 10 -8 11 12 -7 0 -67 11 12 -11 0 10 -7 11 12 -6 0 10 12 -8 0 10 -29 11 12 -43 0 10 -12 11 12 -11 0 10 11 12 -9 0 10 -8 11 12 -6 0 10 -25 11 12 -16 0 10 -10 11 12 -5 0 10 -3 11 12 -42 0 10 -8 11 12 -7 0 -67 11 12 -11 0 10 -7 11 12 -6 0 10 12 -8 0 10 -29 11 12 -43 0 10 -12 11 12 -11 0 10 11 12 -9 0 10 -8 11 12 -6 0 10 -25 11 12 -16 0 10 -10 11 12 -5 0 10 -3 11 12 -42 0 10 -8 11 12 -7 0 -67 11 12 -11 0 10 -7 11 12 -6 0 10 12 -8 0 10 -29 11 12 -43 0 10 -12 11 12 -11 0 10 11 12 -9 0 10 -8 11 12 -6 0 10 -25 11 12 -16 0 10 -10 11 12 -5 0 10 -3 11 12 -42 0 10 -8 11 12 -7 0 -67 11 12 -11 0 10 -7 11 12 -6 0 10 12 -8 0 10 -29 11 12 -43 0 10 -12 11 12 -11 0 10 11 12 -9 0 10 -8 11 12 -6 0 10 -25 11 12 -16 0 10 -10 11 12 -5 0 10 -3 11 12 -42 0 10 -8 11 12 -7 0)
    )
    (tilemap
      (solid #f)
      (z-pos 100)
      (width 355)
      (height 25)
      (tiles -2456 0 130 -155 0 7 -2 8 9 -195 0 129 -155 0 13 -2 14 15 -195 0 129 -354 0 129 -16 0 127 -337 0 129 -354 0 129 -354 0 129 -1326 0 48 2140 2141 2142 2019 2140 2141 2142 2019 2140 2141 48 -122 0 48 2019 2140 2141 2142 2019 2140 2141 2142 2019 2140 2141 2142 2019 2140 2141 48 -95 0 48 2142 2019 2140 2141 2142 2019 2140 2141 48 -99 0 -12 48 -122 0 -17 48 -95 0 -10 48 -2351 0)
    )
    (tilemap
      (solid #f)
      (z-pos -150)
      (name "Background_Far")
      (width 355)
      (height 25)
      (tiles -6169 0 2176 2175 2176 2175 2176 2175 2176 2175 2176 2175 2176 2175 -8 0 2176 2175 2176 2175 2176 2175 2176 2175 2176 2175 2176 2175 2176 2175 2176 2175 2176 2175 2176 2175 2176 2175 2176 2175 2176 -12 0 2176 2175 2176 2175 -2 2176 2175 2176 2175 -2 2176 2175 2176 2175 -2 2176 2175 2176 2175 -2 2176 2175 2176 2175 2176 -69 0 2176 2175 2176 2175 2176 -7 0 2176 2175 2176 2175 2176 2175 2176 2175 2176 2175 2176 2175 2176 2175 2176 2175 2176 2175 2176 2175 2176 2175 2176 2175 2176 2175 2176 2175 2176 2175 2176 2175 2176 2175 2176 2175 2176 2175 2176 2175 2176 2175 -150 0 2172 2171 2172 2171 2172 2171 2172 2171 2172 2171 2172 2171 2172 2171 2172 2171 2172 2171 2172 2171 2172 2171 2172 2171 2172 2171 2172 2171 2172 2171 2172 2171 2172 2171 2172 2171 2172 2171 2172 2171 2172 2171 2172 2171 2172 -12 0 2172 2171 2172 2171 -2 2172 2171 2172 2171 -2 2172 2171 2172 2171 -2 2172 2171 2172 2171 -2 2172 2171 2172 2171 2172 -69 0 2172 2171 2172 2171 2172 2171 2172 2171 2172 2171 2172 2171 2172 2171 2172 2171 2172 2171 2172 2171 2172 2171 2172 2171 2172 2171 2172 2171 2172 2171 2172 2171 2172 2171 2172 2171 2172 2171 2172 2171 2172 2171 2172 2171 2172 2171 2172 2171 2172 2171 2172 2171 2172 2171 -150 0 2176 2175 2176 2175 2176 2175 2176 2175 2176 2175 2176 2175 2176 2175 2176 2175 2176 2175 2176 2175 2176 2175 2176 2175 2176 2175 2176 2175 2176 2175 2176 2175 2176 2175 2176 2175 2176 2175 2176 2175 2176 2175 2176 2175 2176 -12 0 2176 2175 2176 2175 -2 2176 2175 2176 2175 -2 2176 2175 2176 2175 -2 2176 2175 2176 2175 -2 2176 2175 2176 2175 2176 -69 0 2176 2175 2176 2175 2176 2175 2176 2175 2176 2175 2176 2175 2176 2175 2176 2175 2176 2175 2176 2175 2176 2175 2176 2175 2176 2175 2176 2175 2176 2175 2176 2175 2176 2175 2176 2175 2176 2175 2176 2175 2176 2175 2176 2175 2176 2175 2176 2175 2176 2175 2176 2175 2176 2175 -150 0 2172 2171 2172 2171 2172 2171 2172 2171 2172 2171 2172 2171 2172 2171 2172 2171 2172 2171 2172 2171 2172 2171 2172 2171 2172 2171 2172 2171 2172 2171 2172 2171 2172 2171 2172 2171 2172 2171 2172 2171 2172 2171 2172 2171 2172 -12 0 2172 2171 2172 2171 -2 2172 2171 2172 2171 -2 2172 2171 2172 2171 -2 2172 2171 2172 2171 -2 2172 2171 2172 2171 2172 -69 0 2172 2171 2172 2171 2172 2171 2172 2171 2172 2171 2172 2171 2172 2171 2172 2171 2172 2171 2172 2171 2172 2171 2172 2171 2172 2171 2172 2171 2172 2171 2172 2171 2172 2171 2172 2171 2172 2171 2172 2171 2172 2171 2172 2171 2172 2171 2172 2171 2172 2171 2172 2171 2172 2171 -150 0 2176 2175 2176 2175 2176 2175 2176 2175 2176 2175 2176 2175 2176 2175 2176 2175 2176 2175 2176 2175 2176 2175 2176 2175 2176 2175 2176 2175 2176 2175 2176 2175 2176 2175 2176 2175 2176 2175 2176 2175 2176 2175 2176 2175 2176 -12 0 2176 2175 2176 2175 -2 2176 2175 2176 2175 -2 2176 2175 2176 2175 -2 2176 2175 2176 2175 -2 2176 2175 2176 2175 2176 -69 0 2176 2175 2176 2175 2176 2175 2176 2175 2176 2175 2176 2175 2176 2175 2176 2175 2176 2175 2176 2175 2176 2175 2176 2175 2176 2175 2176 2175 2176 2175 2176 2175 2176 2175 2176 2175 2176 2175 2176 2175 2176 2175 2176 2175 2176 2175 2176 2175 2176 2175 2176 2175 2176 2175 -150 0 2172 2171 2172 2171 2172 2171 2172 2171 2172 2171 2172 2171 2172 2171 2172 2171 2172 2171 2172 2171 2172 2171 2172 2171 2172 2171 2172 2171 2172 2171 2172 2171 2172 2171 2172 2171 2172 2171 2172 2171 2172 2171 2172 2171 2172 -12 0 2172 2171 2172 2171 -2 2172 2171 2172 2171 -2 2172 2171 2172 2171 -2 2172 2171 2172 2171 -2 2172 2171 2172 2171 2172 -69 0 2172 2171 2172 2171 2172 2171 2172 2171 2172 2171 2172 2171 2172 2171 2172 2171 2172 2171 2172 2171 2172 2171 2172 2171 2172 2171 2172 2171 2172 2171 2172 2171 2172 2171 2172 2171 2172 2171 2172 2171 2172 2171 2172 2171 2172 2171 2172 2171 2172 2171 2172 2171 2172 2171 -150 0 2176 2175 2176 2175 2176 2175 2176 2175 2176 2175 2176 2175 2176 2175 2176 2175 2176 2175 2176 2175 2176 2175 2176 2175 2176 2175 2176 2175 2176 2175 2176 2175 2176 2175 2176 2175 2176 2175 2176 2175 2176 2175 2176 2175 2176 -12 0 2176 2175 2176 2175 -2 2176 2175 2176 2175 -2 2176 2175 2176 2175 -2 2176 2175 2176 2175 -2 2176 2175 2176 2175 2176 -69 0 2176 2175 2176 2175 2176 2175 2176 2175 2176 2175 2176 2175 2176 2175 2176 2175 2176 2175 2176 2175 2176 2175 2176 2175 2176 2175 2176 2175 2176 2175 2176 2175 2176 2175 2176 2175 2176 2175 2176 2175 2176 2175 2176 2175 2176 2175 2176 2175 2176 2175 2176 2175 2176 2175 -150 0 2172 2171 2172 2171 2172 2171 2172 2171 2172 2171 2172 2171 2172 2171 2172 2171 2172 2171 2172 2171 2172 2171 2172 2171 2172 2171 2172 2171 2172 2171 2172 2171 2172 2171 2172 2171 2172 2171 2172 2171 2172 2171 2172 2171 2172 -12 0 2172 2171 2172 2171 -2 2172 2171 2172 2171 -2 2172 2171 2172 2171 -2 2172 2171 2172 2171 -2 2172 2171 2172 2171 2172 -69 0 2172 2171 2172 2171 2172 2171 2172 2171 2172 2171 2172 2171 2172 2171 2172 2171 2172 2171 2172 2171 2172 2171 2172 2171 2172 2171 2172 2171 2172 2171 2172 2171 2172 2171 2172 2171 2172 2171 2172 2171 2172 2171 2172 2171 2172 2171 2172 2171 2172 2171 2172 2171 2172 2171 -16 0)
    )
    (tilemap
      (solid #f)
      (speed-x 0.5)
      (speed-y 0.5)
      (z-pos -200)
      (name "Background_Para1")
      (width 234)
      (height 25)
      (tiles -1411 0 149 -3 160 151 -35 0 149 -3 160 151 -35 0 149 -3 160 151 -32 0 149 -3 160 151 -35 0 149 -3 160 151 -35 0 149 -3 160 151 -31 0 149 159 -3 153 154 -34 0 149 159 -3 153 154 -34 0 149 159 -3 153 154 -31 0 149 159 -3 153 154 -34 0 149 159 -3 153 154 -34 0 149 159 -3 153 154 -29 0 149 160 159 -4 153 154 -32 0 149 160 159 -4 153 154 -32 0 149 160 159 -4 153 154 -29 0 149 160 159 -4 153 154 -32 0 149 160 159 -4 153 154 -32 0 149 160 159 -4 153 154 -29 0 152 -6 153 154 -32 0 152 -6 153 154 -32 0 152 -6 153 154 -29 0 152 -6 153 154 -32 0 152 -6 153 154 -32 0 152 -6 153 154 -29 0 152 -6 153 158 -2 160 151 -29 0 152 -6 153 158 -2 160 151 -29 0 152 -6 153 158 -2 160 151 -26 0 152 -6 153 158 -2 160 151 -29 0 152 -6 153 158 -2 160 151 -29 0 152 -6 153 158 -2 160 151 -22 0 -4 160 159 -9 153 158 -3 160 151 -12 0 149 160 151 -4 0 149 -5 160 159 -9 153 158 -3 160 151 -12 0 149 160 151 -4 0 149 -5 160 159 -9 153 158 -3 160 151 -12 0 149 160 151 -3 0 149 -3 160 159 -9 153 158 -3 160 151 -12 0 149 160 151 -4 0 149 -5 160 159 -9 153 158 -3 160 151 -12 0 149 160 151 -4 0 149 -5 160 159 -9 153 158 -3 160 151 -12 0 149 160 151 -3 0 -18 153 154 -4 0 149 -5 160 151 0 152 153 158 -2 160 151 0 152 -19 153 154 -4 0 149 -5 160 151 0 152 153 158 -2 160 151 0 152 -19 153 154 -4 0 149 -5 160 151 0 152 153 158 -3 160 159 -17 153 154 -4 0 149 -5 160 151 0 152 153 158 -2 160 151 0 152 -19 153 154 -4 0 149 -5 160 151 0 152 153 158 -2 160 151 0 152 -19 153 154 -4 0 149 -5 160 151 0 152 153 158 -2 160 151 -18 153 158 -4 160 159 -5 153 158 160 159 -4 153 154 0 152 -19 153 158 -4 160 159 -5 153 158 160 159 -4 153 154 0 152 -19 153 158 -4 160 159 -5 153 158 160 159 -23 153 158 -4 160 159 -5 153 158 160 159 -4 153 154 0 152 -19 153 158 -4 160 159 -5 153 158 160 159 -4 153 154 0 152 -19 153 158 -4 160 159 -5 153 158 160 159 -4 153 154 -36 153 154 0 152 -37 153 154 0 152 -74 153 154 0 152 -37 153 154 0 152 -37 153 154 -36 153 154 0 152 -37 153 154 0 152 -74 153 154 0 152 -37 153 154 0 152 -37 153 154 -36 153 154 0 152 -37 153 154 0 152 -74 153 154 0 152 -37 153 154 0 152 -37 153 154 -36 153 154 0 152 -37 153 154 0 152 -74 153 154 0 152 -37 153 154 0 152 -37 153 154 -36 153 154 0 152 -37 153 154 0 152 -74 153 154 0 152 -37 153 154 0 152 -37 153 154 -36 153 154 0 152 -37 153 154 0 152 -74 153 154 0 152 -37 153 154 0 152 -37 153 154 -36 153 154 0 152 -37 153 154 0 152 -74 153 154 0 152 -37 153 154 0 152 -37 153 154 -36 153 154 0 152 -37 153 154 0 152 -74 153 154 0 152 -37 153 154 0 152 -37 153 154 -36 153 154 0 152 -37 153 154 0 152 -74 153 154 0 152 -37 153 154 0 152 -37 153 154 -36 153 154 0 152 -37 153 154 0 152 -74 153 154 0 152 -37 153 154 0 152 -37 153 154 -36 153 154 0 152 -37 153 154 0 152 -74 153 154 0 152 -37 153 154 0 152 -37 153 154)
    )
    (tilemap
      (solid #f)
      (speed-x 0.8)
      (speed-y 0.8)
      (z-pos -150)
      (name "Background_Para0")
      (width 355)
      (height 25)
      (tiles -562 0 85 86 87 88 -93 0 85 86 87 88 -254 0 89 90 91 92 -16 0 85 86 87 88 -73 0 89 90 91 92 -274 0 89 90 91 92 -502 0 85 86 87 88 -93 0 85 86 87 88 -254 0 89 90 91 92 -16 0 85 86 87 88 -73 0 89 90 91 92 -274 0 89 90 91 92 -816 0 85 86 87 88 -93 0 85 86 87 88 -254 0 89 90 91 92 -16 0 85 86 87 88 -73 0 89 90 91 92 -274 0 89 90 91 92 -207 0 1321 1322 1323 1324 -351 0 1325 1326 1327 1328 -351 0 1329 1330 1331 1332 -351 0 1333 1334 1335 1336 -3517 0)
    )
    (tilemap
      (solid #f)
      (speed-x 0.2)
      (speed-y 0.2)
      (z-pos -250)
      (name "Background_Para2")
      (width 117)
      (height 25)
      (tiles -963 0 161 -5 162 163 -31 0 161 -5 162 163 -31 0 161 -5 162 163 -30 0 161 -3 162 171 -5 165 166 -27 0 161 -3 162 171 -5 165 166 -27 0 161 -3 162 171 -5 165 166 -10 0 161 -8 162 163 -5 0 161 163 -3 0 164 -9 165 166 0 161 162 163 -3 0 161 -8 162 163 -5 0 161 163 -3 0 164 -9 165 166 0 161 162 163 -3 0 161 -8 162 163 -5 0 161 163 -3 0 164 -9 165 166 0 161 162 163 -3 0 -3 162 171 -8 165 166 -3 0 161 162 171 166 -3 0 164 -9 165 170 162 171 165 170 -3 162 171 -8 165 166 -3 0 161 162 171 166 -3 0 164 -9 165 170 162 171 165 170 -3 162 171 -8 165 166 -3 0 161 162 171 166 -3 0 164 -9 165 170 162 171 165 170 -3 162 -12 165 170 -3 162 171 -2 165 170 -3 162 171 -26 165 170 -3 162 171 -2 165 170 -3 162 171 -26 165 170 -3 162 171 -2 165 170 -3 162 171 -1421 165)
    )
    (unstable_tile
      (z-pos 0)
      (x 8416)
      (y 480)
    )
    (unstable_tile
      (z-pos 0)
      (x 8384)
      (y 480)
    )
    (unstable_tile
      (z-pos 0)
      (x 8352)
      (y 480)
    )
    (unstable_tile
      (z-pos 0)
      (x 8320)
      (y 480)
    )
    (unstable_tile
      (z-pos 0)
      (x 8448)
      (y 480)
    )
    (unstable_tile
      (z-pos 0)
      (x 8480)
      (y 480)
    )
    (unstable_tile
      (z-pos 0)
      (x 8512)
      (y 480)
    )
    (unstable_tile
      (z-pos 0)
      (x 8544)
      (y 480)
    )
    (unstable_tile
      (z-pos 0)
      (x 8576)
      (y 480)
    )
  )
)
