(supertux-level
  (version 3)
  (name (_ "The Frosted Fields"))
  (author "SuperTux Team")
  (license "GPL 2+ / CC-by-sa 3.0")
  (target-time 80)
  (allow-item-pocket "inherit")
  (icon "")
  (icon-locked "")
  (statistics
    (enable-coins #t)
    (enable-secrets #t)
  )
  (sector
    (name "main")
    (ambient-light
      (color 1 1 1)
    )
    (bouncingsnowball
      (z-pos 50)
      (x 3513)
      (y 475)
      (glinting #f)
    )
    (bouncingsnowball
      (z-pos 50)
      (x 3418)
      (y 475)
      (glinting #f)
    )
    (bouncingsnowball
      (z-pos 50)
      (x 5306)
      (y 375)
      (glinting #f)
    )
    (camera
      (name "Camera")
      (mode "normal")
    )
    (captainsnowball
      (z-pos 50)
      (x 9614)
      (y 372)
      (glinting #f)
    )
    (firefly
      (z-pos 0)
      (x 8480)
      (y 544)
    )
    (gradient
      (top_color 0.5 0.7 1)
      (bottom_color 1 1 1)
    )
    (jumpy
      (z-pos 50)
      (x 2097)
      (y 457)
      (glinting #f)
    )
    (jumpy
      (z-pos 50)
      (x 4724)
      (y 414)
      (glinting #f)
    )
    (jumpy
      (z-pos 50)
      (x 8787)
      (y 452)
      (glinting #f)
    )
    (jumpy
      (z-pos 50)
      (x 10252)
      (y 580)
      (glinting #f)
    )
    (jumpy
      (z-pos 50)
      (x 10798)
      (y 595)
      (glinting #f)
    )
    (jumpy
      (z-pos 50)
      (x 13195)
      (y 414)
      (glinting #f)
    )
    (jumpy
      (z-pos 50)
      (x 14127)
      (y 430)
      (glinting #f)
    )
    (jumpy
      (z-pos 50)
      (x 15119)
      (y 388)
      (glinting #f)
    )
    (jumpy
      (z-pos 50)
      (x 579)
      (y 527)
      (glinting #f)
    )
    (jumpy
      (z-pos 50)
      (x 7232)
      (y 418)
      (glinting #f)
    )
    (jumpy
      (z-pos 50)
      (x 7360)
      (y 392)
      (glinting #f)
    )
    (mrbomb
      (z-pos 50)
      (x 5757)
      (y 561)
      (glinting #f)
    )
    (mriceblock
      (z-pos 50)
      (x 1678)
      (y 485)
      (glinting #f)
    )
    (mriceblock
      (z-pos 50)
      (x 1976)
      (y 527)
      (glinting #f)
    )
    (mriceblock
      (z-pos 50)
      (x 2775)
      (y 413)
      (glinting #f)
    )
    (mriceblock
      (z-pos 50)
      (x 2721)
      (y 413)
      (glinting #f)
    )
    (mriceblock
      (z-pos 50)
      (x 2661)
      (y 413)
      (glinting #f)
    )
    (mriceblock
      (z-pos 50)
      (x 3931)
      (y 410)
      (glinting #f)
    )
    (mriceblock
      (z-pos 50)
      (x 4003)
      (y 412)
      (glinting #f)
    )
    (mriceblock
      (z-pos 50)
      (x 5907)
      (y 317)
      (glinting #f)
    )
    (mriceblock
      (z-pos 50)
      (x 5975)
      (y 317)
      (glinting #f)
    )
    (mriceblock
      (z-pos 50)
      (x 5876)
      (y 572)
      (glinting #f)
    )
    (mriceblock
      (z-pos 50)
      (x 5963)
      (y 570)
      (glinting #f)
    )
    (mriceblock
      (z-pos 50)
      (x 7939)
      (y 572)
      (glinting #f)
    )
    (mriceblock
      (z-pos 50)
      (x 10198)
      (y 316)
      (glinting #f)
    )
    (mriceblock
      (z-pos 50)
      (x 11132)
      (y 538)
      (glinting #f)
    )
    (mriceblock
      (z-pos 50)
      (x 11229)
      (y 538)
      (glinting #f)
    )
    (mriceblock
      (z-pos 50)
      (x 11311)
      (y 538)
      (glinting #f)
    )
    (mriceblock
      (z-pos 50)
      (x 11724)
      (y 380)
      (glinting #f)
    )
    (mriceblock
      (z-pos 50)
      (x 13730)
      (y 378)
      (glinting #f)
    )
    (mriceblock
      (z-pos 50)
      (x 13792)
      (y 380)
      (glinting #f)
    )
    (mriceblock
      (z-pos 50)
      (x 14669)
      (y 379)
      (glinting #f)
    )
    (mriceblock
      (z-pos 50)
      (x 14740)
      (y 378)
      (glinting #f)
    )
    (music
      (file "music/chipdisko.ogg")
    )
    (path
      (name "gen17713485581566836284656")
      (path
        (adapt_speed #f)
        (node
          (x 6976)
          (y 480)
        )
      )
    )
    (secretarea
      (fade-tilemap "Secret")
      (width 348)
      (height 96)
      (x 7104)
      (y 672)
    )
    (smartball
      (z-pos 50)
      (x 8086)
      (y 562)
      (glinting #f)
    )
    (smartball
      (z-pos 50)
      (x 12713)
      (y 405)
      (glinting #f)
    )
    (smartball
      (z-pos 50)
      (x 12779)
      (y 406)
      (glinting #f)
    )
    (smartball
      (z-pos 50)
      (x 9688)
      (y 373)
      (glinting #f)
    )
    (snowball
      (z-pos 50)
      (x 1213)
      (y 571)
      (glinting #f)
    )
    (snowball
      (z-pos 50)
      (x 1131)
      (y 571)
      (glinting #f)
    )
    (snowball
      (z-pos 50)
      (x 5354)
      (y 374)
      (glinting #f)
    )
    (snowball
      (z-pos 50)
      (x 4659)
      (y 562)
      (glinting #f)
    )
    (snowball
      (z-pos 50)
      (x 4585)
      (y 563)
      (glinting #f)
    )
    (snowball
      (z-pos 50)
      (x 8029)
      (y 566)
      (glinting #f)
    )
    (snowball
      (z-pos 50)
      (x 11854)
      (y 378)
      (glinting #f)
    )
    (spawnpoint
      (name "main")
      (x 96)
      (y 544)
    )
    (spiky
      (z-pos 50)
      (x 9101)
      (y 565)
      (glinting #f)
    )
    (spiky
      (z-pos 50)
      (x 9168)
      (y 564)
      (glinting #f)
    )
    (tilemap
      (solid #f)
      (z-pos -100)
      (name "Background")
      (width 510)
      (height 25)
      (tiles -4883 0 28 -2 0 28 -692 0 130 -204 0 28 -65 0 24 -73 0 28 -2 0 28 -46 0 2062 2051 -2 2066 2070 2060 2061 2070 2060 -3 2066 2061 2066 2050 2064 -99 0 129 -194 0 24 -133 0 24 -10 0 24 -52 0 24 -2 0 2057 2061 2066 2061 2060 2065 2070 -3 2058 2060 2061 2050 2064 -11 0 106 107 108 -35 0 24 -31 0 24 -18 0 129 -395 0 2057 2060 2066 -2 2070 2066 2070 2060 -2 2065 2058 2050 2064 -12 0 109 110 111 -7 0 24 -78 0 129 -373 0 122 123 -20 0 2057 2070 2060 2058 2070 2060 -2 2070 2065 2061 2050 2064 -32 0 106 107 108 -67 0 129 -104 0 2062 2051 2060 2070 -2 2061 2065 2060 -2 2058 2066 2061 2070 2050 2064 -27 0 2062 2051 2058 -2 2060 2066 2070 2061 2050 2064 -217 0 124 125 0 122 123 -17 0 2057 2065 2061 2065 -2 2070 2065 2060 2070 2065 2059 -33 0 109 110 111 -2 0 24 -64 0 129 -26 0 106 107 108 -76 0 2057 2066 2070 2060 2058 2061 2058 2065 2058 2066 2065 2061 2059 -29 0 2057 2060 2065 2061 2065 2061 2058 2059 -35 0 24 -21 0 122 123 0 122 123 -33 0 24 -119 0 122 123 0 124 125 0 124 125 -17 0 2057 2058 2070 2058 2061 -2 2060 2061 -2 2065 2059 -103 0 129 8 -4 0 24 -9 0 -10 8 0 109 110 111 -13 0 106 107 108 -28 0 106 107 108 -29 0 2057 2061 2058 2061 2066 -2 2058 2070 2058 2061 2060 2065 2059 -10 0 2062 2051 -2 2058 2065 2060 2058 2070 2060 2070 2066 2050 2064 -6 0 2057 2066 2061 2060 2058 2061 2065 2059 -54 0 122 123 0 124 125 0 124 125 0 122 123 -21 0 106 107 108 -50 0 106 107 108 -67 0 122 123 0 122 123 0 124 125 0 124 125 0 124 125 -3 0 24 -13 0 2057 2066 2061 2070 2066 2070 -2 2061 2058 2061 2059 -139 0 24 -6 0 109 110 111 -6 0 24 0 25 -17 0 24 0 109 110 111 24 -5 0 -2 8 -2 0 24 -7 0 24 -2 8 -5 0 24 -2 0 2057 2058 2060 2058 2060 2058 2070 -2 2061 -2 2060 2058 2059 -6 0 24 -4 0 2057 2061 2066 2058 2066 2070 -2 2058 2060 2065 2059 -7 0 2057 2065 2061 2058 -2 2070 2066 2059 -4 0 25 -4 0 -2 8 -11 0 -2 8 -22 0 24 -7 0 124 125 24 124 125 0 124 125 0 124 125 24 -20 0 109 110 111 -40 0 24 -9 0 109 110 111 24 -6 0 -2 8 -37 0 106 107 108 -15 0 122 123 0 124 125 0 124 125 -26 0 2057 2065 2066 2061 -2 2070 2065 2066 2058 2061 2059 -447 0 109 110 111 -7 0 24 -7 0 124 125 24 124 125 0 124 125 -26 0 2057 -2 2070 2061 2066 2061 -2 2060 2061 2050 2064 -499 0 2057 -2 2060 2058 -2 2065 2070 2066 2061 2059 -63 0 2087 2088 -4 0 2087 2088 -429 0 2057 2066 2065 2066 2070 2060 2070 2058 2060 2059 -500 0 2057 2061 2070 2058 2070 -2 2066 2060 2050 2064 -357 0 -11 8 -132 0 2057 2070 2065 -2 2066 2065 2061 2050 2064 -501 0 2057 2066 -2 2070 2066 2065 2061 2059 -137 0)
    )
    (tilemap
      (solid #t)
      (z-pos 0)
      (name "Interactive")
      (width 510)
      (height 25)
      (tiles -480 0 133 -22 0 -2 132 -485 0 133 -22 0 -2 132 -485 0 133 -22 0 -2 132 -485 0 133 -22 0 -2 132 -485 0 133 -22 0 -2 132 -485 0 133 -22 0 -2 132 -485 0 133 -22 0 -2 132 -36 0 83 -213 0 103 27 -9 28 29 -223 0 133 -22 0 -2 132 -485 0 133 -22 0 -2 132 -297 0 27 83 -2 28 102 29 -9 0 -2 83 -55 0 2067 -14 2068 2069 -100 0 133 -22 0 -2 132 -83 0 83 -5 0 83 -159 0 7 8 9 -117 0 2072 -14 2073 2074 -100 0 133 -22 0 -2 132 -34 0 83 -3 0 102 -138 0 27 28 128 -4 28 29 27 -6 28 29 -52 0 7 8 9 0 13 14 15 -66 0 27 83 -2 28 83 28 29 -160 0 133 -14 0 126 -7 0 -2 132 -169 0 7 -3 8 9 -17 0 27 -6 28 29 -42 0 7 8 9 0 13 14 15 0 10 11 12 -49 0 7 -6 8 9 -2 0 7 -2 8 9 -48 0 7 -12 8 9 -49 0 7 -11 8 9 -16 0 7 -11 8 9 -17 0 133 -22 0 -2 132 -79 0 2067 -13 2068 2069 -27 0 2067 -8 2068 2069 -38 0 13 -3 14 15 -22 0 27 -6 28 29 -32 0 7 -2 8 9 0 13 14 15 0 10 11 12 0 10 11 12 -49 0 13 -6 14 15 -2 0 13 -2 14 15 -48 0 13 -12 14 15 -6 0 102 -10 0 7 -11 8 9 -19 0 13 -11 14 15 -16 0 13 -11 14 15 -17 0 133 -22 0 -2 132 -79 0 2072 -13 2073 2074 -27 0 2072 -8 2073 2074 -38 0 10 19 -2 11 12 -58 0 7 8 9 0 13 -2 14 15 0 10 11 12 0 10 11 12 0 10 11 12 -49 0 10 -6 11 12 -2 0 10 -2 11 12 -3 0 7 -4 8 9 -39 0 10 -12 11 12 -17 0 13 -11 14 15 -19 0 10 -11 11 12 -4 0 2085 2086 -4 0 2085 2086 -4 0 10 -11 11 12 -17 0 133 -22 0 -2 132 -30 0 83 -3 0 83 -3 0 83 -3 0 83 -60 0 2067 -11 2068 2069 -23 0 2085 2086 -5 0 102 -5 0 2085 2086 -15 0 10 -3 11 12 -5 0 47 -48 0 7 8 9 0 13 14 15 0 10 -2 11 12 0 10 11 12 0 10 11 12 0 10 11 12 -49 0 10 -6 11 12 -2 0 10 11 19 12 -3 0 13 -4 14 15 -37 0 7 8 22 -12 11 12 -5 0 7 -4 8 9 -6 0 10 -11 11 12 -2 0 7 -16 8 22 -11 11 12 -4 0 2087 2088 -4 0 2087 2088 -4 0 10 -11 11 12 -17 0 133 -22 0 -2 132 -70 0 2085 2086 -31 0 2072 -11 2073 2074 -23 0 2087 2088 -11 0 2087 2088 -10 0 7 -4 8 22 -3 11 12 -50 0 7 8 9 0 13 14 15 0 10 11 12 0 10 30 17 18 0 16 17 18 0 10 11 12 0 10 11 12 -27 0 2085 2086 -15 0 7 -4 8 22 -6 11 12 -2 0 10 -2 11 12 -3 0 10 11 19 -2 11 12 -37 0 13 14 23 -12 11 21 9 -4 0 13 -4 14 15 -6 0 16 -11 17 18 -2 0 13 -16 14 23 -11 11 12 -4 0 2087 2088 0 27 29 0 2087 2088 -4 0 10 -11 11 12 -15 0 7 8 133 -14 8 -4 0 -4 8 -2 132 -4 8 9 -52 0 2085 2086 -11 0 2087 2088 -67 0 2087 2088 -11 0 2087 2088 -10 0 13 -4 14 23 -3 11 12 -50 0 13 14 15 0 10 11 12 0 10 11 21 8 22 12 0 7 9 -4 0 16 17 18 0 16 17 18 -27 0 2087 2088 -15 0 13 -4 14 23 11 19 -4 11 12 -2 0 10 -2 11 12 -3 0 16 -4 17 18 -20 0 7 -16 8 22 -14 11 20 15 -4 0 10 11 19 -2 11 12 -21 0 10 -28 11 12 -4 0 2087 2088 -4 0 2087 2088 -4 0 10 -11 11 12 -15 0 13 -30 14 15 7 -51 8 2087 2088 -11 8 2087 2088 -67 8 2087 2088 -11 8 2087 2088 -10 8 22 -8 11 21 -28 8 9 -6 0 7 -14 8 22 11 12 0 10 11 21 8 22 11 20 14 23 12 0 13 113 -20 8 9 -6 0 7 -10 8 2087 2088 -15 8 22 -11 11 12 -2 0 10 -2 11 12 -29 0 13 -16 14 23 -14 11 30 18 -4 0 16 -4 17 18 -21 0 10 -28 11 12 -4 0 2087 2088 -4 0 2087 2088 -4 0 10 -11 11 12 -15 0 10 -30 11 12 13 -158 14 23 19 -7 11 20 -28 14 15 -6 0 13 -14 14 23 11 12 0 10 11 20 14 23 -3 11 30 18 0 10 20 -20 14 15 -6 0 13 -27 14 23 19 -10 11 12 -2 0 10 -2 11 12 -3 0 7 8 9 0 7 8 9 0 7 -17 8 22 -31 11 12 -32 0 10 -28 11 12 -4 0 2087 2088 -4 2178 2087 2088 -4 0 10 -11 11 12 -15 0 10 -30 11 12 10 19 -70 11 19 -30 11 19 -30 11 19 -32 11 19 -29 11 12 -6 0 10 -16 11 12 0 16 -7 17 18 -2 0 10 -21 11 12 -6 0 10 -38 11 30 18 -2 0 10 19 11 12 -3 0 13 14 15 0 13 14 15 0 13 -17 14 23 -31 11 12 -32 0 10 -28 11 12 -4 0 27 -6 28 29 -4 0 10 -11 11 12 -15 0 10 -30 11 12 10 -196 11 12 -6 0 10 -16 11 12 -11 0 7 22 -21 11 12 -6 0 10 -38 11 12 -3 0 10 -2 11 12 0 48 0 10 11 12 0 10 11 12 0 10 -49 11 12 -32 0 10 -28 11 12 -4 0 2087 2088 -4 0 2087 2088 -4 0 10 -11 11 12 -15 0 10 -30 11 12 10 -196 11 12 -6 0 10 -16 11 12 -10 44 0 13 23 -21 11 12 -6 0 10 -38 11 12 -3 0 10 -2 11 12 0 203 0 10 11 12 0 10 11 12 0 10 -49 11 12 -32 0 10 -28 11 12 -4 0 2087 2088 -4 0 2087 2088 -4 0 10 -11 11 12 -15 0 10 -30 11 12 10 -196 11 12 -6 0 10 -16 11 21 -10 44 0 22 -22 11 12 -6 0 10 -38 11 12 -3 0 10 -2 11 12 0 206 0 10 11 12 0 10 11 12 0 10 -49 11 12 -32 0 10 -28 11 12 -4 0 2087 2088 -4 0 2087 2088 -4 0 10 -11 11 12 -15 0 10 -30 11 12 10 -196 11 12 -6 0 10 -16 11 20 -11 14 23 -22 11 12 -6 0 10 -38 11 12 -3 0 10 -2 11 12 0 206 0 10 11 12 0 10 11 12 0 10 -49 11 12 -32 0 10 -28 11 12 -4 0 2087 2088 -4 0 2087 2088 -4 0 10 -11 11 12 -15 0 10 -30 11 12)
    )
    (tilemap
      (solid #f)
      (z-pos 100)
      (name "Foreground")
      (width 510)
      (height 25)
      (tiles -5581 0 130 -509 0 129 -16 0 127 -492 0 129 -509 0 129 -509 0 129 -509 0 129 -509 0 129 -590 0 -2 8 -11 0 -2 8 -67 0 -2 8 -11 0 -2 8 -125 0 -2 8 -1565 0 202 -1728 0)
    )
    (tilemap
      (handle
        (scale_x 0)
        (scale_y 0)
        (offset_x 0)
        (offset_y 0)
      )
      (solid #f)
      (z-pos 60)
      (name "Secret")
      (path-ref "gen17713485581566836284656")
      (width 20)
      (height 10)
      (tiles -34 0 -2 11 12 -17 0 -2 11 21 -17 0 -2 11 20 -6 0 21 8 22 -7 0 -4 11 -6 0 20 14 23 -11 11 -6 0 11 115 116 -11 11 -6 0 11 117 118 -11 11 -6 0 -13 11 -7 0 -13 11 -4 0)
    )
    (tilemap
      (solid #f)
      (z-pos -150)
      (name "Background2")
      (width 510)
      (height 25)
      (tiles -6361 0 2185 -4 2199 2186 -500 0 2185 -3 2199 2200 2197 2189 2197 2179 2190 -365 0 122 209 123 -127 0 2185 -4 2199 2200 2188 2197 2179 2197 -2 2189 2180 2188 2190 -365 0 124 210 125 -123 0 2185 -3 2199 2200 2197 2195 -2 2180 2179 2188 2187 2197 2195 2197 2196 2179 2181 2190 -361 0 122 209 123 0 124 210 125 -119 0 2185 -3 2199 2200 2181 2195 2181 2180 2188 2195 2188 2187 2195 2180 2181 2197 2180 2189 2188 2179 2180 2190 -361 0 124 210 125 0 124 210 125 0 122 209 123 -112 0 -3 2199 2200 2179 -2 2187 2181 2197 2181 2195 2181 2195 2189 2188 2195 2181 2197 2180 2197 2196 2195 2181 2187 2196 2190 -361 0 124 210 125 0 124 210 125 0 124 210 125 -112 0 2197 2196 2188 2187 2181 2188 2179 2181 2187 2181 2196 2189 2197 2188 2181 2189 2179 2197 2195 2189 2197 2188 2195 2179 2181 2190 -484 0 2189 2196 2181 2195 2197 -2 2189 2195 -2 2196 2195 2196 2195 2188 2181 2187 2179 2187 2197 2180 2179 2197 2180 -2 2197 2190 -484 0 -2 2187 2195 2189 -2 2197 2189 2197 2179 2188 2196 2180 -2 2189 2180 2179 2180 2195 2181 2195 2197 2187 2195 2180 2179 2190 -484 0 2181 2187 2195 2181 2179 2195 2179 2195 2196 2189 2196 2180 2181 2189 2179 2197 2179 2187 2197 -2 2179 2181 2197 2188 2179 2190 -484 0 2180 -2 2197 2187 2180 2179 2187 2189 2188 2196 2180 2179 2197 2188 -2 2197 -2 2180 2179 2196 -2 2187 2195 -2 2189 2190 -484 0 2196 2189 2179 2181 2195 2196 2188 -2 2195 2187 2188 2187 2181 -2 2188 2181 2196 2187 2196 2180 2188 2179 2181 2197 2196 2190 -484 0 2195 2187 2196 -2 2188 2196 2187 2196 2195 2179 2196 2180 2195 2189 2179 -2 2187 -2 2181 2189 -2 2195 -2 2187 2179 2190 -263 0)
    )
    (tilemap
      (solid #f)
      (speed-x 0.5)
      (speed-y 0.5)
      (z-pos -200)
      (name "Background_para1")
      (width 340)
      (height 25)
      (tiles -887 0 85 86 87 88 -29 0 85 86 87 88 -77 0 85 86 87 88 -30 0 85 86 87 88 -50 0 85 86 87 88 -51 0 85 86 87 88 -19 0 85 86 87 88 -22 0 85 86 87 88 -30 0 89 90 91 92 -12 0 85 86 87 88 -13 0 89 90 91 92 -47 0 85 86 87 88 -21 0 85 86 87 88 0 89 90 91 92 -30 0 89 90 91 92 -10 0 85 86 87 88 -8 0 85 86 87 88 -24 0 89 90 91 92 -12 0 85 86 87 88 -35 0 89 90 91 92 -19 0 89 90 91 92 -11 0 85 86 87 88 -7 0 89 90 91 92 -14 0 85 86 87 88 -28 0 89 90 91 92 -44 0 85 86 87 88 -16 0 89 90 91 92 -21 0 89 90 91 92 -49 0 89 90 91 92 -8 0 89 90 91 92 -17 0 85 86 87 88 -19 0 89 90 91 92 -73 0 89 90 91 92 -25 0 89 90 91 92 -59 0 85 86 87 88 -13 0 89 90 91 92 -127 0 89 90 91 92 -36 0 85 86 87 88 -148 0 89 90 91 92 -184 0 89 90 91 92 -921 0 149 -3 160 151 -35 0 149 -3 160 151 -35 0 149 -3 160 151 -32 0 149 -3 160 151 -35 0 149 -3 160 151 -35 0 149 -3 160 151 -32 0 149 -3 160 151 -35 0 149 -3 160 151 -35 0 149 -3 160 151 -20 0 149 159 -3 153 154 -34 0 149 159 -3 153 154 -34 0 149 159 -3 153 154 -31 0 149 159 -3 153 154 -34 0 149 159 -3 153 154 -34 0 149 159 -3 153 154 -31 0 149 159 -3 153 154 -34 0 149 159 -3 153 154 -34 0 149 159 -3 153 154 -18 0 149 160 159 -4 153 154 -32 0 149 160 159 -4 153 154 -32 0 149 160 159 -4 153 154 -29 0 149 160 159 -4 153 154 -32 0 149 160 159 -4 153 154 -32 0 149 160 159 -4 153 154 -29 0 149 160 159 -4 153 154 -32 0 149 160 159 -4 153 154 -32 0 149 160 159 -4 153 154 -18 0 152 -6 153 154 -32 0 152 -6 153 154 -32 0 152 -6 153 154 -29 0 152 -6 153 154 -32 0 152 -6 153 154 -32 0 152 -6 153 154 -29 0 152 -6 153 154 -32 0 152 -6 153 154 -32 0 152 -6 153 154 -18 0 152 -6 153 158 -2 160 151 -29 0 152 -6 153 158 -2 160 151 -29 0 152 -6 153 158 -2 160 151 -26 0 152 -6 153 158 -2 160 151 -29 0 152 -6 153 158 -2 160 151 -29 0 152 -6 153 158 -2 160 151 -26 0 152 -6 153 158 -2 160 151 -29 0 152 -6 153 158 -2 160 151 -29 0 152 -6 153 158 -2 160 151 -11 0 -4 160 159 -9 153 158 -3 160 151 -12 0 149 160 151 -4 0 149 -5 160 159 -9 153 158 -3 160 151 -12 0 149 160 151 -4 0 149 -5 160 159 -9 153 158 -3 160 151 -12 0 149 160 151 -3 0 149 -3 160 159 -9 153 158 -3 160 151 -12 0 149 160 151 -4 0 149 -5 160 159 -9 153 158 -3 160 151 -12 0 149 160 151 -4 0 149 -5 160 159 -9 153 158 -3 160 151 -12 0 149 160 151 -3 0 -4 160 159 -9 153 158 -3 160 151 -12 0 149 160 151 -4 0 149 -5 160 159 -9 153 158 -3 160 151 -12 0 149 160 151 -4 0 149 -5 160 159 -9 153 158 -3 160 151 -7 0 -18 153 154 -4 0 149 -5 160 151 0 152 153 158 -2 160 151 0 152 -19 153 154 -4 0 149 -5 160 151 0 152 153 158 -2 160 151 0 152 -19 153 154 -4 0 149 -5 160 151 0 152 153 158 -3 160 159 -17 153 154 -4 0 149 -5 160 151 0 152 153 158 -2 160 151 0 152 -19 153 154 -4 0 149 -5 160 151 0 152 153 158 -2 160 151 0 152 -19 153 154 -4 0 149 -5 160 151 0 152 153 158 -3 160 -18 153 154 -4 0 149 -5 160 151 0 152 153 158 -2 160 151 0 152 -19 153 154 -4 0 149 -5 160 151 0 152 153 158 -2 160 151 0 152 -19 153 154 -7 0 -18 153 158 -4 160 159 -5 153 158 160 159 -4 153 154 0 152 -19 153 158 -4 160 159 -5 153 158 160 159 -4 153 154 0 152 -19 153 158 -4 160 159 -5 153 158 160 159 -23 153 158 -4 160 159 -5 153 158 160 159 -4 153 154 0 152 -19 153 158 -4 160 159 -5 153 158 160 159 -4 153 154 0 152 -19 153 158 -4 160 159 -5 153 158 160 159 -23 153 158 -4 160 159 -5 153 158 160 159 -4 153 154 0 152 -19 153 158 -4 160 159 -5 153 158 160 159 -4 153 154 0 152 -19 153 158 -7 160 -36 153 154 0 152 -37 153 154 0 152 -74 153 154 0 152 -37 153 154 0 152 -74 153 154 0 152 -37 153 154 0 152 -63 153 154 0 152 -37 153 154 0 152 -74 153 154 0 152 -37 153 154 0 152 -74 153 154 0 152 -37 153 154 0 152 -63 153 154 0 152 -37 153 154 0 152 -74 153 154 0 152 -37 153 154 0 152 -74 153 154 0 152 -37 153 154 0 152 -63 153 154 0 152 -37 153 154 0 152 -74 153 154 0 152 -37 153 154 0 152 -74 153 154 0 152 -37 153 154 0 152 -63 153 154 0 152 -37 153 154 0 152 -74 153 154 0 152 -37 153 154 0 152 -74 153 154 0 152 -37 153 154 0 152 -63 153 154 0 152 -37 153 154 0 152 -74 153 154 0 152 -37 153 154 0 152 -74 153 154 0 152 -37 153 154 0 152 -63 153 154 0 152 -37 153 154 0 152 -74 153 154 0 152 -37 153 154 0 152 -74 153 154 0 152 -37 153 154 0 152 -27 153)
    )
    (tilemap
      (solid #f)
      (speed-x 0.2)
      (speed-y 0.2)
      (z-pos -250)
      (name "Background_para2")
      (width 170)
      (height 25)
      (tiles -1727 0 161 -5 162 163 -31 0 161 -5 162 163 -31 0 161 -5 162 163 -34 0 161 -5 162 163 -42 0 161 -3 162 171 -5 165 166 -27 0 161 -3 162 171 -5 165 166 -27 0 161 -3 162 171 -5 165 166 -30 0 161 -3 162 171 -5 165 166 -22 0 161 -8 162 163 -5 0 161 163 -3 0 164 -9 165 166 0 161 162 163 -3 0 161 -8 162 163 -5 0 161 163 -3 0 164 -9 165 166 0 161 162 163 -3 0 161 -8 162 163 -5 0 161 163 -3 0 164 -9 165 166 0 161 162 163 -6 0 161 -8 162 163 -5 0 161 163 -3 0 164 -9 165 166 0 161 162 163 -3 0 161 -8 162 163 -2 0 -3 162 171 -8 165 166 -3 0 161 162 171 166 -3 0 164 -9 165 170 162 171 165 170 -3 162 171 -8 165 166 -3 0 161 162 171 166 -3 0 164 -9 165 170 162 171 165 170 -3 162 171 -8 165 166 -3 0 161 162 171 166 -3 0 164 -9 165 170 162 171 165 170 -6 162 171 -8 165 166 -3 0 161 162 171 166 -3 0 164 -9 165 170 162 171 165 170 -3 162 171 -8 165 166 -2 0 -12 165 170 -3 162 171 -2 165 170 -3 162 171 -26 165 170 -3 162 171 -2 165 170 -3 162 171 -26 165 170 -3 162 171 -2 165 170 -3 162 171 -29 165 170 -3 162 171 -2 165 170 -3 162 171 -26 165 170 -2 162 -1700 165)
    )
    (trampoline
      (type "stationary")
      (z-pos 50)
      (x 9952)
      (y 640)
    )
    (unstable_tile
      (z-pos 0)
      (x 14912)
      (y 448)
    )
    (unstable_tile
      (z-pos 0)
      (x 14944)
      (y 448)
    )
    (unstable_tile
      (z-pos 0)
      (x 14976)
      (y 448)
    )
    (unstable_tile
      (z-pos 0)
      (x 15008)
      (y 448)
    )
    (unstable_tile
      (z-pos 0)
      (x 15040)
      (y 448)
    )
    (unstable_tile
      (z-pos 0)
      (x 15072)
      (y 448)
    )
    (unstable_tile
      (z-pos 0)
      (x 15104)
      (y 448)
    )
    (unstable_tile
      (z-pos 0)
      (x 15136)
      (y 448)
    )
    (unstable_tile
      (z-pos 0)
      (x 15168)
      (y 448)
    )
  )
)
