(supertux-level
  (version 3)
  (name (_ "23rd Airborne"))
  (author "SuperTux Team")
  (license "GPL 2+ / CC-by-sa 3.0")
  (target-time 80)
  (allow-item-pocket "inherit")
  (icon "")
  (icon-locked "")
  (statistics
    (enable-coins #t)
    (enable-secrets #t)
  )
  (sector
    (name "main")
    (ambient-light
      (color 1 1 1)
    )
    (background
      (scroll-offset-y -300)
      (color 1 1 1)
      (speed 0.5)
      (image-top "images/background/bluemountain-top.png")
      (image "images/background/bluemountain-middle.png")
      (image-bottom "images/background/bluemountain-bottom.png")
    )
    (bouncingsnowball
      (z-pos 50)
      (x 13034)
      (y 123)
      (glinting #f)
    )
    (bouncingsnowball
      (z-pos 50)
      (x 12929)
      (y 96)
      (glinting #f)
    )
    (bouncingsnowball
      (z-pos 50)
      (x 8347)
      (y 37)
      (glinting #f)
    )
    (bouncingsnowball
      (z-pos 50)
      (direction "left")
      (x 8320)
      (y 736)
      (glinting #f)
    )
    (bouncingsnowball
      (z-pos 50)
      (direction "left")
      (x 8192)
      (y 800)
      (glinting #f)
    )
    (camera
      (name "Camera")
      (mode "normal")
    )
    (captainsnowball
      (z-pos 50)
      (x 14905)
      (y 227)
      (glinting #f)
    )
    (captainsnowball
      (z-pos 50)
      (x 15202)
      (y 197)
      (glinting #f)
    )
    (crusher
      (z-pos 50)
      (x 5248)
      (y 880)
    )
    (crusher
      (z-pos 50)
      (x 7328)
      (y 880)
    )
    (crusher
      (z-pos 50)
      (x 7392)
      (y 880)
    )
    (firefly
      (z-pos 0)
      (x 7889)
      (y 327)
    )
    (flyingsnowball
      (z-pos 50)
      (x 4556)
      (y 240)
      (glinting #f)
    )
    (flyingsnowball
      (z-pos 50)
      (x 4646)
      (y 240)
      (glinting #f)
    )
    (flyingsnowball
      (z-pos 50)
      (x 1248)
      (y 176)
      (glinting #f)
    )
    (flyingsnowball
      (z-pos 50)
      (x 1440)
      (y 128)
      (glinting #f)
    )
    (flyingsnowball
      (z-pos 50)
      (x 1823)
      (y 65)
      (glinting #f)
    )
    (flyingsnowball
      (z-pos 50)
      (x 1634)
      (y 100)
      (glinting #f)
    )
    (flyingsnowball
      (z-pos 50)
      (x 12609)
      (y 282)
      (glinting #f)
    )
    (flyingsnowball
      (z-pos 50)
      (x 12928)
      (y 288)
      (glinting #f)
    )
    (flyingsnowball
      (z-pos 50)
      (x 3515)
      (y 188)
      (glinting #f)
    )
    (flyingsnowball
      (z-pos 50)
      (x 3727)
      (y 194)
      (glinting #f)
    )
    (haywire
      (z-pos 50)
      (x 4512)
      (y 1120)
      (glinting #f)
    )
    (jumpy
      (z-pos 50)
      (x 6640)
      (y 288)
      (glinting #f)
    )
    (jumpy
      (z-pos 50)
      (x 6863)
      (y 215)
      (glinting #f)
    )
    (jumpy
      (z-pos 50)
      (x 7087)
      (y 289)
      (glinting #f)
    )
    (jumpy
      (z-pos 50)
      (x 7447)
      (y 219)
      (glinting #f)
    )
    (jumpy
      (z-pos 50)
      (x 9323)
      (y 312)
      (glinting #f)
    )
    (jumpy
      (z-pos 50)
      (x 9783)
      (y 386)
      (glinting #f)
    )
    (jumpy
      (z-pos 50)
      (x 12229)
      (y 244)
      (glinting #f)
    )
    (jumpy
      (z-pos 50)
      (x 4976)
      (y 1056)
      (glinting #f)
    )
    (mrbomb
      (z-pos 50)
      (x 5833)
      (y 353)
      (glinting #f)
    )
    (mrbomb
      (z-pos 50)
      (x 6091)
      (y 334)
      (glinting #f)
    )
    (mrbomb
      (z-pos 50)
      (x 10446)
      (y 231)
      (glinting #f)
    )
    (mrbomb
      (z-pos 50)
      (x 5792)
      (y 992)
      (glinting #f)
    )
    (mriceblock
      (z-pos 50)
      (x 613)
      (y 367)
      (glinting #f)
    )
    (mriceblock
      (z-pos 50)
      (x 11782)
      (y 136)
      (glinting #f)
    )
    (mriceblock
      (z-pos 50)
      (x 11730)
      (y 141)
      (glinting #f)
    )
    (mriceblock
      (z-pos 50)
      (x 11673)
      (y 140)
      (glinting #f)
    )
    (music
      (file "music/airship_remix.music")
    )
    (path
      (name "gen17713485741566962022320")
      (path
        (adapt_speed #f)
        (node
          (x 8000)
          (y 352)
        )
      )
    )
    (scripttrigger
      (script "secret2.fade (0.0, 1.0);")
      (button #f)
      (width 32)
      (height 224)
      (x 7616)
      (y 928)
    )
    (secretarea
      (fade-tilemap "secret1")
      (width 60)
      (height 156)
      (x 0)
      (y 0)
    )
    (secretarea
      (fade-tilemap "secret2")
      (width 927.1973)
      (height 95.63959)
      (x 8032.575)
      (y 370.0123)
    )
    (smartball
      (z-pos 50)
      (x 5440)
      (y 1120)
      (glinting #f)
    )
    (smartball
      (z-pos 50)
      (x 5504)
      (y 1120)
      (glinting #f)
    )
    (smartball
      (z-pos 50)
      (x 5568)
      (y 1120)
      (glinting #f)
    )
    (smartball
      (z-pos 50)
      (x 11113)
      (y 319)
      (glinting #f)
    )
    (smartball
      (z-pos 50)
      (x 11177)
      (y 321)
      (glinting #f)
    )
    (smartball
      (z-pos 50)
      (x 11242)
      (y 323)
      (glinting #f)
    )
    (smartball
      (z-pos 50)
      (x 796)
      (y 362)
      (glinting #f)
    )
    (smartball
      (z-pos 50)
      (x 4932)
      (y 202)
      (glinting #f)
    )
    (smartblock
      (z-pos 50)
      (x 8885)
      (y 308)
      (glinting #f)
    )
    (smartblock
      (z-pos 50)
      (x 7773)
      (y 360)
      (glinting #f)
    )
    (smartblock
      (z-pos 50)
      (x 8825)
      (y 307)
      (glinting #f)
    )
    (smartblock
      (z-pos 50)
      (x 8764)
      (y 306)
      (glinting #f)
    )
    (smartblock
      (z-pos 50)
      (x 7817)
      (y 361)
      (glinting #f)
    )
    (snowball
      (z-pos 50)
      (x 736)
      (y 363)
      (glinting #f)
    )
    (snowball
      (z-pos 50)
      (direction "left")
      (x 7168)
      (y 1120)
      (glinting #f)
    )
    (snowball
      (z-pos 50)
      (direction "left")
      (x 7264)
      (y 1120)
      (glinting #f)
    )
    (snowball
      (z-pos 50)
      (direction "left")
      (x 7360)
      (y 1120)
      (glinting #f)
    )
    (snowman
      (z-pos 50)
      (direction "left")
      (x 7424)
      (y 1088)
      (glinting #f)
    )
    (spawnpoint
      (name "main")
      (x 96)
      (y 352)
    )
    (spiky
      (z-pos 50)
      (x 13796)
      (y 172)
      (glinting #f)
    )
    (spiky
      (z-pos 50)
      (x 13978)
      (y 174)
      (glinting #f)
    )
    (tilemap
      (solid #f)
      (z-pos -100)
      (width 515)
      (height 38)
      (tiles -999 0 130 -455 0 122 123 0 122 123 -54 0 129 -452 0 122 123 0 124 125 0 124 125 0 122 123 -51 0 129 -31 0 24 -420 0 124 125 0 124 125 0 124 125 0 124 125 -51 0 129 -89 0 106 107 108 -360 0 124 125 0 124 125 0 124 125 0 124 125 -51 0 129 -89 0 109 110 111 -356 0 24 -3 0 124 125 0 124 125 0 124 125 0 124 125 -39 0 106 107 108 -9 0 129 8 -14 0 -10 8 -6 0 17 18 -52 0 24 -416 0 109 110 111 -124 0 24 -237 0 24 -56 0 106 107 108 -83 0 24 -61 0 122 123 0 122 123 -55 0 24 -66 0 106 107 108 -20 0 106 107 108 -99 0 106 107 108 -77 0 122 123 0 122 123 -26 0 24 -3 0 109 110 111 -62 0 24 -79 0 122 123 0 124 125 0 124 125 0 122 123 -17 0 25 -101 0 109 110 111 -2 0 25 -17 0 109 110 111 -12 0 25 -33 0 122 123 -4 0 122 123 -45 0 109 110 111 -2 0 24 -62 0 106 107 108 -6 0 122 123 0 124 125 0 124 125 0 122 123 -169 0 122 123 0 124 125 0 124 125 0 124 125 0 124 125 0 122 123 -75 0 7 9 -20 0 24 -79 0 122 123 0 122 123 -6 0 124 125 -4 0 124 125 -5 0 122 123 0 122 123 -21 0 16 -10 17 -27 0 25 -5 0 24 -37 0 109 110 111 -6 0 124 125 0 124 125 0 124 125 0 124 125 -32 0 -3 8 -134 0 124 125 0 124 125 24 124 125 0 124 125 0 124 125 0 124 125 0 25 -167 0 24 -7 0 124 125 0 124 125 -4 0 24 0 124 125 -4 0 124 125 -5 0 124 125 0 124 125 25 -23 0 -5 8 9 -2 0 16 -17 17 18 -23 0 106 107 108 -468 0 -13 8 9 -3 0 7 -2 8 9 -23 0 109 110 111 -2 0 24 -7038 0 2192 2189 2180 2197 2187 2180 2197 -2 2180 2188 2189 2197 2188 2189 2180 2197 2189 2180 2197 2187 2190 -4 0 2192 2180 2181 2179 2188 2189 2180 2197 2187 2180 2197 2188 2189 2180 2197 2187 2180 2197 -2 2180 2188 2189 2197 2188 2189 2180 2197 2188 2189 2197 2180 2181 2179 2180 2181 2179 2180 -2 2181 2179 2187 2180 2197 -2 2180 2181 2179 2188 2189 2180 2197 2187 2180 2197 2188 2189 2180 2197 2187 2180 2197 -2 2180 2181 2179 2188 2189 2180 2197 2187 2180 2197 2190 -417 0 2192 2196 2180 2181 2179 2180 2181 2179 2188 2180 2197 2187 2195 2196 2180 2181 2196 2180 2181 2179 2190 -4 0 2192 2188 2189 2197 2195 2196 2180 2181 2179 2180 2181 2195 2196 2180 2181 2179 2180 2181 2179 2188 2180 2197 2187 2195 2196 2180 2181 2180 -2 2197 -2 2180 2181 2188 2189 2197 2188 2189 2180 2181 2179 2180 2181 2179 2188 2189 2197 2195 2196 2180 2181 2179 2180 2181 2195 2196 2180 2181 2179 2180 2181 2179 2188 2189 2197 2195 2196 2180 2181 2179 2180 2181 2190 -417 0 2192 2181 2179 2180 2181 2188 2189 2197 2180 2181 2179 2180 -2 2181 2179 2180 2181 2179 2180 2181 2190 -4 0 2192 2180 2197 2187 2180 2181 2179 2180 2181 2188 2189 2180 2181 2179 2180 2181 2188 2189 2197 2180 2181 2179 2180 2181 2179 2180 -2 2181 -2 2179 2180 2188 2189 2180 2197 2187 2195 2196 2188 2189 2181 2188 2189 2197 2180 2197 2187 2180 2181 2179 2180 2181 2188 2189 2180 2181 2179 2180 2181 2188 2189 2197 2180 2197 2187 2180 2181 2179 2180 2181 2188 2189 2190 -417 0 2192 2179 2180 -2 2181 2188 2189 2197 -2 2180 2181 2188 2189 2179 2180 2181 2179 2180 -2 2181 2190 -4 0 2192 2179 2180 2181 2179 2188 2189 2197 2195 2196 2180 2181 2179 2180 -2 2181 2188 2189 2197 -2 2180 2181 2188 2189 2197 2188 2189 2180 2181 2197 2188 2195 2196 2180 2181 2179 2180 2181 2195 2196 2189 2180 2197 2179 2180 2181 -2 2188 2189 2197 2188 2189 2180 2197 2188 2189 2197 2188 2189 2180 2197 2179 2180 2181 -2 2188 2189 2197 2188 2189 2180 2197 2190 -417 0 2192 2181 2188 -2 2189 2180 2197 2179 2180 2182 2184 2180 2197 2181 2188 2189 2181 2188 -2 2189 2190 -4 0 2192 2181 2188 2189 2197 2180 2197 2187 2180 2181 2179 2180 2181 2188 -2 2189 2180 2197 2179 2180 2188 2189 2180 2197 2187 2195 2196 2188 2189 2187 2195 2196 2180 2181 2179 2181 -2 2188 2189 2197 2196 2180 2181 2197 2188 2189 -2 2180 2197 2187 2195 2196 2180 2181 2180 2197 2187 2195 2196 2180 2181 2197 2188 2189 -2 2180 2197 2187 2195 2196 2187 2197 2190 -417 0 2192 2189 2180 2197 2196 2180 2181 2197 2188 2198 2200 2180 2181 2189 2180 2197 2189 2180 2197 2196 2190 -4 0 2192 2189 2180 2197 2179 2180 2181 -2 2188 2189 2197 2188 2189 2180 2197 2196 2180 2181 2197 2188 2195 2196 2180 2181 2179 2180 2181 2195 2196 -2 2180 2181 2179 2180 2181 2189 -2 2180 2197 2187 2179 2180 2181 2187 2195 2196 2180 2181 2179 2180 2181 2179 2180 -2 2181 2179 2180 2181 2179 2180 2181 2187 2195 2196 2180 2181 2179 2180 2181 2179 2187 2182 2194 -417 0 2192 2196 2180 2181 2179 2180 2181 2187 2195 2196 2180 2181 2179 2196 2180 2181 2196 2180 2181 2179 2190 -4 0 2192 2196 2180 2181 2197 2188 2189 -2 2180 2197 2187 2195 2196 2180 2181 2179 2180 2181 2187 2195 2196 2180 2181 2179 2181 -2 2188 2189 2197 2179 2188 2189 2197 2188 2189 2196 2180 2181 2179 2180 2197 2188 2189 -2 2180 2181 2179 2180 2181 2188 2189 2197 2188 2189 2180 2181 2188 2189 2197 2188 2189 -2 2180 2181 2179 2180 2181 2188 2189 2197 2180 2190 -418 0 2192 2179 2180 2181 2197 2188 2189 -2 2180 2181 2179 2180 2181 2179 2180 2181 2179 2180 2181 2197 2190 -4 0 2192 2179 2180 2181 2187 2195 2196 2180 2181 2179 2180 2181 2179 2180 2181 2197 2188 2189 -2 2180 2181 2179 2180 2181 2189 -2 2180 2197 2187 2197 2180 2197 2187 2195 2196 2181 2179 2180 2181 2188 2187 2195 2196 2179 2188 2189 2197 2188 2189 2180 2197 2187 2195 2196 2188 2189 2180 2197 2187 2195 2196 2179 2188 2189 2197 2188 2189 2180 2197 2187 2196 2190 -418 0 2192 2197 2188 2189 2187 2195 2196 2179 2188 2189 2197 2188 2189 2197 2188 2189 2197 2188 2189 2187 2190 -4 0 2192 2197 2188 2189 -2 2180 2181 2179 2180 2181 2188 2189 2197 2188 2189 2187 2195 2196 2179 2188 2189 2197 2188 2189 2196 2180 2181 2179 2180 2181 2196 2188 2189 2180 2197 2187 2195 2196 2180 2181 2179 2180 2181 2197 2180 2197 2187 2195 2196 2180 2181 2179 2180 2181 2195 2196 2180 2181 2179 2180 2181 2197 2180 2197 2187 2195 2196 2180 2181 2179 2181 2190 -418 0 2192 2187 2195 2196 2179 2180 2181 2197 2180 2197 2187 2195 2196 2187 2195 2196 2187 2195 2196 2179 2190 -4 0 2192 2187 2195 2196 2179 2188 2189 2197 2188 2189 2180 2197 2187 2195 2196 2179 2180 2181 2197 2180 2197 2187 2195 2196 2181 2179 2180 2181 2188 2189 2181 2195 2196 2180 2181 2179 2180 2181 2188 2189 2197 2188 2189 2187 2180 2181 2179 2180 2181 2188 2189 2197 2188 2189 2180 2181 2188 2189 2197 2188 2189 2187 2180 2181 2179 2180 2181 2188 2189 2197 2189 2190 -4 8 -792 0)
    )
    (tilemap
      (solid #t)
      (z-pos 0)
      (width 515)
      (height 38)
      (tiles -485 0 133 -22 0 -2 132 -6 0 102 -483 0 133 -14 0 126 -7 0 -2 132 -368 0 -5 44 -117 0 133 -22 0 -2 132 -65 0 -2 83 -192 0 27 28 29 83 102 27 28 29 -156 0 44 -2 0 44 -2 0 44 -2 0 44 -2 0 44 -2 0 44 -2 0 44 -48 0 133 -22 0 -2 132 -5 0 -2 8 9 -51 0 -2 83 -42 0 102 83 -385 0 133 -22 0 -2 132 -5 0 -2 14 15 -45 0 -2 83 -311 0 7 -8 8 9 -114 0 133 -22 0 -2 132 -5 0 -2 11 12 -39 0 -2 83 -15 0 7 -2 8 9 -94 0 27 29 103 83 27 29 -90 0 7 -8 8 9 -98 0 13 -8 14 15 -18 0 27 -7 28 29 102 83 27 -7 28 29 -6 0 7 -24 8 9 -40 0 7 -3 8 133 -14 8 -8 0 -2 132 -5 8 -2 11 12 -33 0 -2 83 -15 0 7 -2 8 9 -2 0 13 -2 14 15 -31 0 -3 44 -4 0 -3 44 -47 0 7 -2 8 9 -10 0 7 -2 8 9 -4 0 83 102 83 -77 0 13 -8 14 15 -5 0 27 28 29 -2 83 27 28 29 -85 0 10 -8 11 21 8 9 -42 0 13 -24 14 15 -29 0 7 -4 8 9 -5 0 13 -33 14 -2 11 12 -3 0 112 -23 0 -2 83 -15 0 7 -2 8 9 -2 0 13 -2 14 15 -2 0 10 -2 11 12 -2 0 7 9 -16 0 7 9 -4 0 -2 44 -3 0 27 28 29 -4 0 27 28 29 -3 0 -2 44 -4 0 7 9 -36 0 13 -2 14 15 -10 0 13 -2 14 15 -24 0 7 8 9 -18 0 7 9 -16 0 7 8 9 -18 0 10 -8 11 12 -55 0 7 -8 8 9 -6 0 -3 83 -17 0 7 -6 8 22 -8 11 20 14 15 -24 0 -5 44 -13 0 10 -24 11 12 -11 0 7 -4 8 9 -3 0 7 -4 8 9 -3 0 13 -4 14 15 -5 0 10 -35 11 12 -38 0 7 -2 8 9 -2 0 13 -2 14 15 -2 0 10 -2 11 12 -2 0 10 -2 11 12 -2 0 13 15 -4 0 7 9 -4 0 7 9 -4 0 13 15 -4 0 27 29 -16 0 27 29 -4 0 13 15 -36 0 10 -2 11 12 -10 0 10 -2 11 12 -16 0 7 8 9 -5 0 13 14 15 -18 0 2085 2086 -16 0 13 14 15 -15 0 7 -2 8 22 -8 11 12 -55 0 13 -8 14 15 -26 0 13 -6 14 23 -10 11 21 -10 8 9 -3 0 7 -4 8 9 -3 0 7 -5 8 9 -3 0 7 -3 8 9 -4 0 10 -24 11 12 -2 0 7 -4 8 9 -3 0 13 -4 14 15 -3 0 13 -4 14 15 -3 0 10 -4 11 12 -5 0 10 -12 11 19 -22 11 12 -32 0 7 -2 8 9 -2 0 13 -2 14 15 -2 0 10 -2 11 12 -2 0 10 -2 11 12 -2 0 10 -2 11 12 -2 0 10 12 -4 0 13 15 -4 0 13 15 -4 0 10 12 -13 0 -2 44 -13 0 10 12 -22 0 7 -13 8 22 -2 11 21 -3 8 9 -2 0 7 -3 8 22 -2 11 21 -10 8 9 -5 0 13 14 15 -5 0 10 11 12 -11 0 7 9 -5 0 2087 2088 -5 0 7 9 -9 0 10 11 12 -15 0 13 -2 14 23 -8 11 21 -16 8 9 -38 0 10 -8 11 12 -26 0 10 -8 11 30 -5 17 31 -2 11 20 -10 14 15 -3 0 13 -4 14 15 -3 0 13 -5 14 15 -3 0 13 -3 14 15 -4 0 16 2937 -23 11 12 -2 0 13 -4 14 15 -3 0 10 -4 11 12 -3 0 10 -4 11 12 -3 0 10 -4 11 12 -5 0 10 -26 11 19 -8 11 12 -26 0 7 -2 8 9 -2 0 13 -2 14 15 -2 0 10 -2 11 12 -2 0 10 -2 11 12 -2 0 10 -2 11 12 -2 0 10 -2 11 12 -2 0 10 12 -4 0 10 12 -4 0 10 12 -4 0 10 12 -13 0 -2 44 -13 0 10 12 -5 0 7 9 -7 0 7 9 -6 0 13 -13 14 23 -2 11 20 -3 14 15 -2 0 13 -3 14 23 -2 11 20 -10 14 15 -5 0 10 11 12 -5 0 10 11 12 -11 0 2085 2086 -5 0 2087 2088 -5 0 2085 2086 -9 0 10 11 12 -11 0 7 9 -5 0 -8 44 31 20 -16 14 15 -7 0 7 -8 8 9 -17 0 27 29 -2 0 10 -8 11 12 -3 0 7 -22 8 22 -6 11 30 17 18 -5 0 16 31 -12 11 21 -3 8 22 -4 11 12 -3 0 10 -5 11 12 -3 0 10 -3 11 12 -5 0 2938 -21 11 2929 2930 18 -2 0 10 -4 11 12 -3 0 10 -4 11 12 -3 0 10 -4 11 12 -3 0 16 -4 17 18 -5 0 10 -7 11 19 -27 11 21 -23 8 9 -2 0 13 -2 14 15 -2 0 10 -2 11 12 -2 0 10 -2 11 12 -2 0 10 -2 11 12 -2 0 10 -2 11 12 -2 0 10 -2 11 12 -2 0 10 12 -4 0 10 12 -4 0 10 12 -4 0 10 12 -13 0 13 15 -13 0 10 12 -5 0 13 15 -7 0 13 15 -6 0 10 -19 11 30 18 -2 0 16 31 -16 11 21 -5 8 22 11 21 -5 8 22 11 21 -11 8 2087 2088 -5 8 2087 2088 -5 8 2087 2088 -9 8 22 11 12 -2 0 7 -8 8 114 113 -5 8 -23 44 -3 0 18 -7 0 13 -8 14 15 -21 0 10 -8 11 12 -3 0 13 -22 14 23 -5 11 30 18 -8 0 16 -9 17 31 -2 11 20 -3 14 23 -4 11 21 -3 8 22 11 30 17 31 11 21 -3 8 22 11 30 17 18 -5 0 2939 2937 -19 11 2935 2931 -4 0 10 -4 11 12 -3 0 16 -4 17 18 -3 0 16 -4 17 18 -14 0 10 -35 11 20 -23 14 15 -2 0 10 -2 11 12 -2 0 10 -2 11 12 -2 0 10 -2 11 12 -2 0 10 -2 11 12 -2 0 10 -2 11 12 -2 0 10 -2 11 12 -2 0 10 12 -4 0 10 12 -4 0 10 12 -4 0 10 12 -13 0 10 12 -13 0 10 12 -5 0 10 12 -7 0 10 12 -6 0 10 -19 11 12 -4 0 10 -16 11 20 -5 14 23 11 20 -5 14 23 11 20 -36 14 23 11 12 -2 0 13 -8 14 23 20 -10 14 113 -17 44 -3 0 9 -7 0 10 -8 11 12 -4 0 7 -8 8 9 -7 0 10 -5 11 19 -2 11 12 -3 0 10 -27 11 30 18 -19 0 10 30 -8 17 31 11 20 -3 14 23 30 18 0 16 31 20 -3 14 23 30 18 -8 0 2938 -7 11 19 -9 11 2929 2930 2936 -5 0 16 -4 17 18 -32 0 10 -59 11 12 -2 0 10 -2 11 12 -2 0 10 -2 11 12 -2 0 10 -2 11 12 -2 0 10 -2 11 12 -2 0 10 -2 11 12 -2 0 10 -2 11 12 -2 0 10 12 -4 0 10 12 -4 0 10 12 -4 0 10 12 -13 0 10 12 -13 0 10 12 -5 0 10 12 -7 0 10 12 -6 0 10 -19 11 12 -4 0 10 -71 11 12 -2 0 10 -20 11 20 -13 14 15 -3 77 13 -2 14 113 8 9 -5 0 10 -8 11 12 -4 0 13 -8 14 15 -7 0 10 -8 11 12 -3 0 10 -27 11 12 -20 0 10 12 -8 0 10 -6 11 12 -3 0 10 -5 11 12 -9 0 2939 31 -14 11 30 17 2931 -45 0 10 -59 11 12 -2 0 10 -2 11 12 -2 0 10 -2 11 12 -2 0 10 -2 11 12 -2 0 10 -2 11 12 -2 0 10 -2 11 12 -2 0 10 -2 11 12 -2 0 10 12 -4 0 10 12 -4 0 10 12 -4 0 10 12 -13 0 10 12 -13 0 10 12 -5 0 10 12 -7 0 10 12 -6 0 10 -19 11 12 -4 0 10 -7 11 19 -63 11 12 -2 0 10 -34 11 12 -3 0 10 -2 11 20 14 15 -5 0 10 -8 11 12 -4 0 10 -8 11 12 -7 0 10 -8 11 12 -3 0 10 -22 11 19 -4 11 12 -20 0 10 12 -8 0 16 -6 17 18 -3 0 16 -5 17 18 -10 0 10 -14 11 12 -47 0 10 -59 11 12 -2 0 10 -2 11 12 -2 0 10 -2 11 12 -2 0 10 -2 11 12 -2 0 10 -2 11 12 -2 0 10 -2 11 12 -2 0 10 -2 11 12 -2 0 10 12 -4 0 10 12 -4 0 10 12 -4 0 10 12 -13 0 10 12 -13 0 10 12 -5 0 10 12 -7 0 10 12 -6 0 10 -19 11 12 -4 0 10 -71 11 12 -2 0 10 -34 11 12 -3 0 10 -4 11 12 -5 0 10 -8 11 12 -4 0 10 -8 11 12 -7 0 10 -8 11 12 -3 0 10 -27 11 12 -20 0 10 12 -36 0 10 -14 11 12 -47 0 10 -59 11 12 -2 0 10 -2 11 12 -2 0 10 -2 11 12 -2 0 10 -2 11 12 -2 0 10 -2 11 12 -2 0 10 -2 11 12 -2 0 10 -2 11 12 -2 0 10 12 -4 0 10 12 -4 0 10 12 -4 0 10 12 -13 0 10 12 -13 0 10 12 -5 0 10 12 -7 0 10 12 -6 0 10 -19 11 12 -4 0 10 -71 11 12 -2 0 10 -21 11 2935 -12 17 18 -3 0 10 -4 11 12 -5 0 10 -8 11 12 -4 0 10 -8 11 12 -7 0 10 -8 11 12 -3 0 10 -25 11 30 17 18 -20 0 10 12 -36 0 10 -14 11 12 -47 0 10 -59 11 12 -2 0 10 -2 11 12 -2 0 10 -2 11 12 -2 0 10 -2 11 12 -2 0 10 -2 11 12 -2 0 10 -2 11 12 -2 0 10 -2 11 12 -2 0 10 12 -4 0 10 12 -4 0 10 12 -4 0 10 12 -13 0 10 12 -13 0 10 12 -5 0 10 12 -7 0 10 12 -6 0 10 -19 11 12 -4 0 10 -54 11 19 -16 11 12 -2 0 10 -20 11 2935 2936 -15 0 102 10 -4 11 12 -5 0 10 -8 11 12 -4 0 10 -8 11 12 -7 0 10 -8 11 12 -3 0 10 -25 11 12 -22 0 10 12 -36 0 10 -14 11 12 -47 0 10 -59 11 12 -2 0 10 -2 11 12 -2 0 10 -2 11 12 -2 0 10 -2 11 12 -2 0 10 -2 11 12 -2 0 10 -2 11 12 -2 0 10 -2 11 12 -2 0 10 12 -4 0 10 12 -4 0 10 12 -4 0 10 12 -13 0 10 12 -13 0 16 18 -5 0 16 18 -7 0 16 18 -6 0 10 -19 11 12 -4 0 10 -71 11 12 -2 0 10 -5 11 19 -13 11 2935 2936 -17 0 10 -4 11 12 -5 0 16 -8 17 18 -4 0 16 -8 17 18 -7 0 10 -8 11 12 -3 0 16 -25 17 18 -22 0 10 12 -36 0 10 -14 11 12 -47 0 10 -59 11 12 -2 0 10 -2 11 12 -2 0 10 -2 11 12 -2 0 10 -2 11 12 -2 0 10 -2 11 12 -2 0 10 -2 11 12 -2 0 10 -2 11 12 -2 0 10 12 -4 0 10 12 -4 0 10 12 -4 0 10 12 -13 0 10 12 -37 0 10 -19 11 12 -4 0 10 -71 11 12 -2 0 10 -18 11 2935 2936 -18 0 10 -4 11 12 -36 0 10 -8 11 12 -52 0 10 12 -36 0 10 -14 11 12 -47 0 10 -59 11 12 -2 0 10 -2 11 12 -2 0 10 -2 11 12 -2 0 10 -2 11 12 -2 0 10 -2 11 12 -2 0 10 -2 11 12 -2 0 10 -2 11 12 -2 0 10 12 -4 0 10 12 -4 0 10 12 -4 0 10 12 -13 0 10 12 -37 0 10 -19 11 12 -4 0 10 -71 11 12 -2 0 10 -16 11 2929 2930 2936 -2 0 128 -2 83 -3 0 44 0 2909 2910 -7 8 22 -4 11 12 -36 0 10 -8 11 12 -52 0 10 12 -36 0 10 -14 11 12 -47 0 10 -59 11 12 -2 0 10 -2 11 12 -2 0 10 -2 11 12 -2 0 10 -2 11 12 -2 0 10 -2 11 12 -2 0 10 -2 11 12 -2 0 10 -2 11 12 -2 0 10 12 -4 0 10 12 -4 0 10 12 -4 0 10 12 -13 0 10 12 -37 0 10 -19 11 12 -4 0 10 -71 11 12 -2 0 10 -14 11 2929 2930 2931 -8 0 44 0 1826 1829 2911 2912 -7 14 23 -4 11 12 -36 0 10 -8 11 12 -52 0 10 12 -36 0 10 -14 11 12 -47 0 10 -59 11 12 -2 0 10 -2 11 12 -2 0 16 -2 17 18 -2 0 10 -2 11 12 -2 0 16 -2 17 18 -2 0 10 -2 11 12 -2 0 16 -2 17 18 -2 0 10 12 -4 0 10 12 -4 0 10 12 -4 0 10 12 -13 0 10 12 -37 0 10 -14 11 19 -4 11 12 -4 0 10 -71 11 12 -2 0 10 -12 11 2929 2930 2931 -8 0 44 0 1826 1829 1830 1833 1834 -13 11 12 -36 0 10 -2 11 19 -5 11 12 -52 0 10 12 -36 0 10 -14 11 12 -47 0 10 -16 11 19 -42 11 12 -2 0 10 -2 11 12 -8 0 10 -2 11 12 -8 0 10 -2 11 12 -8 0 10 12 -4 0 10 12 -4 0 10 12 -4 0 10 12 -13 0 10 12 -37 0 10 -19 11 12 -4 0 10 -35 11 19 -35 11 12 -2 0 10 -10 11 2929 2930 2931 -8 0 44 0 1826 1829 1830 1833 1834 -15 11 12 -36 0 10 -8 11 12 -52 0 10 12 -36 0 10 -14 11 12 -47 0 10 -59 11 12 -2 0 10 -2 11 12 -8 0 10 -2 11 12 -8 0 10 -2 11 12 -8 0 10 12 -4 0 10 12 -4 0 10 12 -4 0 16 18 -13 0 10 12 -37 0 10 -19 11 12 -4 0 10 -71 11 12 -2 0 10 -8 11 2929 2930 2931 -8 0 44 0 1826 1829 1830 1833 1834 -17 11 12 -36 0 10 -8 11 12 -52 0 10 12 -36 0 10 -14 11 12 -47 0 10 -59 11 12 -2 0 10 -2 11 12 -8 0 10 -2 11 12 -8 0 10 -2 11 12 -8 0 10 12 -4 0 10 12 -4 0 10 12 -19 0 10 12 -37 0 10 -19 11 12 -4 0 10 -71 11 12 -2 0 10 -6 11 2929 2930 2931 -8 0 44 0 1826 1829 1830 1833 1834 -19 11 12 -36 0 10 -8 11 12 -52 0 10 12 -36 0 10 -14 11 12 -47 0 10 -59 11 12 -2 0 10 -2 11 12 -8 0 16 -2 17 18 -8 0 10 -2 11 12 -8 0 10 12 -4 0 10 12 -4 0 10 12 -19 0 10 12 -37 0 10 -19 11 12 -4 0 10 11 -2 297 -63 11 -4 297 11 12 -2 0 10 -4 11 2929 2930 2931 -8 0 44 0 1826 1829 1830 1833 1834 -21 11 12 -36 0 16 -8 17 18 -52 0 10 12 -36 0 10 -14 11 12 -47 0 10 -59 11 12 -2 0 10 -2 11 12 -20 0 10 -2 11 12 -8 0 16 18 -4 0 10 12 -4 0 10 12 -19 0 10 12 -37 0 10 -19 11 12 -4 0 10 30 -2 0 31 -61 11 30 -4 0 31 12 -2 0 10 -2 11 2929 2930 2931 -8 0 44 0 1826 1829 1830 1833 1834 -23 11 12 -98 0 16 18 -36 0 16 -14 17 18 -47 0 10 -59 11 12 -2 0 10 -2 11 12 -20 0 16 -2 17 18 -14 0 10 12 -4 0 16 18 -19 0 10 12 -37 0 16 -19 17 18 -4 0 16 18 -2 0 16 -61 17 18 -4 0 16 18 -2 0 16 -2 17 2931 -8 0 44 0 1826 1829 1830 1833 1834 -25 11 12 -199 0 10 -59 11 12 -2 0 10 -2 11 12 -38 0 10 12 -25 0 10 12 -147 0 44 0 1826 1829 1830 1833 1834 -27 11 12 -199 0 10 -59 11 12 -2 0 16 -2 17 18 -38 0 10 12 -25 0 10 12 -145 0 44 0 1826 1829 1830 1833 1834 -12 11 19 -16 11 12 -199 0 10 -59 11 12 -44 0 10 12 -25 0 10 12 -39 0 102 -2 83 -38 0 -3 83 -20 0 83 -39 0 44 0 1826 1829 1830 1833 1834 -31 11 12 -199 0 10 -59 11 12 -44 0 10 12 -25 0 10 12 -94 0 77 -46 0 44 0 1826 1829 1830 1833 1834 -33 11 12 -199 0 16 -33 17 -26 11 12 -44 0 16 18 -25 0 10 12 -93 0 -2 77 -46 0 1826 1829 1830 1833 1834 -35 11 12 -233 0 -26 11 12 -71 0 16 18 -37 0 7 -17 8 -2 48 9 -4 0 7 -29 8 -3 48 -38 8 9 -4 0 7 2921 2922 1830 1833 1834 -37 11 12 -233 0 -26 11 12 -101 0 27 -2 28 29 -5 0 13 -19 14 15 -4 0 13 -70 14 113 -4 2178 114 2923 2924 1834 -30 11 19 -8 11 12 -233 0 -26 11 12 -110 0 10 -19 11 12 -4 0 10 -70 11 20 -4 14 23 -42 11 12 -233 0)
    )
    (tilemap
      (solid #f)
      (z-pos 100)
      (width 515)
      (height 38)
      (tiles -1001 0 130 -16 0 127 -497 0 129 -514 0 129 -514 0 129 -514 0 129 -514 0 129 -2810 0 -2 8 -5 0 -2 8 -5 0 -2 8 -7665 0 -4 11 -61 0 -6 11 -444 0 30 -2 17 31 -61 0 30 -4 17 31 -3526 0 -2 8 -35 0 -3 8 -475 0 -2 14 -513 0 -2 11 -358 0)
    )
    (tilemap
      (solid #f)
      (z-pos 101)
      (name "secret1")
      (width 3)
      (height 3)
      (tiles -2 11 12 -2 11 12 -2 17 18)
    )
    (tilemap
      (handle
        (scale_x 0)
        (scale_y 0)
        (offset_x 0)
        (offset_y 0)
      )
      (solid #f)
      (z-pos 102)
      (name "secret2")
      (path-ref "gen17713485741566962022320")
      (width 30)
      (height 15)
      (tiles 10 11 115 116 -8 11 -18 0 22 11 117 118 -25 11 12 23 -28 11 12 -6 0 -23 11 21 -6 0 -21 11 -9 0 -21 11 -9 0 -21 11 -9 0 -21 11 -9 0 -21 11 -9 0 -21 11 -7 0 -23 11 -5 0 -25 11 -5 0 -10 17 31 -4 11 -25 0 22 -2 11 -27 0 23 -17 0)
    )
  )
)
