(supertux-level
  (version 3)
  (name (_ "A Mysterious House of Ice"))
  (author "SuperTux Team")
  (license "GPL 2+ / CC-by-sa 3.0")
  (target-time 30)
  (allow-item-pocket "inherit")
  (icon "")
  (icon-locked "")
  (statistics
    (enable-coins #t)
    (enable-secrets #t)
  )
  (sector
    (name "main")
    (ambient-light
      (color 1 1 1)
    )
    (camera
      (name "Camera")
      (mode "normal")
    )
    (crystallo
      (z-pos 50)
      (glinting #f)
      (x 3088)
      (y 295)
    )
    (crystallo
      (z-pos 50)
      (glinting #f)
      (x 3280)
      (y 295)
    )
    (crystallo
      (z-pos 50)
      (glinting #f)
      (x 3568)
      (y 295)
    )
    (firefly
      (z-pos 0)
      (x 4817)
      (y 468)
    )
    (gradient
      (top_color 0.5 0.7 1)
      (bottom_color 1 1 1)
    )
    (jumpy
      (z-pos 50)
      (x 5053)
      (y 471)
      (glinting #f)
    )
    (mrbomb
      (z-pos 50)
      (x 580)
      (y 401)
      (glinting #f)
    )
    (mrbomb
      (z-pos 50)
      (x 1075)
      (y 497)
      (glinting #f)
    )
    (mrbomb
      (z-pos 50)
      (x 1530)
      (y 497)
      (glinting #f)
    )
    (mrbomb
      (z-pos 50)
      (x 1949)
      (y 496)
      (glinting #f)
    )
    (mrbomb
      (z-pos 50)
      (x 2920)
      (y 338)
      (glinting #f)
    )
    (mrbomb
      (z-pos 50)
      (x 3229)
      (y 338)
      (glinting #f)
    )
    (mrbomb
      (z-pos 50)
      (x 5199)
      (y 497)
      (glinting #f)
    )
    (mrbomb
      (z-pos 50)
      (x 5572)
      (y 497)
      (glinting #f)
    )
    (mrbomb
      (z-pos 50)
      (x 6006)
      (y 497)
      (glinting #f)
    )
    (mriceblock
      (z-pos 50)
      (x 1677)
      (y 506)
      (glinting #f)
    )
    (mriceblock
      (z-pos 50)
      (x 1737)
      (y 506)
      (glinting #f)
    )
    (mriceblock
      (z-pos 50)
      (x 1804)
      (y 507)
      (glinting #f)
    )
    (music
      (file "music/fortress.music")
    )
    (path
      (name "gen17713431632214076972336")
      (path
        (adapt_speed #f)
        (node
          (x 3904)
          (y 416)
        )
      )
    )
    (secretarea
      (fade-tilemap "secret1")
      (width 312)
      (height 152)
      (x 3924)
      (y 468)
    )
    (snowball
      (z-pos 50)
      (x 1238)
      (y 506)
      (glinting #f)
    )
    (snowball
      (z-pos 50)
      (x 1294)
      (y 505)
      (glinting #f)
    )
    (snowball
      (z-pos 50)
      (x 1357)
      (y 505)
      (glinting #f)
    )
    (snowball
      (z-pos 50)
      (x 5324)
      (y 504)
      (glinting #f)
    )
    (snowball
      (z-pos 50)
      (x 5379)
      (y 504)
      (glinting #f)
    )
    (snowball
      (z-pos 50)
      (x 5437)
      (y 505)
      (glinting #f)
    )
    (spawnpoint
      (name "main")
      (x 96)
      (y 320)
    )
    (spiky
      (z-pos 50)
      (x 5855)
      (y 501)
      (glinting #f)
    )
    (spiky
      (z-pos 50)
      (x 5792)
      (y 500)
      (glinting #f)
    )
    (spiky
      (z-pos 50)
      (x 5733)
      (y 500)
      (glinting #f)
    )
    (stalactite
      (glinting #f)
      (z-pos -1)
      (x 7088)
      (y 264)
    )
    (stalactite
      (glinting #f)
      (z-pos -1)
      (x 6991)
      (y 264)
    )
    (stalactite
      (glinting #f)
      (z-pos -1)
      (x 6897)
      (y 264)
    )
    (stalactite
      (glinting #f)
      (z-pos -1)
      (x 6799)
      (y 264)
    )
    (stalactite
      (glinting #f)
      (z-pos -1)
      (x 6704)
      (y 264)
    )
    (stalactite
      (glinting #f)
      (z-pos -1)
      (x 6609)
      (y 262)
    )
    (stalactite
      (glinting #f)
      (z-pos -1)
      (x 6513)
      (y 262)
    )
    (stalactite
      (glinting #f)
      (z-pos -1)
      (x 6418)
      (y 263)
    )
    (stalactite
      (glinting #f)
      (z-pos -1)
      (x 5746)
      (y 135)
    )
    (stalactite
      (glinting #f)
      (z-pos -1)
      (x 5650)
      (y 134)
    )
    (stalactite
      (glinting #f)
      (z-pos -1)
      (x 5553)
      (y 135)
    )
    (stalactite
      (glinting #f)
      (z-pos -1)
      (x 5138)
      (y 134)
    )
    (stalactite
      (glinting #f)
      (z-pos -1)
      (x 5202)
      (y 135)
    )
    (stalactite
      (glinting #f)
      (z-pos -1)
      (x 5266)
      (y 135)
    )
    (stalactite
      (glinting #f)
      (z-pos -1)
      (x 2099)
      (y 232)
    )
    (stalactite
      (glinting #f)
      (z-pos -1)
      (x 1680)
      (y 296)
    )
    (stalactite
      (glinting #f)
      (z-pos -1)
      (x 1013)
      (y 263)
    )
    (stalactite
      (glinting #f)
      (z-pos -1)
      (x 1068)
      (y 262)
    )
    (stalactite
      (glinting #f)
      (z-pos -1)
      (x 498)
      (y 201)
    )
    (tilemap
      (solid #f)
      (z-pos -100)
      (name "Background")
      (width 260)
      (height 25)
      (tiles -907 0 2189 2180 2189 2180 2189 2180 2189 2180 -4 0 2189 2180 2189 2180 2189 2180 2189 2180 2189 -2 2180 2189 2180 2189 2180 -72 0 2195 2190 -159 0 2195 2187 2195 2187 2195 2187 2195 2187 2189 2180 2189 2180 2195 2187 2195 2187 2195 2187 2195 2187 2195 -2 2187 2195 2187 2195 2189 2180 2189 2180 2195 2187 2195 2187 2195 2187 2189 2180 2189 2180 -2 2195 2187 2195 2187 2195 2187 2195 2189 2197 2187 2195 2189 2195 -2 2187 2195 2187 2195 -2 2187 2195 2187 2195 2187 -34 0 2195 2190 -159 0 2180 2189 2180 2189 2180 2189 2180 2189 2195 2187 2195 2187 2180 2189 2180 2189 2180 2189 2180 2189 2180 -2 2189 2180 2189 2180 2195 2187 2195 2187 2180 2189 2180 2189 2180 2189 2195 2187 2195 2187 -2 2180 2189 2180 2189 2180 2189 2180 2195 2187 2195 2187 2195 2180 2195 2189 2180 2189 2180 -2 2189 2180 2189 2180 -2 2189 2180 -32 0 2180 2190 -32 0 2189 2180 2189 2180 2189 -2 2180 -2 2189 2180 2189 2180 2189 -3 2180 2189 2180 2189 2180 -2 2189 2180 2189 2180 2189 2180 2189 2180 -8 0 2195 2187 2195 2187 2195 2187 2195 2187 2189 2180 2189 2180 2189 2180 -4 0 2187 2195 2187 2195 2187 2195 2180 2189 2180 2189 -2 0 2195 2187 2195 2187 2195 2187 2195 2187 2195 2187 2195 2187 2195 2187 2195 2187 -6 0 2189 2180 2189 2180 2189 2180 2189 2180 2189 2180 2189 2180 2189 2180 2189 2180 2195 2187 2195 2187 2195 2187 2198 2186 -4 0 2192 2189 2180 -2 2189 2180 2189 2180 2189 2180 2187 2195 2187 2195 2187 2195 2187 2195 2180 2189 2180 2189 2187 2195 2187 2195 2187 2195 2182 -3 2183 2184 2187 2195 2187 2180 2189 2180 2189 2187 2195 2187 2195 2187 2195 2180 2189 2180 2189 2187 2195 2187 -2 2195 2187 2195 2187 2180 2196 2180 2181 2180 2187 2180 2195 2187 2195 2187 -2 2195 2187 2195 2187 -2 2195 2187 2195 2187 -30 0 2187 2190 -32 0 2195 2187 2189 2180 2195 -2 2187 -2 2195 2187 2182 2184 2195 -3 2187 2195 2187 2195 2187 -2 2195 2187 2195 2187 2195 2187 2195 2187 2180 2189 2180 -2 0 2180 2189 -2 2180 2189 2180 2189 2180 2189 2180 2189 2195 2187 2195 2187 2195 2187 2189 -2 0 2195 2189 2180 2189 2180 2189 2180 2195 2187 2195 2187 2195 2187 2195 2187 2195 2187 2195 2189 2180 2189 2180 2189 2180 2189 2180 2189 2180 2189 2180 2195 2187 2195 2187 2195 -2 2187 -2 2195 2187 2195 2187 2195 2189 2197 2187 2195 2189 2195 -2 2187 2180 2189 2180 2189 2180 2189 2180 2198 2186 -2 0 2185 2200 2195 2187 -2 2195 2187 2195 2187 2195 2187 2189 2180 2189 2181 2189 2180 2189 2180 2187 2195 2187 2195 2189 2180 2189 2180 2189 2180 2190 -3 0 2192 2189 2180 2189 2187 2195 2187 2195 2189 2180 2182 -3 2183 2184 2195 2187 2195 -2 2189 2197 2187 2195 2189 2180 2189 2187 2179 2188 2189 2187 2189 2188 2182 -3 2183 2184 2180 2189 2180 2189 -2 2180 2189 2180 -2 2189 2180 -28 0 2189 2190 -32 0 2195 2187 2195 2181 2195 -2 2187 -2 2195 2187 2198 2200 2195 -3 2187 2195 2187 2195 2187 -2 2195 2187 2195 2187 2195 2187 2195 -2 2187 2195 -2 2187 2195 2187 2182 -3 2183 2184 2187 2195 2187 2195 2181 2195 2187 2195 2187 2195 2187 2195 2187 2195 2187 2195 2187 2195 2182 -3 2183 2184 2195 2187 2195 2187 2189 2180 2189 2180 2195 2187 2195 2187 2195 2187 2195 2187 -2 2195 2187 2195 2187 2180 2196 2187 2195 2187 2195 2187 2195 2180 2189 2180 2189 2180 2195 2187 2195 2187 2195 2180 2195 -2 2187 2195 2187 2195 2187 2195 2187 2195 2198 2186 2185 2200 2187 2195 2187 -2 2195 2187 2195 2187 2195 2187 2195 2187 2195 2187 2195 2187 2195 2187 2189 2180 2189 2180 2195 2187 2195 2187 2181 2187 2190 -3 0 2192 2195 2187 2195 2189 2180 2189 2180 2195 2187 2190 -3 0 2192 2180 2189 2180 -2 2195 2187 2195 2187 2195 2187 2195 2196 2180 2181 2180 2189 2195 2187 2190 -3 0 2192 2187 2189 2197 2187 2195 2189 2180 2189 -2 2187 -3 2195 2187 2195 2187 2180 2196 2187 2195 2187 -2 2195 2187 2195 2187 2180 2196 2195 -2 2187 2195 2187 -2 2195 2187 2195 2187 2180 2196 2198 2186 -31 0 2180 -3 2189 2180 -2 2189 -2 2180 2189 2195 2187 2180 -3 2189 2180 2189 2181 2189 -2 2180 2189 2180 2189 2180 2189 2180 2189 2187 2195 2187 2189 2180 2189 2190 -3 0 2192 2189 2180 2189 2180 2189 2180 -2 2189 -2 2180 2189 2180 2189 2180 2189 2180 2189 2180 2190 -3 0 2192 2180 2189 2180 2189 2195 2187 2195 2187 2180 2196 2180 2189 2180 2189 2180 2189 2180 2195 2189 2180 2189 2187 2179 2189 2180 2189 2180 2189 2180 -2 2195 2187 2195 2187 2180 2196 2180 2195 2187 2195 2187 2195 2189 2197 2187 2195 2189 2195 2187 2180 2189 2198 2200 2180 -2 2189 2180 2189 2180 2189 2180 2189 2180 2189 2180 2189 2180 2189 2180 2189 2180 2189 2195 2187 2195 2187 2180 2189 2180 2181 2180 2182 2194 -3 0 2192 2180 2189 2180 2195 2187 2195 2187 2180 2189 2190 -3 0 2192 2187 2195 2187 -2 2180 2196 2180 2181 2180 2189 2180 2179 2188 2189 2187 2195 2180 2189 2190 -3 0 2192 2189 2195 2187 2195 2187 2195 2187 2195 2196 2189 2180 2187 2195 2189 2180 2189 2187 2179 -2 2189 2197 2187 2195 2189 2180 2189 2187 2179 2195 -3 2189 2197 2187 2195 2189 2180 2189 2187 2179 2189 2190 0 130 -29 0 2187 2195 2187 2195 2180 2189 2195 -2 2187 2195 2187 2195 2180 2189 -2 2195 2187 2195 2187 2195 -2 2187 2195 2187 2195 2182 2184 2187 2195 2189 2180 2189 2195 2187 2195 2190 -3 0 2192 2195 2187 -3 2195 2187 2195 2180 2195 2187 2195 2187 2195 2187 2195 2187 2195 2187 2190 -3 0 2192 2187 2195 2187 -2 2195 2189 2180 2189 2187 2179 2187 2182 2184 2195 2187 2195 -2 2187 2195 2187 2195 2196 2180 2195 2187 2195 2187 2195 -2 2187 2195 2189 2180 2189 2187 2179 2188 2180 2189 2180 2189 2180 2195 2187 2195 2187 2195 2180 -2 2195 2187 2195 2187 2195 2187 2195 2187 2195 2187 2195 2187 2195 2187 2195 2187 2195 2187 2195 2187 2195 2187 2195 2180 2189 2180 2189 2187 2195 2187 2195 2182 2194 -3 0 2185 2200 2181 2195 2187 2180 2189 2180 2189 2187 2195 2190 -3 0 2192 2189 2180 2189 -2 2187 2179 2188 2189 2187 -3 2195 2187 2195 2187 2195 2187 2195 2190 -3 0 2192 2195 2180 2196 2180 2181 2180 2189 2180 2179 2195 2187 2195 2187 2195 2187 2195 2196 2180 -2 2195 2187 2195 2187 2195 2187 2195 2196 2180 2187 -3 2195 2187 2195 2187 2195 2187 2195 2196 2180 2195 2190 0 129 -29 0 2189 2180 2189 2180 2187 2195 2180 -2 2189 2180 2189 2180 2187 2195 -2 2180 2189 2180 2189 2180 -2 2189 2180 2189 2180 2198 2200 2189 2180 2195 2187 2195 2180 2189 2180 2190 -3 0 2192 2180 2189 2180 -2 2195 2187 2195 2187 -2 2180 2189 2180 -2 2189 2180 2189 2180 2189 2190 -3 0 2192 2189 2180 2189 2180 2187 2195 2187 2195 2196 2180 2189 2198 2200 2180 2189 2180 2189 2181 2180 2189 2180 2179 2188 2179 2188 2189 2187 2180 2189 2195 2187 2195 2187 2195 2196 2180 2181 -2 2195 2187 2195 2187 2180 2196 2180 2181 2180 2187 -2 2180 2189 2180 2189 2180 2189 2180 2189 2180 2189 2180 2189 2180 2189 2180 2189 2180 2187 2195 2187 2195 2187 2195 2187 2195 2187 2195 2189 2180 2189 2182 2194 0 2185 -2 2199 2200 2187 2189 2180 2189 2187 2195 2187 2195 2189 2180 2190 -3 0 2192 2195 2187 2195 2189 2196 2180 2181 2180 2189 2180 2189 2180 2189 2180 2189 2180 2189 2180 2190 -3 0 2192 2180 2187 2179 2188 2189 2187 -3 2195 2180 2189 2180 2181 2180 2189 2180 2179 2188 -2 2180 2196 2180 2181 2180 2189 2180 2179 2188 2181 -3 2180 2196 2180 2181 2180 2189 2180 2179 2188 2180 2190 0 129 -35 0 2187 -2 2195 2181 2195 2187 2195 -3 2187 2195 2187 2195 2187 -2 2195 2187 -2 2195 2187 -2 2195 2187 2180 2189 2180 2187 2195 2187 2190 -3 0 2192 2187 2195 -2 2187 2195 2189 2180 2189 2187 -2 2195 2187 2195 2180 -2 2195 2187 2195 2190 -3 0 2192 2195 2187 2195 2187 2181 2180 2189 2180 2179 2188 2195 2187 2195 2187 2195 2187 2195 2189 2187 -3 2195 2187 2180 2181 2180 2189 2187 2195 2180 2181 2180 2189 2180 2179 2188 2189 2187 2195 2189 2180 2189 2187 2179 2188 2189 2187 2189 2188 2187 2195 2187 2195 2187 2195 2187 2195 2187 2195 2187 2195 2187 2195 2187 2195 2187 2189 2180 2189 2180 2189 2180 2189 2180 2189 2180 2195 2187 2189 2190 0 2185 2200 2181 2195 -2 2187 2195 2187 2195 2189 2180 2189 2180 2195 2187 2198 -3 2199 2200 2180 2189 2182 2184 2179 2188 2189 2187 2195 2187 2195 2187 2195 2187 2195 2187 2195 2187 2198 -3 2199 2200 2187 2196 2180 2181 2180 2189 2180 2189 2180 2187 2195 2188 2189 2187 -3 2195 -3 2187 2179 2188 2189 2187 -3 2195 2187 2189 -3 2187 2179 2188 2189 2187 -3 2195 -2 2187 2190 0 129 -35 0 2189 2180 -2 2189 2180 2189 2180 -3 2189 2180 2189 2180 2195 2189 2180 2189 -2 2187 2189 -2 2180 2189 2187 2195 2187 2189 2180 2189 2198 -3 2199 2200 2189 2180 2189 2195 2187 2195 2187 2195 2196 -2 2195 2187 2195 2187 -2 2180 2189 2180 2198 -3 2199 2200 2180 2189 2180 -2 2189 2187 -3 2195 2187 2180 2189 2180 2189 2180 2189 -2 2180 2189 2180 2189 2180 2189 2188 2189 2187 2195 2189 2180 2188 2189 2187 -3 2195 2187 -2 2195 2187 2195 2187 2195 2196 2180 2181 2180 2189 2195 2187 2189 2180 -2 2189 2180 2182 2184 2180 2189 2180 2189 2180 2189 2180 2189 2180 2189 2195 2187 2195 2187 2195 2187 2195 2187 2195 2187 2180 2189 2180 2198 2199 2200 2180 2189 2180 -2 2189 2180 2189 2180 2195 2187 2195 2187 2180 2189 2180 2189 2180 2189 2195 2187 2195 2198 2200 2189 2180 2189 2180 2189 2180 2189 2180 -2 2189 2181 2189 2180 -2 2189 2180 2189 2180 -2 2189 2179 2188 2189 2187 2195 2187 2195 2187 2180 2189 -28 0 -2 2189 2198 2186 129 -7 0 134 135 -26 0 2195 2187 -2 2195 2189 2180 2189 2187 -5 0 2187 2195 2187 2195 2196 2181 2195 -2 2187 2195 2189 2180 2189 2195 2187 2195 2187 2195 2187 2195 2187 2195 2187 2195 2180 2181 2180 2189 2180 2179 2187 2195 2189 2180 2189 -2 2187 2195 2187 2195 2187 2195 2187 2195 2187 2195 2187 2195 2180 2189 2180 2189 2180 2189 2187 2195 2187 2195 2187 2195 2187 2195 2187 2180 -3 2195 2187 2195 2187 -2 2195 2187 2181 2180 2189 2180 2189 2180 2189 -2 2180 2181 2180 2189 2180 2179 2188 2189 2187 2195 2180 2189 2195 2189 2180 -2 2189 2190 2193 2184 2195 2187 2195 2187 2195 2187 2195 2187 2195 2180 2189 2180 2189 2180 2189 2180 2189 2180 2189 2187 2195 2187 2195 2187 2195 2187 2195 2187 -2 2195 2187 2195 2187 2180 2189 2180 2189 2187 2195 2187 2195 2187 2195 2180 2189 2180 2189 2187 2195 2187 2195 2187 2195 2187 2195 2187 -2 2195 2187 2195 2187 -2 2195 2187 2195 2187 -2 2195 2187 2195 2187 -2 2195 2187 2195 2187 -30 0 -2 2195 2189 2190 129 -35 0 2180 2189 2195 2187 2195 2187 2195 2196 -5 0 2181 2180 2189 2180 2179 2189 2180 -2 2189 2180 2195 2187 2195 2180 2189 2180 2189 2180 2189 2180 2189 2180 2189 2180 2189 2180 2189 2180 2189 2180 2195 2187 2195 2187 2195 2196 2189 2180 2189 2180 2189 2180 2189 2180 2189 2180 2189 2180 2189 2180 2189 2180 2189 2180 2189 2180 2189 2180 2189 2180 2189 2180 2189 2195 2180 2189 2180 2189 2180 2189 -2 2180 2189 2180 2189 2180 2189 2180 2181 2180 2189 2188 2189 2187 -3 2195 2187 2195 2187 2195 2187 2195 2180 2195 2187 2182 2183 2194 0 2193 2184 2189 2180 2189 2180 2189 2180 2189 2180 2187 2195 2187 2195 2187 2195 2187 2195 2187 2195 2189 2180 2189 2180 2189 2180 2189 2180 2189 -2 2180 2189 2180 2189 2187 2195 2187 2195 2189 2180 2189 2180 2189 2180 2187 2195 2187 2195 2189 2180 2189 2180 2189 2180 2189 2180 2189 -2 2180 2189 2180 2189 -2 2180 2189 2180 2189 -2 2180 2189 2180 2189 -2 2180 2189 -32 0 -2 2180 2189 2190 129 8 -13 0 -10 8 -11 0 2187 2195 2180 2189 2180 -2 2189 2180 -5 0 2189 2187 -3 2195 2180 2187 -2 2195 2187 2180 2189 2180 -2 2195 2187 2195 2187 2195 2189 2180 2189 2180 2189 2180 2189 2187 2195 2187 2195 2180 2181 2180 2189 2180 2179 2187 -2 2195 2187 2195 2187 2195 2187 2195 2187 2195 2187 2195 2187 2195 2187 2195 2187 2195 2187 2195 2189 2197 2187 2195 2189 2195 2187 2195 2189 2180 2189 -2 2187 2195 2187 2195 2187 2195 2187 2195 2187 2195 2187 2195 2181 2180 2189 2180 2189 2180 2189 2180 2189 2180 2189 2180 2189 2195 2187 2198 2199 2186 0 2185 2200 2195 2187 2195 2187 2195 2187 2195 2187 2189 2180 2189 2180 2189 2180 2189 2180 2189 2180 2195 2187 2195 2187 2195 -2 2187 2195 2187 2195 2187 2195 2187 2195 2189 2180 2189 2180 2195 2187 2195 2187 2195 2187 2189 2180 2189 2180 2195 2187 2195 2187 2195 -2 2187 2195 2187 2195 2187 2195 2187 2195 -3 2187 2195 2187 2195 2187 2195 2187 2195 2187 -74 0 2180 2189 -2 2195 2187 2195 2180 2195 -5 0 2180 2189 2180 2189 2180 -2 2189 2180 -42 0 2180 2189 2180 2189 2180 2189 2180 2195 2187 2195 2187 2195 2180 2195 2187 2195 2187 2195 2196 2189 2180 2189 2180 2189 2180 2189 2180 2189 2180 2189 2180 2189 2180 2189 2180 2189 2180 2189 2180 2195 2187 2195 2187 2195 2180 2195 2180 2189 2190 2185 2200 2189 2180 2189 2180 2189 2180 2189 2180 2189 2180 2189 2180 2189 2180 2189 2180 2189 2180 2189 2180 2189 2180 2189 2180 -2 2189 2180 2189 2180 2189 2180 2189 2180 2189 2180 -111 0 2187 -3 2195 2187 2195 2187 2180 -5 0 2180 2187 -2 2195 2187 2195 2180 2195 -42 0 2195 2187 -2 2195 2187 2195 2187 2180 2196 2180 2181 2180 2187 2180 2181 2180 2189 2180 2182 2184 2187 2195 2187 2195 2187 2195 2187 2195 2187 2195 2182 2183 2184 2187 -2 2195 2187 2195 2187 2180 2196 2180 2181 2180 2187 2180 2187 2195 2198 2200 2187 2195 2187 2195 2187 2195 2187 2195 2187 2195 2187 2195 2187 2195 2187 2195 2187 2195 2187 2195 2187 2195 2187 2195 2187 -2 2195 2187 2195 2187 2195 2187 2195 2187 2195 2187 -111 0 2187 2195 2187 2195 2189 2180 2189 2187 -5 0 2195 2180 2189 2180 2179 2189 -2 2180 -42 0 2189 2197 2187 2195 2189 2180 2189 2187 2179 2188 2189 2187 2189 2188 2189 2187 -2 2195 2198 2200 2189 2180 2189 2180 2189 2180 2189 2180 2189 2180 2198 2199 2200 2197 2187 2195 2189 2180 2189 2187 2179 2188 2189 2187 2189 2188 2189 2180 2189 2180 2189 2180 2189 2180 2189 2180 2189 2180 2189 2180 2189 2180 2189 2180 2189 2180 2189 2180 2189 2180 2189 2180 2189 2180 2189 -2 2180 2189 2195 2189 2180 2189 2180 2189 2180 2189 -111 0 2189 2180 2195 2187 2195 2187 2195 2196 -5 0 2189 2187 -3 2195 2180 -2 2187 -42 0 2195 2187 2195 2187 2195 2187 2195 2196 2180 2181 2180 2189 2195 2187 2195 2187 2195 2187 2195 2187 2195 2187 2195 2187 2195 2187 2195 2187 2195 2187 2195 2187 2195 2187 2195 2187 2195 2187 2195 2196 2180 2181 2180 2189 2195 2187 2195 2187 2195 2187 2195 2187 2195 2187 2195 2187 2195 2187 2195 2187 2195 2187 2195 2187 2195 2187 2195 2187 2195 2187 2195 2187 2195 2187 2195 -2 2187 2195 2187 2195 2187 2195 2187 2195 2187 2195 -111 0 2195 2187 2180 2181 2180 2189 2180 2179 -5 0 2195 2189 2180 2189 2180 -2 2189 2196 -42 0 2180 2196 2180 2181 2180 2189 2180 2179 2188 2189 2187 2195 2180 2189 2180 2187 2195 2187 2195 2187 -2 2195 2187 2195 2187 2195 2187 2195 2187 2195 2187 2195 2187 2196 2180 2181 2180 2189 2180 2179 2188 2189 2187 2195 2180 2189 2195 2189 2180 2189 2180 2189 2180 2189 2180 2189 2180 2189 2180 2189 2180 2189 2180 2189 2180 2189 2180 2189 2180 2189 2180 2189 2180 2189 2180 -2 2189 2180 2189 2180 2189 2180 2189 2180 2189 2180 -111 0 2187 2195 2180 2189 2187 -3 2195 -5 0 2180 2187 -2 2195 2187 2195 2180 2179 -42 0 2187 2179 2188 2189 2187 -3 2195 2187 2195 2187 2195 2187 2195 2187 2189 2180 2189 -2 2180 2189 2180 2189 2180 2189 2180 2189 2180 2189 2180 2189 2180 2189 2179 2188 2189 2187 -3 2195 2187 2195 2187 2195 2187 -3 2195 2187 2195 2187 2195 2187 2195 2187 2195 2187 2189 2180 2189 2180 2189 2180 2189 2180 2189 2187 2195 2187 2195 2187 2195 2187 2195 -2 2187 -2 2195 2187 2195 2187 2195 2187 2195 2187 2195 -111 0 2189 -3 2180 2189 2180 2189 2180 -5 0 2187 2179 2188 2189 2187 -3 2195 -42 0 2196 2180 2181 2180 2189 2180 2189 2180 2189 2180 2189 2180 2189 2180 2189 2195 2187 2195 -2 2187 2195 2187 2195 2187 2195 2187 2195 2187 2195 2187 2195 2187 2195 2180 2181 2180 2189 2180 2189 2180 2189 2180 2189 2180 2189 -2 2180 2187 2195 2187 2195 2187 2195 2187 2195 2187 -2 2195 2187 2195 2187 2195 2187 2195 2187 2195 2189 2180 2189 2180 2189 2180 2189 2180 -2 2189 -2 2180 2189 2180 2189 2180 2189 2180 2189 2180 -111 0 2195 -2 2187 2195 2187 2195 2187 2195 -5 0 2196 2180 2181 2180 2189 2180 2189 2180 -42 0 2179 2188 2189 2187 2195 2187 2195 2187 2195 2187 2195 2187 2195 2187 2195 2180 2189 2180 -2 2189 2180 2189 2180 2189 2180 2189 2180 2189 2180 2189 2180 2189 2180 2188 2189 2187 2195 2187 2195 2187 2195 2187 2195 2187 2195 -2 2187 2189 2180 2189 2180 2189 2180 2189 2180 2189 2180 2195 2187 2195 2187 2195 2187 2195 2187 -2 2195 2187 2195 2187 2189 2180 2195 2187 -3 2195 2187 2195 2187 2195 2187 2195 2187 2195 2187 -105 0)
    )
    (tilemap
      (solid #t)
      (z-pos 0)
      (name "Interactive")
      (width 260)
      (height 25)
      (tiles -534 11 19 -73 11 19 -128 11 19 -169 11 30 -6 17 31 -4 11 30 -7 17 31 30 -4 17 31 -233 11 12 -6 0 10 30 -2 17 31 12 -7 0 10 12 -4 0 10 30 -36 17 31 -34 11 30 -33 17 -127 11 12 -6 0 10 12 -2 0 10 12 -7 0 16 18 -4 0 10 12 -36 0 16 17 31 -32 11 12 -4 0 133 -21 0 -2 132 -5 0 -28 17 31 -8 11 30 -12 17 31 -4 11 30 -8 17 31 -2 11 30 -14 17 31 -6 11 30 -37 17 18 -6 0 16 18 -2 0 10 12 -13 0 16 18 -38 0 16 17 31 -30 11 12 -4 0 133 -21 0 -2 132 -33 0 16 -2 17 31 -2 11 30 -2 17 18 -12 0 16 31 -2 11 30 18 -8 0 16 -2 17 18 -14 0 16 -6 17 18 -48 0 10 12 -55 0 16 17 31 -28 11 12 -4 0 133 -21 0 -2 132 -36 0 16 -2 17 18 -16 0 16 31 30 18 -52 0 44 0 44 0 44 0 44 0 44 0 44 -4 0 44 0 44 0 44 -11 0 10 12 -57 0 16 -28 17 18 -4 0 133 -21 0 -2 132 -57 0 16 18 -52 0 7 -11 8 9 -2 0 7 -5 8 9 -4 0 -2 44 -4 0 16 18 -91 0 133 -21 0 -2 132 -96 0 44 0 44 0 44 0 44 0 44 0 44 -4 0 13 -11 14 15 -2 0 13 -5 14 15 -4 0 7 9 -97 0 133 -13 0 126 -7 0 -2 132 -5 0 -6 8 9 -29 0 -3 44 -20 0 -3 44 -28 0 7 -11 8 9 -3 0 16 -11 17 18 -2 0 16 -5 17 18 0 44 -2 0 13 15 -4 0 -2 44 -91 0 133 -21 0 -2 132 -5 0 -6 14 15 -69 0 7 9 -12 0 13 -11 14 15 -26 0 44 -2 0 10 12 -4 0 7 9 -57 0 7 -28 8 9 -4 0 133 -21 0 -2 132 -5 0 -6 11 12 -6 0 7 -5 8 9 -9 0 102 -46 0 13 15 -12 0 16 -11 17 18 -26 0 44 0 7 22 12 -4 0 13 15 -31 0 102 -23 0 7 8 114 -28 14 15 -4 0 133 -21 0 -2 132 -5 0 -6 11 12 -6 0 13 -5 14 15 -48 0 7 9 -6 0 10 12 -6 0 7 9 -39 0 103 -5 0 13 23 12 -4 0 10 12 -3 0 -2 44 -48 0 7 8 114 14 23 -28 11 12 -4 0 133 -21 0 -2 132 -5 0 -6 11 12 -6 0 10 -5 11 12 -48 0 13 15 -6 0 10 12 -6 0 13 15 -45 0 10 19 12 -4 0 10 12 -3 0 7 9 -46 0 7 8 114 14 23 -30 11 21 -4 8 133 -13 8 -8 0 -2 132 -5 8 -6 11 12 -6 0 10 -5 11 12 -6 0 7 -41 8 22 12 -6 0 10 12 -6 0 10 12 -37 0 7 -7 8 22 11 12 -4 0 10 12 -3 0 13 15 -5 0 7 9 -2 0 7 -36 8 114 14 23 -32 11 20 -33 14 -6 11 12 -6 0 10 -5 11 12 -6 0 13 -41 14 23 12 -6 0 10 12 -6 0 10 12 -37 0 13 -7 14 23 11 12 -4 0 10 12 -3 0 10 12 -5 0 13 15 -2 0 13 -36 14 23 -74 11 12 -6 0 10 -5 11 12 -6 0 10 -42 11 12 -6 0 10 12 -6 0 10 12 -37 0 16 -7 17 31 11 12 -4 0 10 12 -3 0 10 12 -5 0 10 12 -2 0 10 -111 11 12 -6 0 10 -5 11 12 -6 0 10 -42 11 12 -6 0 10 12 -6 0 10 12 -45 0 10 11 12 -4 0 10 12 -3 0 10 12 -5 0 10 12 -2 0 10 -58 11 19 -52 11 12 -6 0 10 -5 11 12 -6 0 10 -42 11 12 -6 0 10 12 -6 0 10 12 -45 0 10 11 12 -4 0 10 12 -3 0 10 12 -5 0 10 12 -2 0 10 -111 11 12 -6 0 10 -5 11 12 -6 0 10 -23 11 19 -18 11 12 -6 0 10 12 -6 0 10 12 -45 0 10 11 12 -4 0 10 12 -3 0 10 12 -5 0 10 12 -2 0 10 -10 11 19 -100 11 12 -6 0 10 -5 11 12 -6 0 10 -42 11 12 -6 0 10 12 -6 0 10 12 -45 0 10 11 12 -4 0 10 12 -3 0 10 12 -5 0 10 12 -2 0 10 -111 11 12 -6 0 10 -5 11 12 -6 0 10 -42 11 12 -6 0 10 12 -6 0 10 12 -45 0 10 11 12 -4 0 10 12 -3 0 10 12 -5 0 10 12 -2 0 10 -111 11 12 -6 0 10 -5 11 12 -6 0 10 -42 11 12 -6 0 10 12 -6 0 10 12 -45 0 10 11 12 -4 0 10 12 -3 0 10 12 -5 0 10 12 -2 0 10 -105 11)
    )
    (tilemap
      (solid #f)
      (z-pos 100)
      (name "Foreground")
      (width 260)
      (height 25)
      (tiles -1652 0 79 -7 0 79 -7 0 79 -7 0 79 -7 0 79 -227 0 79 -7 0 79 -7 0 79 -7 0 79 -7 0 79 -227 0 79 -7 0 79 -7 0 79 -7 0 79 -7 0 79 -227 0 79 -7 0 79 -7 0 79 -7 0 79 -7 0 79 -107 0 130 -119 0 79 -7 0 79 -131 0 129 -15 0 127 -103 0 79 -7 0 79 -131 0 129 -259 0 129 -259 0 129 -259 0 129 -259 0 129 -2367 0)
    )
    (tilemap
      (handle
        (scale_x 0)
        (scale_y 0)
        (offset_x 0)
        (offset_y 0)
      )
      (solid #f)
      (z-pos 101)
      (name "secret1")
      (path-ref "gen17713431632214076972336")
      (width 10)
      (height 7)
      (tiles -2 0 2185 2199 2186 -7 0 2192 2180 2198 2199 2186 -3 0 2185 2199 2200 2195 2187 2195 2198 -2 2199 2186 2192 2189 2180 2189 2180 2189 2180 2189 2180 2190 2192 2195 2187 2195 2187 2195 2187 2195 2188 2190 2192 -2 2195 2180 2189 2180 2189 2180 2182 2194 2193 -7 2183 2194 0)
    )
    (tilemap
      (solid #t)
      (z-pos -1)
      (name "Windows")
      (width 260)
      (height 25)
      (tiles -3019 0 2067 -3 2068 2069 -18 0 2067 -3 2068 2069 -108 0 2067 -3 2068 2069 -18 0 2067 -3 2068 2069 -96 0 2072 -3 2073 2074 -18 0 2072 -3 2073 2074 -108 0 2072 -3 2073 2074 -18 0 2072 -3 2073 2074 -96 0 2057 2060 2065 2061 2059 -18 0 2057 2060 2065 2061 2059 -108 0 2057 2060 2065 2061 2059 -18 0 2057 2060 2065 2061 2059 -96 0 2057 2060 2065 2060 2059 -18 0 2057 2060 2065 2060 2059 -108 0 2057 2060 2065 2060 2059 -18 0 2057 2060 2065 2060 2059 -96 0 2057 -3 2061 2059 -18 0 2057 -3 2061 2059 -108 0 2057 -3 2061 2059 -18 0 2057 -3 2061 2059 -96 0 2057 -3 2061 2059 -18 0 2057 -3 2061 2059 -2153 0)
    )
    (tilemap
      (solid #f)
      (speed-x 0.5)
      (speed-y 0.5)
      (z-pos -150)
      (name "Background_para1")
      (width 175)
      (height 25)
      (tiles -1236 0 149 160 151 -35 0 149 160 151 -35 0 149 160 151 -35 0 149 160 151 -35 0 149 160 151 -14 0 149 160 151 -2 0 149 159 153 158 151 -28 0 149 160 151 -2 0 149 159 153 158 151 -28 0 149 160 151 -2 0 149 159 153 158 151 -28 0 149 160 151 -2 0 149 159 153 158 151 -28 0 149 160 151 -2 0 149 159 153 158 151 -12 0 149 159 153 158 151 0 152 -3 153 158 -2 160 151 -24 0 149 159 153 158 151 0 152 -3 153 158 -2 160 151 -24 0 149 159 153 158 151 0 152 -3 153 158 -2 160 151 -24 0 149 159 153 158 151 0 152 -3 153 158 -2 160 151 -24 0 149 159 153 158 151 0 152 -3 153 158 -2 160 151 -9 0 152 -3 153 158 160 159 -6 153 154 -5 0 149 160 151 -16 0 152 -3 153 158 160 159 -6 153 154 -5 0 149 160 151 -16 0 152 -3 153 158 160 159 -6 153 154 -5 0 149 160 151 -16 0 152 -3 153 158 160 159 -6 153 154 -5 0 149 160 151 -16 0 152 -3 153 158 160 159 -6 153 154 -5 0 -4 160 159 -12 153 154 -4 0 149 159 153 158 151 -6 0 149 160 151 0 149 -4 160 159 -12 153 154 -4 0 149 159 153 158 151 -6 0 149 160 151 0 149 -4 160 159 -12 153 154 -4 0 149 159 153 158 151 -6 0 149 160 151 0 149 -4 160 159 -12 153 154 -4 0 149 159 153 158 151 -6 0 149 160 151 0 149 -4 160 159 -12 153 154 -4 0 149 -17 153 154 -4 0 152 -3 153 158 -2 160 151 -2 0 149 159 153 158 151 152 -17 153 154 -4 0 152 -3 153 158 -2 160 151 -2 0 149 159 153 158 151 152 -17 153 154 -4 0 152 -3 153 158 -2 160 151 -2 0 149 159 153 158 151 152 -17 153 154 -4 0 152 -3 153 158 -2 160 151 -2 0 149 159 153 158 151 152 -17 153 154 -4 0 152 -17 153 158 -4 160 159 -6 153 154 -2 0 152 -3 153 158 159 -17 153 158 -4 160 159 -6 153 154 -2 0 152 -3 153 158 159 -17 153 158 -4 160 159 -6 153 154 -2 0 152 -3 153 158 159 -17 153 158 -4 160 159 -6 153 154 -2 0 152 -3 153 158 159 -17 153 158 -4 160 159 -29 153 158 -2 160 159 -34 153 158 -2 160 159 -34 153 158 -2 160 159 -34 153 158 -2 160 159 -1778 153)
    )
    (tilemap
      (solid #f)
      (speed-x 0.2)
      (speed-y 0.2)
      (z-pos -200)
      (name "Background_para2")
      (width 90)
      (height 25)
      (tiles -729 0 161 163 -34 0 161 163 -34 0 161 163 -7 0 163 -8 0 164 166 -6 0 161 -2 162 163 -13 0 161 162 163 -8 0 164 166 -6 0 161 -2 162 163 -13 0 161 162 163 -8 0 164 166 -6 0 161 170 -2 162 163 -4 0 161 171 166 -6 0 164 -2 165 170 163 -12 0 164 165 170 -2 162 163 -4 0 161 171 166 -6 0 164 -2 165 170 163 -12 0 164 165 170 -2 162 163 -4 0 161 171 166 -6 0 164 -3 165 166 -4 0 164 165 170 163 -3 0 161 162 171 -3 165 166 -10 0 161 162 171 -4 165 166 -4 0 164 165 170 163 -3 0 161 162 171 -3 165 166 -10 0 161 162 171 -4 165 166 -4 0 164 165 170 163 -3 0 161 162 171 -3 165 166 -3 0 161 171 -2 165 170 -3 162 171 -5 165 166 -4 0 161 -2 162 163 -2 0 164 -6 165 166 -3 0 161 171 -2 165 170 -3 162 171 -5 165 166 -4 0 161 -2 162 163 -2 0 164 -6 165 166 -3 0 161 171 -2 165 170 -3 162 171 -5 165 170 -3 162 171 -13 165 170 -4 162 171 -2 165 170 -2 162 171 -6 165 170 -3 162 171 -13 165 170 -4 162 171 -2 165 170 -2 162 171 -6 165 170 -3 162 171 -1000 165)
    )
  )
)
