(supertux-level
  (version 3)
  (name (_ "The Escape"))
  (author "SuperTux Team")
  (license "GPL 2+ / CC-by-sa 3.0")
  (target-time 60)
  (allow-item-pocket "inherit")
  (icon "")
  (icon-locked "")
  (statistics
    (enable-coins #t)
    (enable-secrets #t)
  )
  (sector
    (name "main")
    (ambient-light
      (color 1 1 1)
    )
    (bouncingsnowball
      (z-pos 50)
      (x 7105)
      (y 384)
      (glinting #f)
    )
    (camera
      (name "Camera")
      (mode "normal")
    )
    (firefly
      (z-pos 0)
      (x 8329)
      (y 303)
    )
    (gradient
      (top_color 0.5 0.7 1)
      (bottom_color 1 1 1)
    )
    (jumpy
      (z-pos 50)
      (x 2032)
      (y 341)
      (glinting #f)
    )
    (jumpy
      (z-pos 50)
      (x 4494)
      (y 510)
      (glinting #f)
    )
    (jumpy
      (z-pos 50)
      (x 12398)
      (y 375)
      (glinting #f)
    )
    (jumpy
      (z-pos 50)
      (x 15232)
      (y 320)
      (glinting #f)
    )
    (jumpy
      (z-pos 50)
      (x 15168)
      (y 283)
      (glinting #f)
    )
    (jumpy
      (z-pos 50)
      (x 15104)
      (y 252)
      (glinting #f)
    )
    (mrbomb
      (z-pos 50)
      (x 2353)
      (y 528)
      (glinting #f)
    )
    (mrbomb
      (z-pos 50)
      (x 7821)
      (y 242)
      (glinting #f)
    )
    (mrbomb
      (z-pos 50)
      (x 7997)
      (y 240)
      (glinting #f)
    )
    (mrbomb
      (z-pos 50)
      (x 9595)
      (y 304)
      (glinting #f)
    )
    (mrbomb
      (z-pos 50)
      (x 9775)
      (y 302)
      (glinting #f)
    )
    (mrbomb
      (z-pos 50)
      (x 14831)
      (y 529)
      (glinting #f)
    )
    (mrbomb
      (z-pos 50)
      (x 14134)
      (y 180)
      (glinting #f)
    )
    (mrbomb
      (z-pos 50)
      (x 5174)
      (y 211)
      (glinting #f)
    )
    (mriceblock
      (z-pos 50)
      (x 1565)
      (y 377)
      (glinting #f)
    )
    (mriceblock
      (z-pos 50)
      (x 1621)
      (y 379)
      (glinting #f)
    )
    (mriceblock
      (z-pos 50)
      (x 2573)
      (y 538)
      (glinting #f)
    )
    (mriceblock
      (z-pos 50)
      (x 2511)
      (y 541)
      (glinting #f)
    )
    (mriceblock
      (z-pos 50)
      (x 2636)
      (y 539)
      (glinting #f)
    )
    (mriceblock
      (z-pos 50)
      (x 3084)
      (y 539)
      (glinting #f)
    )
    (mriceblock
      (z-pos 50)
      (x 3558)
      (y 543)
      (glinting #f)
    )
    (mriceblock
      (z-pos 50)
      (x 4922)
      (y 538)
      (glinting #f)
    )
    (mriceblock
      (z-pos 50)
      (x 5657)
      (y 539)
      (glinting #f)
    )
    (mriceblock
      (z-pos 50)
      (x 11761)
      (y 184)
      (glinting #f)
    )
    (mriceblock
      (z-pos 50)
      (x 12393)
      (y 540)
      (glinting #f)
    )
    (mriceblock
      (z-pos 50)
      (x 12728)
      (y 284)
      (glinting #f)
    )
    (mriceblock
      (z-pos 50)
      (x 13980)
      (y 538)
      (glinting #f)
    )
    (mriceblock
      (z-pos 50)
      (x 13880)
      (y 539)
      (glinting #f)
    )
    (mriceblock
      (z-pos 50)
      (x 14064)
      (y 539)
      (glinting #f)
    )
    (mriceblock
      (z-pos 50)
      (x 15053)
      (y 359)
      (glinting #f)
    )
    (mriceblock
      (z-pos 50)
      (x 14678)
      (y 430)
      (glinting #f)
    )
    (mriceblock
      (z-pos 50)
      (x 9554)
      (y 538)
      (glinting #f)
    )
    (music
      (file "music/chipdisko.ogg")
    )
    (secretarea
      (width 707.9941)
      (height 105.5391)
      (x 13516.74)
      (y 119.8608)
    )
    (smartball
      (z-pos 50)
      (x 6959)
      (y 539)
      (glinting #f)
    )
    (smartball
      (z-pos 50)
      (x 10179)
      (y 550)
      (glinting #f)
    )
    (smartblock
      (z-pos 50)
      (x 12636)
      (y 283)
      (glinting #f)
    )
    (smartblock
      (z-pos 50)
      (x 9317)
      (y 316)
      (glinting #f)
    )
    (snowball
      (z-pos 50)
      (x 10837)
      (y 213)
      (glinting #f)
    )
    (snowball
      (z-pos 50)
      (x 10710)
      (y 283)
      (glinting #f)
    )
    (snowball
      (z-pos 50)
      (x 10518)
      (y 411)
      (glinting #f)
    )
    (spawnpoint
      (name "main")
      (x 96)
      (y 352)
    )
    (spiky
      (z-pos 50)
      (x 3775)
      (y 535)
      (glinting #f)
    )
    (spiky
      (z-pos 50)
      (x 3864)
      (y 533)
      (glinting #f)
    )
    (spiky
      (z-pos 50)
      (x 5113)
      (y 534)
      (glinting #f)
    )
    (spiky
      (z-pos 50)
      (x 5176)
      (y 532)
      (glinting #f)
    )
    (spiky
      (z-pos 50)
      (x 7977)
      (y 532)
      (glinting #f)
    )
    (stalactite
      (glinting #f)
      (z-pos -1)
      (x 4143)
      (y 320)
    )
    (stalactite
      (glinting #f)
      (z-pos -1)
      (x 8400)
      (y 393)
    )
    (stalactite
      (glinting #f)
      (z-pos -1)
      (x 5016)
      (y 288)
    )
    (stalactite
      (glinting #f)
      (z-pos -1)
      (x 5125)
      (y 288)
    )
    (stalactite
      (glinting #f)
      (z-pos -1)
      (x 9578)
      (y 391)
    )
    (stalactite
      (glinting #f)
      (z-pos -1)
      (x 9779)
      (y 392)
    )
    (stalactite
      (glinting #f)
      (z-pos -1)
      (x 13666)
      (y 265)
    )
    (stalactite
      (glinting #f)
      (z-pos -1)
      (x 13762)
      (y 266)
    )
    (stalactite
      (glinting #f)
      (z-pos -1)
      (x 13857)
      (y 266)
    )
    (stalactite
      (glinting #f)
      (z-pos -1)
      (x 13954)
      (y 266)
    )
    (tilemap
      (solid #f)
      (z-pos -100)
      (name "Background")
      (width 515)
      (height 25)
      (tiles -1906 0 122 209 123 -512 0 124 210 125 -151 0 -5 2187 2198 2186 -354 0 124 210 125 0 106 107 108 -147 0 -6 2187 2190 -350 0 -4 2069 124 210 125 0 109 110 111 -54 0 7 -21 8 9 -39 0 130 -30 0 -6 2187 2198 2186 -294 0 122 123 -42 0 106 107 108 -10 0 2069 -124 0 129 -30 0 -7 2187 2190 -291 0 122 123 0 124 125 0 122 123 -39 0 109 110 111 -8 0 2062 2051 2065 2060 2061 2060 2061 -2 2058 2066 2050 2064 -115 0 129 -30 0 -7 2187 2190 -291 0 124 125 0 124 125 0 124 125 -51 0 2062 2051 2065 2058 2065 2066 -2 2058 2050 2064 -102 0 122 123 -12 0 129 -30 0 -7 2187 2198 2186 -239 0 -2 17 0 17 -41 0 2068 -5 0 124 125 0 124 125 0 124 125 -52 0 2057 2061 2060 -3 2058 2050 2064 -100 0 122 123 0 124 125 0 122 123 -9 0 129 -30 0 -8 2187 2190 -34 0 106 107 108 -247 0 2073 -65 0 2057 2058 2050 2063 2051 2065 2055 2054 -22 0 2062 2051 2065 2058 2065 2066 -2 2058 2050 2064 -68 0 124 125 0 124 125 0 124 125 -9 0 129 -30 0 -8 2187 2190 -34 0 109 110 111 -246 0 -3 2058 2050 -62 0 2052 2056 2050 2064 0 2062 2051 2065 2055 0 25 -21 0 2062 2051 -2 2065 2066 2058 2065 2059 -69 0 124 125 0 124 125 0 124 125 -9 0 129 8 -14 0 7 -9 8 -115 0 2057 -2 2058 2059 -138 0 2057 2066 2059 -36 0 2057 -3 2058 2059 -94 0 2052 2056 2058 2065 2066 2058 2065 2055 2054 -191 0 122 123 0 122 123 -18 0 2057 2060 2059 -9 0 2057 2060 2061 2059 -33 0 122 123 -44 0 25 -30 0 122 123 -4 0 2057 -3 2058 2059 -53 0 122 123 0 2057 -3 2058 2059 -22 0 122 123 -110 0 122 123 -155 0 122 123 0 124 125 0 124 125 0 122 123 -15 0 2057 2058 2059 -8 0 2052 2056 2058 2060 2059 -4 0 122 123 -24 0 122 123 0 124 125 0 122 123 -72 0 124 125 0 122 123 0 2057 -3 2058 2059 -53 0 124 125 0 2057 -3 2058 2059 -19 0 122 123 0 124 125 0 122 123 -60 0 2062 2063 2051 2060 2061 -2 2060 2061 -2 2060 2061 2060 2061 2060 2050 2064 -28 0 122 123 0 124 125 0 122 123 -152 0 124 125 0 124 125 0 124 125 0 124 125 0 106 107 108 2052 2056 2058 2059 -7 0 2057 2060 2059 -8 0 2057 2060 2061 2065 2055 2054 122 123 0 124 125 0 122 123 -21 0 124 125 0 124 125 0 124 125 -22 0 106 107 108 -40 0 106 107 108 -4 0 124 125 0 124 125 0 2057 -3 2058 2059 -46 0 106 107 108 -4 0 124 125 0 2057 -3 2058 2059 -19 0 124 125 0 124 125 0 124 125 -54 0 122 123 0 122 123 -3 0 2057 2065 2058 -2 2065 2058 -2 2065 2058 2065 2058 2065 2059 -29 0 124 125 0 124 125 0 124 125 0 106 107 108 -14 0 106 107 108 -131 0 124 125 0 124 125 0 124 125 0 124 125 0 109 110 111 2057 -2 2060 2055 2054 -5 0 2052 2056 2065 2055 2054 -3 0 25 -3 0 2057 2058 2060 2066 2058 2059 124 125 0 124 125 0 124 125 -19 0 25 0 124 125 24 124 125 0 124 125 -3 0 24 -18 0 109 110 111 -37 0 24 -2 0 109 110 111 -4 0 124 125 0 124 125 0 2057 -3 2058 2059 -9 0 24 -36 0 109 110 111 -2 0 25 0 124 125 0 2057 -3 2058 2059 0 25 -17 0 1345 125 0 124 125 0 124 125 -54 0 124 125 0 124 125 -2 0 2052 2056 2058 2061 -2 2060 2061 -4 2060 2061 2060 2055 2054 -28 0 124 125 0 124 125 0 124 125 0 109 110 111 -14 0 109 110 111 -21 0 76 -22 0 76 -53 0 122 123 -29 0 24 0 124 125 0 124 125 0 124 125 0 124 125 -394 0 75 -22 0 75 -29 0 122 123 -13 0 122 123 -7 0 124 125 -436 0 75 -22 0 75 -29 0 124 125 -10 0 122 123 0 124 125 -7 0 124 125 -436 0 75 -22 0 75 -29 0 124 125 0 122 123 -7 0 124 125 0 124 125 -7 0 124 125 0 122 123 -433 0 75 -22 0 75 -29 0 124 125 0 124 125 -7 0 124 125 0 124 125 -7 0 124 125 0 124 125 -433 0 75 -22 0 75 -29 0 124 125 0 124 125 -7 0 124 125 0 124 125 -7 0 124 125 0 124 125 -433 0 75 -22 0 75 -29 0 124 125 0 124 125 -7 0 124 125 0 124 125 -7 0 124 125 0 124 125 -433 0 75 -22 0 75 -14 0)
    )
    (tilemap
      (solid #t)
      (z-pos 0)
      (name "Interactive")
      (width 515)
      (height 25)
      (tiles -6 11 12 -508 0 -6 11 12 -508 0 -6 11 12 -508 0 -6 11 12 -508 0 -6 11 12 -478 0 133 -22 0 -2 132 -5 0 -6 17 18 -129 0 -8 44 -108 0 2067 2068 2069 -230 0 133 -22 0 -2 132 -141 0 27 -6 28 29 -108 0 2072 2073 2074 -102 0 2067 -10 2068 2069 -53 0 -23 44 -40 0 133 -22 0 -2 132 -156 0 -12 44 -89 0 2057 2066 2059 -10 0 7 -2 8 9 -24 0 7 8 9 -40 0 7 -2 8 9 -17 0 2072 -10 2073 2074 -36 0 -2 1311 -6 0 -2 1311 -7 0 13 -21 14 15 -40 0 133 -14 0 126 -7 0 -2 132 -127 0 -9 44 -20 0 27 -10 28 29 -76 0 2067 -11 2068 2069 2056 2058 2055 2067 2068 2069 -7 0 13 -2 14 15 -24 0 13 14 15 -40 0 13 -2 14 15 -5 0 7 -5 8 9 -43 0 -4 44 -23 0 16 -21 17 18 -40 0 133 -22 0 -2 132 -127 0 27 -7 28 29 -69 0 102 -38 0 2072 -11 2073 2078 2058 2066 2060 2077 2073 2074 -7 0 10 -2 11 21 -2 8 9 -21 0 10 11 12 -37 0 7 -2 8 22 -2 11 12 -5 0 13 -5 14 15 -37 0 2067 -8 2068 2069 -86 0 133 -22 0 -2 132 -22 0 102 -188 0 83 78 2947 78 83 78 -27 0 2062 -10 2063 2051 2066 2060 2058 -2 2060 2050 2064 -2 0 7 -4 8 22 -2 11 20 -2 14 15 -12 0 2067 -8 2068 10 11 21 -12 8 9 -24 0 13 -2 14 23 -2 11 12 -5 0 16 17 31 11 30 17 18 -6 0 102 83 -5 0 -2 83 -18 0 -2 83 -2 0 2072 -8 2073 2074 -86 0 133 -22 0 -2 132 -115 0 2067 -2 2068 2069 -136 0 2062 2051 2060 2058 2060 2050 2064 -3 0 13 -4 14 23 -5 11 21 -2 8 9 -9 0 2072 -8 2073 10 11 20 -12 14 15 -21 0 7 -2 8 22 -5 11 12 -7 0 10 11 12 -135 0 133 -22 0 -2 132 -5 0 -8 8 9 -33 0 7 -8 8 9 -7 0 7 -8 8 9 -41 0 2072 -2 2073 2074 -116 0 2067 -3 2068 2069 -16 0 2062 2051 2066 2050 2064 -4 0 16 -4 17 31 -5 11 20 -2 14 15 -9 0 2062 -6 2063 2051 0 16 -14 17 18 -21 0 13 -2 14 23 -5 11 12 -7 0 10 11 12 -5 0 7 -4 8 9 -3 0 7 -5 8 9 -22 0 -6 44 -14 0 -3 44 -41 0 -2 44 -6 0 7 -11 8 9 7 -6 8 133 -13 8 9 -8 0 132 1311 -5 8 -8 14 15 -16 0 7 -9 8 9 -6 0 13 -8 14 15 -7 0 13 -8 14 15 -29 0 2067 2068 2069 -98 0 -2 78 -29 0 2072 -3 2073 2074 -15 0 7 -6 8 9 -7 0 10 -8 11 21 -2 8 9 -49 0 7 -2 8 22 -8 11 12 -7 0 10 11 12 -5 0 13 -4 14 15 -3 0 13 -5 14 15 -12 0 2067 -14 2068 2069 -13 0 7 -3 8 9 -40 0 -2 44 -6 0 13 -11 14 15 27 -20 28 29 13 -14 14 -8 11 12 -4 0 7 -6 8 9 -4 0 13 -9 14 15 -6 0 16 -3 17 31 30 -3 17 18 -7 0 16 -3 17 31 30 -3 17 18 -19 0 2067 2068 2069 -7 0 2072 2073 2074 -90 0 7 -2 8 9 -10 0 -8 78 -7 0 7 8 9 -16 0 7 -2 8 9 -7 0 13 -6 14 15 -5 0 -2 44 10 -8 11 20 -2 14 15 -49 0 13 -2 14 23 -8 11 12 -7 0 10 11 12 -5 0 16 -4 17 18 -3 0 16 -5 17 18 -7 0 -3 83 -2 0 2072 -14 2073 2074 -6 0 -2 44 -5 0 13 -3 14 15 -20 0 -3 83 -16 0 7 -2 8 9 -5 0 10 -11 11 12 -22 0 10 -22 11 12 -4 0 13 -6 14 15 -4 0 16 -9 17 18 -10 0 10 12 -15 0 10 12 -2 44 -21 0 2072 2073 2074 -91 0 7 -2 8 9 -5 0 13 -2 14 15 -25 0 13 14 15 -16 0 13 -2 14 15 -7 0 16 31 -4 11 30 18 -5 0 -2 44 10 -11 11 21 -2 8 9 -43 0 7 -2 8 22 -11 11 12 -7 0 10 11 12 -54 0 7 -2 8 9 -4 0 10 -3 11 12 -39 0 13 -2 14 15 -5 0 10 -11 11 12 -22 0 10 -22 11 12 -4 0 16 -6 17 18 -25 0 10 12 -15 0 10 12 -2 44 -115 0 13 -2 14 15 -5 0 10 -2 11 12 -25 0 10 11 12 -16 0 10 -2 11 12 -8 0 10 -4 11 12 -6 0 -2 44 10 -6 11 19 -4 11 20 -2 14 15 -43 0 13 -2 14 23 -11 11 12 -7 0 10 11 12 -38 0 -11 44 -5 0 13 -2 14 15 -4 0 10 -3 11 12 -5 0 7 8 9 -31 0 10 -2 11 12 -5 0 10 -11 11 12 -22 0 10 -22 11 12 -37 0 10 12 -15 0 10 21 -2 8 2913 2914 -14 0 2909 2910 -39 8 9 -3 0 7 -2 8 9 -5 0 7 -26 8 9 -5 0 7 -6 8 9 -4 0 10 -2 11 12 -5 0 10 -2 11 12 -6 0 7 -18 8 22 11 21 -16 8 22 -2 11 21 -8 8 22 -3 11 19 21 -8 8 22 -14 11 21 -18 8 9 -4 0 7 -2 8 9 -5 0 7 -10 8 22 -14 11 12 -7 0 10 11 12 -25 0 7 -22 8 9 -5 0 10 -2 11 12 -4 0 10 -3 11 12 -5 0 13 14 113 -15 8 9 -5 0 7 -9 8 22 -2 11 21 -5 8 22 -11 11 12 -22 76 10 -22 11 12 -37 0 10 12 -15 0 10 20 -2 14 2915 2916 2917 2918 -10 8 2921 2922 2911 2912 -39 14 15 -3 0 13 -2 14 15 -5 0 13 -26 14 15 -5 0 13 -6 14 15 -4 0 10 -2 11 12 -5 0 10 -2 11 12 -6 0 13 -18 14 23 11 20 -16 14 23 -2 11 20 -8 14 23 -4 11 20 -8 14 23 -14 11 20 -18 14 15 -4 0 13 -2 14 15 -5 0 13 -10 14 23 -14 11 12 -7 0 10 11 12 -25 0 13 -22 14 15 -5 0 10 -2 11 12 -4 0 10 -3 11 12 -5 0 10 11 20 -15 14 15 -5 0 13 -9 14 23 -2 11 20 -5 14 23 -11 11 12 -22 75 10 -22 11 12 -37 0 10 12 -15 0 10 -5 11 2919 2920 -10 14 2923 2924 -41 11 12 -3 0 10 -2 11 12 -5 0 10 -26 11 12 -5 0 10 -6 11 12 -4 0 10 -2 11 12 -5 0 10 -2 11 12 -6 0 10 -97 11 12 -4 0 10 -2 11 12 -5 0 10 -25 11 12 -7 0 10 11 12 -25 0 16 -22 17 18 -5 0 10 -2 11 12 -4 0 10 -3 11 12 -5 0 10 -17 11 12 -5 0 10 -30 11 12 -22 75 10 -22 11 12 -37 0 10 12 -15 0 10 -60 11 12 -3 0 10 -2 11 12 -5 0 10 -26 11 12 -5 0 10 -6 11 12 -4 0 10 -2 11 12 -5 0 10 -2 11 12 -6 0 10 -97 11 12 -4 0 10 -2 11 12 -5 0 10 -25 11 12 -7 0 10 11 12 -54 0 10 -2 11 12 -4 0 10 -3 11 12 -5 0 10 -17 11 12 -5 0 10 -30 11 12 -22 75 10 -22 11 12 -37 0 10 12 -15 0 10 -60 11 12 -3 0 10 -2 11 12 -5 0 10 -26 11 12 -5 0 10 -6 11 12 -4 0 10 -2 11 12 -5 0 10 -2 11 12 -6 0 10 -97 11 12 -4 0 10 -2 11 12 -5 0 10 -25 11 12 -7 0 10 11 12 -54 0 10 -2 11 12 -4 0 10 -3 11 12 -5 0 10 -17 11 12 -5 0 10 -30 11 12 -22 75 10 -22 11 12 -37 0 10 12 -15 0 10 -60 11 12 -3 0 10 -2 11 12 -5 0 10 -26 11 12 -5 0 10 -6 11 12 -4 0 10 -2 11 12 -5 0 10 -2 11 12 -6 0 10 -97 11 12 -4 0 10 -2 11 12 -5 0 10 -25 11 12 -7 0 10 11 12 -54 0 10 -2 11 12 -4 0 10 -3 11 12 -5 0 10 -17 11 12 -5 0 10 -30 11 12 -22 75 10 -22 11 12 -37 0 10 12 -15 0 10 -60 11 12 -3 0 10 -2 11 12 -5 0 10 -26 11 12 -5 0 10 -6 11 12 -4 0 10 -2 11 12 -5 0 10 -2 11 12 -6 0 10 -97 11 12 -4 0 10 -2 11 12 -5 0 10 -25 11 12 -7 0 10 11 12 -54 0 10 -2 11 12 -4 0 10 -3 11 12 -5 0 10 -17 11 12 -5 0 10 -30 11 12 -22 75 10 -22 11 12 -37 0 10 12 -15 0 10 -60 11 12 -3 0 10 -2 11 12 -5 0 10 -26 11 12 -5 0 10 -6 11 12 -4 0 10 -2 11 12 -5 0 10 -2 11 12 -6 0 10 -97 11 12 -4 0 10 -2 11 12 -5 0 10 -25 11 12 -7 0 10 11 12 -54 0 10 -2 11 12 -4 0 10 -3 11 12 -5 0 10 -17 11 12 -5 0 10 -30 11 12 -22 75 10 -14 11)
    )
    (tilemap
      (solid #f)
      (z-pos 100)
      (name "Foreground")
      (width 515)
      (height 25)
      (tiles -3494 0 85 86 87 88 -4 0 85 86 87 88 -70 0 130 -432 0 89 90 91 92 -4 0 89 90 91 92 -70 0 129 -16 0 127 -497 0 129 -514 0 129 -514 0 129 -514 0 129 -514 0 129 -6208 0)
    )
    (tilemap
      (solid #f)
      (speed-x 0.5)
      (speed-y 0.5)
      (z-pos -150)
      (name "Background_para1")
      (width 350)
      (height 25)
      (tiles -2461 0 149 160 151 -35 0 149 160 151 -35 0 149 160 151 -35 0 149 160 151 -35 0 149 160 151 -35 0 149 160 151 -35 0 149 160 151 -35 0 149 160 151 -35 0 149 160 151 -37 0 149 160 151 -2 0 149 159 153 158 151 -28 0 149 160 151 -2 0 149 159 153 158 151 -28 0 149 160 151 -2 0 149 159 153 158 151 -28 0 149 160 151 -2 0 149 159 153 158 151 -28 0 149 160 151 -2 0 149 159 153 158 151 -28 0 149 160 151 -2 0 149 159 153 158 151 -28 0 149 160 151 -2 0 149 159 153 158 151 -28 0 149 160 151 -2 0 149 159 153 158 151 -28 0 149 160 151 -2 0 149 159 153 158 151 -28 0 149 160 151 -4 0 149 159 153 158 151 0 152 -3 153 158 -2 160 151 -24 0 149 159 153 158 151 0 152 -3 153 158 -2 160 151 -24 0 149 159 153 158 151 0 152 -3 153 158 -2 160 151 -24 0 149 159 153 158 151 0 152 -3 153 158 -2 160 151 -24 0 149 159 153 158 151 0 152 -3 153 158 -2 160 151 -24 0 149 159 153 158 151 0 152 -3 153 158 -2 160 151 -24 0 149 159 153 158 151 0 152 -3 153 158 -2 160 151 -24 0 149 159 153 158 151 0 152 -3 153 158 -2 160 151 -24 0 149 159 153 158 151 0 152 -3 153 158 -2 160 151 -24 0 149 159 153 158 -4 0 152 -3 153 158 160 159 -6 153 154 -5 0 149 160 151 -16 0 152 -3 153 158 160 159 -6 153 154 -5 0 149 160 151 -16 0 152 -3 153 158 160 159 -6 153 154 -5 0 149 160 151 -16 0 152 -3 153 158 160 159 -6 153 154 -5 0 149 160 151 -16 0 152 -3 153 158 160 159 -6 153 154 -5 0 149 160 151 -16 0 152 -3 153 158 160 159 -6 153 154 -5 0 149 160 151 -16 0 152 -3 153 158 160 159 -6 153 154 -5 0 149 160 151 -16 0 152 -3 153 158 160 159 -6 153 154 -5 0 149 160 151 -16 0 152 -3 153 158 160 159 -6 153 154 -5 0 149 160 151 -16 0 152 -3 153 -4 160 159 -12 153 154 -4 0 149 159 153 158 151 -6 0 149 160 151 0 149 -4 160 159 -12 153 154 -4 0 149 159 153 158 151 -6 0 149 160 151 0 149 -4 160 159 -12 153 154 -4 0 149 159 153 158 151 -6 0 149 160 151 0 149 -4 160 159 -12 153 154 -4 0 149 159 153 158 151 -6 0 149 160 151 0 149 -4 160 159 -12 153 154 -4 0 149 159 153 158 151 -6 0 149 160 151 0 149 -4 160 159 -12 153 154 -4 0 149 159 153 158 151 -6 0 149 160 151 0 149 -4 160 159 -12 153 154 -4 0 149 159 153 158 151 -6 0 149 160 151 0 149 -4 160 159 -12 153 154 -4 0 149 159 153 158 151 -6 0 149 160 151 0 149 -4 160 159 -12 153 154 -4 0 149 159 153 158 151 -6 0 149 160 151 0 149 -4 160 159 -20 153 154 -4 0 152 -3 153 158 -2 160 151 -2 0 149 159 153 158 151 152 -17 153 154 -4 0 152 -3 153 158 -2 160 151 -2 0 149 159 153 158 151 152 -17 153 154 -4 0 152 -3 153 158 -2 160 151 -2 0 149 159 153 158 151 152 -17 153 154 -4 0 152 -3 153 158 -2 160 151 -2 0 149 159 153 158 151 152 -17 153 154 -4 0 152 -3 153 158 -2 160 151 -2 0 149 159 153 158 151 152 -17 153 154 -4 0 152 -3 153 158 -2 160 151 -2 0 149 159 153 158 151 152 -17 153 154 -4 0 152 -3 153 158 -2 160 151 -2 0 149 159 153 158 151 152 -17 153 154 -4 0 152 -3 153 158 -2 160 151 -2 0 149 159 153 158 151 152 -17 153 154 -4 0 152 -3 153 158 -2 160 151 -2 0 149 159 153 158 151 152 -25 153 158 -4 160 159 -6 153 154 -2 0 152 -3 153 158 159 -17 153 158 -4 160 159 -6 153 154 -2 0 152 -3 153 158 159 -17 153 158 -4 160 159 -6 153 154 -2 0 152 -3 153 158 159 -17 153 158 -4 160 159 -6 153 154 -2 0 152 -3 153 158 159 -17 153 158 -4 160 159 -6 153 154 -2 0 152 -3 153 158 159 -17 153 158 -4 160 159 -6 153 154 -2 0 152 -3 153 158 159 -17 153 158 -4 160 159 -6 153 154 -2 0 152 -3 153 158 159 -17 153 158 -4 160 159 -6 153 154 -2 0 152 -3 153 158 159 -17 153 158 -4 160 159 -6 153 154 -2 0 152 -3 153 158 159 -37 153 158 -2 160 159 -34 153 158 -2 160 159 -34 153 158 -2 160 159 -34 153 158 -2 160 159 -34 153 158 -2 160 159 -34 153 158 -2 160 159 -34 153 158 -2 160 159 -34 153 158 -2 160 159 -34 153 158 -2 160 159 -3513 153)
    )
    (tilemap
      (solid #f)
      (speed-x 0.25)
      (speed-y 0.25)
      (z-pos -200)
      (name "Background_para2")
      (width 175)
      (height 25)
      (tiles -1409 0 161 163 -34 0 161 163 -34 0 161 163 -34 0 161 163 -34 0 161 163 -20 0 163 -8 0 164 166 -6 0 161 -2 162 163 -13 0 161 162 163 -8 0 164 166 -6 0 161 -2 162 163 -13 0 161 162 163 -8 0 164 166 -6 0 161 -2 162 163 -13 0 161 162 163 -8 0 164 166 -6 0 161 -2 162 163 -13 0 161 162 163 -8 0 164 166 -6 0 161 -2 162 163 -10 0 170 -2 162 163 -4 0 161 171 166 -6 0 164 -2 165 170 163 -12 0 164 165 170 -2 162 163 -4 0 161 171 166 -6 0 164 -2 165 170 163 -12 0 164 165 170 -2 162 163 -4 0 161 171 166 -6 0 164 -2 165 170 163 -12 0 164 165 170 -2 162 163 -4 0 161 171 166 -6 0 164 -2 165 170 163 -12 0 164 165 170 -2 162 163 -4 0 161 171 166 -6 0 164 -2 165 170 163 -9 0 -3 165 166 -4 0 164 165 170 163 -3 0 161 162 171 -3 165 166 -10 0 161 162 171 -4 165 166 -4 0 164 165 170 163 -3 0 161 162 171 -3 165 166 -10 0 161 162 171 -4 165 166 -4 0 164 165 170 163 -3 0 161 162 171 -3 165 166 -10 0 161 162 171 -4 165 166 -4 0 164 165 170 163 -3 0 161 162 171 -3 165 166 -10 0 161 162 171 -4 165 166 -4 0 164 165 170 163 -3 0 161 162 171 -3 165 166 -9 0 -3 165 166 -3 0 161 171 -2 165 170 -3 162 171 -5 165 166 -4 0 161 -2 162 163 -2 0 164 -6 165 166 -3 0 161 171 -2 165 170 -3 162 171 -5 165 166 -4 0 161 -2 162 163 -2 0 164 -6 165 166 -3 0 161 171 -2 165 170 -3 162 171 -5 165 166 -4 0 161 -2 162 163 -2 0 164 -6 165 166 -3 0 161 171 -2 165 170 -3 162 171 -5 165 166 -4 0 161 -2 162 163 -2 0 164 -6 165 166 -3 0 161 171 -2 165 170 -3 162 171 -5 165 166 -4 0 161 -2 162 163 0 -3 165 170 -3 162 171 -13 165 170 -4 162 171 -2 165 170 -2 162 171 -6 165 170 -3 162 171 -13 165 170 -4 162 171 -2 165 170 -2 162 171 -6 165 170 -3 162 171 -13 165 170 -4 162 171 -2 165 170 -2 162 171 -6 165 170 -3 162 171 -13 165 170 -4 162 171 -2 165 170 -2 162 171 -6 165 170 -3 162 171 -13 165 170 -4 162 171 -2 165 170 162 -1925 165)
    )
  )
)
