(supertux-level
  (version 3)
  (name (_ "The Shattered Bridge"))
  (author "SuperTux Team")
  (license "GPL 2+ / CC-by-sa 3.0")
  (target-time 70)
  (allow-item-pocket "inherit")
  (icon "")
  (icon-locked "")
  (statistics
    (enable-coins #t)
    (enable-secrets #t)
  )
  (sector
    (name "main")
    (ambient-light
      (color 1 1 1)
    )
    (camera
      (name "Camera")
      (mode "normal")
    )
    (firefly
      (z-pos 0)
      (x 6860)
      (y 382)
    )
    (goldbomb
      (z-pos 50)
      (x 8463)
      (y 413)
      (glinting #t)
    )
    (gradient
      (top_color 0.003921569 0.003921569 0.003921569)
      (bottom_color 0.1254902 0.1568628 0.4039216)
    )
    (haywire
      (z-pos 50)
      (x 3328)
      (y 401)
      (glinting #f)
    )
    (haywire
      (z-pos 50)
      (x 8151)
      (y 403)
      (glinting #f)
    )
    (haywire
      (z-pos 50)
      (x 13664)
      (y 399)
      (glinting #f)
    )
    (haywire
      (z-pos 50)
      (x 11559)
      (y 404)
      (glinting #f)
    )
    (jumpy
      (z-pos 50)
      (x 4000)
      (y 339)
      (glinting #f)
    )
    (jumpy
      (z-pos 50)
      (x 6208)
      (y 383)
      (glinting #f)
    )
    (jumpy
      (z-pos 50)
      (x 10656)
      (y 390)
      (glinting #f)
    )
    (mrbomb
      (z-pos 50)
      (x 2756)
      (y 403)
      (glinting #f)
    )
    (mrbomb
      (z-pos 50)
      (x 4528)
      (y 403)
      (glinting #f)
    )
    (mrbomb
      (z-pos 50)
      (x 4386)
      (y 401)
      (glinting #f)
    )
    (mrbomb
      (z-pos 50)
      (x 11842)
      (y 404)
      (glinting #f)
    )
    (mrbomb
      (z-pos 50)
      (x 12594)
      (y 402)
      (glinting #f)
    )
    (mrbomb
      (z-pos 50)
      (x 13362)
      (y 401)
      (glinting #f)
    )
    (mrbomb
      (z-pos 50)
      (x 14260)
      (y 400)
      (glinting #f)
    )
    (mriceblock
      (z-pos 50)
      (x 757)
      (y 413)
      (glinting #f)
    )
    (mriceblock
      (z-pos 50)
      (x 689)
      (y 413)
      (glinting #f)
    )
    (mriceblock
      (z-pos 50)
      (x 605)
      (y 413)
      (glinting #f)
    )
    (mriceblock
      (z-pos 50)
      (x 1949)
      (y 413)
      (glinting #f)
    )
    (mriceblock
      (z-pos 50)
      (x 1869)
      (y 414)
      (glinting #f)
    )
    (mriceblock
      (z-pos 50)
      (x 5307)
      (y 412)
      (glinting #f)
    )
    (mriceblock
      (z-pos 50)
      (x 5237)
      (y 412)
      (glinting #f)
    )
    (mriceblock
      (z-pos 50)
      (x 5378)
      (y 412)
      (glinting #f)
    )
    (mriceblock
      (z-pos 50)
      (x 5447)
      (y 413)
      (glinting #f)
    )
    (mriceblock
      (z-pos 50)
      (x 6711)
      (y 412)
      (glinting #f)
    )
    (mriceblock
      (z-pos 50)
      (x 8798)
      (y 571)
      (glinting #f)
    )
    (mriceblock
      (z-pos 50)
      (x 8862)
      (y 412)
      (glinting #f)
    )
    (mriceblock
      (z-pos 50)
      (x 8746)
      (y 571)
      (glinting #f)
    )
    (mriceblock
      (z-pos 50)
      (x 8557)
      (y 411)
      (glinting #f)
    )
    (mriceblock
      (z-pos 50)
      (x 8645)
      (y 402)
      (glinting #f)
    )
    (mriceblock
      (z-pos 50)
      (x 8247)
      (y 412)
      (glinting #f)
    )
    (mriceblock
      (z-pos 50)
      (x 8034)
      (y 411)
      (glinting #f)
    )
    (mriceblock
      (z-pos 50)
      (x 12810)
      (y 411)
      (glinting #f)
    )
    (mriceblock
      (z-pos 50)
      (x 3428)
      (y 412)
      (glinting #f)
    )
    (mriceblock
      (z-pos 50)
      (x 12884)
      (y 413)
      (glinting #f)
    )
    (music
      (file "music/wisphunt.music")
    )
    (secretarea
      (width 556)
      (height 50)
      (x 4838.515)
      (y 179.5615)
    )
    (secretarea
      (width 710.8228)
      (height 153.6224)
      (x 8068.353)
      (y 467.1681)
    )
    (smartball
      (z-pos 50)
      (x 5342)
      (y 187)
      (glinting #f)
    )
    (spawnpoint
      (name "main")
      (x 128)
      (y 384)
    )
    (spiky
      (z-pos 50)
      (x 10496)
      (y 405)
      (glinting #f)
    )
    (spiky
      (z-pos 50)
      (x 10424)
      (y 403)
      (glinting #f)
    )
    (tilemap
      (solid #f)
      (z-pos -100)
      (name "Background")
      (width 525)
      (height 25)
      (tiles -3164 0 85 86 87 88 -462 0 85 86 87 88 -55 0 89 90 91 92 -37 0 85 86 87 88 -60 0 85 86 87 88 -83 0 85 86 87 88 -8 0 2085 2086 -71 0 85 86 87 88 -107 0 85 86 87 88 -74 0 89 90 91 92 -96 0 89 90 91 92 -60 0 89 90 91 92 -83 0 89 90 91 92 -8 0 2087 2088 -71 0 89 90 91 92 -107 0 89 90 91 92 -260 0 2087 2088 -75 0 2087 2088 -446 0 2087 2088 -75 0 2087 2088 -274 0 130 -163 0 2087 2088 -6 0 2087 2088 -75 0 2087 2088 -109 0 2087 2088 -163 0 129 -163 0 2087 2088 -6 0 2087 2088 -75 0 2087 2088 -109 0 2087 2088 -163 0 129 -163 0 2087 2088 -6 0 2087 2088 -75 0 2087 2088 -109 0 2087 2088 -163 0 129 -163 0 2087 2088 -6 0 2087 2088 -75 0 2087 2088 -60 0 -2 1540 -47 0 2087 2088 -163 0 129 -163 0 2087 2088 -6 0 2087 2088 -101 0 1543 1544 -34 0 2087 2088 -47 0 2087 2088 -163 0 129 -163 0 2087 2088 -6 0 2087 2088 -101 0 1547 1548 -34 0 2087 2088 -47 0 2087 2088 -163 0 129 -274 0 1543 1544 -34 0 2087 2088 -47 0 2087 2088 -163 0 129 -274 0 1547 1548 -248 0 129 -3180 0)
    )
    (tilemap
      (solid #t)
      (z-pos 0)
      (name "Interactive")
      (width 525)
      (height 25)
      (tiles -495 0 133 -22 0 -2 132 -500 0 133 -22 0 -2 132 -500 0 133 -22 0 -2 132 -500 0 133 -22 0 -2 132 -500 0 133 -22 0 -2 132 -500 0 133 -22 0 -2 132 -156 0 -18 44 -326 0 133 -22 0 -2 132 -156 0 1551 -16 1540 1541 -149 0 83 -176 0 133 -22 0 -2 132 -146 0 2404 2405 -195 0 2085 2086 -7 0 2085 2086 -146 0 133 -22 0 -2 132 -343 0 2087 2088 -7 0 2087 2088 -146 0 133 -22 0 -2 132 -55 0 -3 83 -42 0 83 102 83 -35 0 2404 2405 -22 0 -2 83 -47 0 83 -41 0 83 102 83 -5 0 -3 83 -5 0 -3 83 -50 0 -3 77 -9 0 2404 2405 -7 0 2087 2088 -7 0 2087 2088 -8 0 2085 2086 -5 0 -2 83 -129 0 133 -22 0 -2 132 -37 0 -2 44 -304 0 2087 2088 -7 0 2087 2088 -8 0 2087 2088 -136 0 133 -22 0 -2 132 -343 0 2087 2088 -7 0 2087 2088 -8 0 2087 2088 -14 0 2085 2086 -120 0 133 -22 0 -2 132 -15 0 7 -5 8 9 -15 0 7 9 -5 0 -2 44 -6 0 7 8 9 -30 0 1545 -44 0 1545 -212 0 2087 2088 -7 0 2087 2088 -8 0 2085 2086 -14 0 2087 2088 -120 0 133 -14 0 126 -7 0 -2 132 -5 0 -25 1540 1541 -6 0 2085 2086 -13 0 1551 -16 1540 1541 -6 0 1545 0 1545 -3 0 1545 -2 0 1551 -7 1540 1541 -3 0 1551 -15 1540 1541 -6 0 1551 -29 1540 1541 -7 0 1551 -20 1540 1541 -8 0 1551 -11 1540 1541 1545 -2 0 1545 0 1545 0 1551 -6 1540 1541 -3 0 1551 -11 1540 1541 -12 0 1551 -40 1540 2404 2405 -5 1540 1541 -24 0 1551 -20 1540 1541 -4 0 2087 2088 -7 0 2087 2088 -8 0 2897 2898 2145 -11 2144 2143 2144 2879 2088 -10 0 1551 -17 1540 1541 -8 0 1551 -5 1540 1541 -3 0 1551 -4 1540 1541 -4 0 1551 1541 -5 0 1551 -6 1540 1541 -4 0 1551 -7 1540 1541 -9 0 1551 -17 1540 1541 -7 0 133 -22 0 -2 132 -29 0 1543 1544 -6 0 2087 2088 -5 0 7 9 -42 0 1543 1544 -14 0 1543 1544 -72 0 1543 1544 -8 0 1543 1544 -33 0 2087 2088 -6 0 1543 1544 -56 0 1543 1544 -27 0 1543 1544 -23 0 2087 2088 -7 0 2087 2088 -8 0 2901 2902 2148 -11 2147 2146 2147 2880 2088 -10 0 1543 1544 -99 0 1543 1544 1543 1544 -5 0 133 -22 0 -2 132 -29 0 1547 1548 -6 0 2087 2088 -5 0 2085 2086 -19 0 44 -22 0 1547 1548 -14 0 1547 1548 -72 0 1547 1548 -3 0 -2 44 -3 0 1547 1548 -33 0 2087 2088 -6 0 1547 1548 -36 0 128 -19 0 1547 1548 -27 0 1547 1548 -23 0 2087 2088 -7 0 2087 2088 -24 0 2087 2088 -10 0 1547 1548 -99 0 1547 1548 1547 1548 -5 0 133 -22 0 -2 132 -29 0 1543 1544 -6 0 2087 2088 -5 0 2087 2088 -3 0 1543 1544 -9 0 -2 44 -3 0 44 -7 0 1543 1544 -6 0 44 -6 0 1543 1544 -14 0 1543 1544 -32 0 2087 2088 -6 0 2087 2088 -3 0 1543 1544 -25 0 1543 1544 -3 0 2085 2086 -3 0 1543 1544 -33 0 2087 2088 -6 0 1543 1544 -6 0 1545 -49 0 1543 1544 -11 0 1543 1544 -6 0 2085 2086 -6 0 1543 1544 -23 0 2087 2088 -7 0 2087 2088 -24 0 2089 2090 -10 0 1543 1544 -11 0 -2 44 -3 0 44 -6 0 1543 1544 -74 0 1543 1544 1543 1544 1543 1544 -3 0 133 -22 0 -2 132 -29 0 1547 1548 -6 0 2087 2088 -5 0 2087 2088 -3 0 1547 1548 -9 0 -2 44 -3 0 44 -7 0 1547 1548 -6 0 44 -6 0 1547 1548 -14 0 1547 1548 -12 0 1543 1544 -18 0 2087 2088 -6 0 2087 2088 -2 0 1545 1547 1548 -6 0 -2 44 -17 0 1547 1548 -3 0 2087 2088 -3 0 1547 1548 -33 0 2087 2088 -6 0 1547 1548 -16 0 2019 2140 -6 0 -22 44 -6 0 -2 61 -2 0 1547 1548 -11 0 1547 1548 -6 0 2087 2088 -6 0 1547 1548 -14 0 2087 2088 -7 0 2087 2088 -7 0 2087 2088 -24 0 2087 2088 -10 0 1547 1548 -11 0 -2 44 -3 0 44 -6 0 1547 1548 -74 0 1547 1548 1547 1548 1547 1548 -3 0 133 -22 0 -2 132 -29 0 1543 1544 -6 0 2087 2088 -5 0 2087 2088 -3 0 1543 1544 -9 0 -2 44 -3 0 1549 -3 0 1549 -2 0 1543 1544 61 -6 0 44 -6 0 1543 1544 -14 0 1543 1544 -12 0 1547 1548 -18 0 2087 2088 -6 0 2087 2088 -2 0 1543 1544 61 -6 0 -2 44 -17 0 1543 1544 -3 0 2087 2088 -3 0 1543 1544 -33 0 2087 2088 -6 0 1543 1544 61 -15 0 1543 1544 -2 0 2143 1543 1544 -22 2144 2143 2891 2892 -4 0 1543 1544 -2 0 1543 1544 -6 0 1543 1544 -3 0 1543 1544 -6 0 2087 2088 -6 0 1543 1544 -14 0 2087 2088 -7 0 2087 2088 -7 0 2087 2088 -24 0 2087 2088 -10 0 1543 1544 -11 0 -2 44 -3 0 44 -4 0 1543 1544 1543 1544 -74 0 1543 1544 1543 1544 1543 1544 1543 1544 1543 1544 1543 1544 1543 1544 1543 1544 1543 1544 1543 1544 1543 1544 1543 1544 1543 1544 1543 1544 1543 1544 1543 1544 1543 1544 1543 1544 1543 1544 1543 -24 0 1547 1548 -6 0 2087 2088 -5 0 2087 2088 -3 0 1547 1548 -3 0 1543 1544 -4 0 1543 1544 -7 0 1549 -2 0 1547 1548 61 1545 -2 0 1545 -2 0 1545 -6 0 1547 1548 -14 0 1547 1548 -11 0 -2 61 1543 1544 -17 0 2087 2088 -6 0 2087 2088 -2 0 1547 1548 61 0 61 -4 0 -2 1545 -17 0 1547 1548 -3 0 2087 2088 -3 0 1547 1548 -33 0 2087 2088 -6 0 1547 1548 61 1543 1544 -10 0 -2 61 0 1547 1548 -2 0 2146 1547 1548 -22 2147 2146 2895 2896 -2 0 61 0 1547 1548 -2 0 1547 1548 -6 0 1547 1548 -3 0 1547 1548 -6 0 2087 2088 -6 0 1547 1548 -14 0 2087 2088 -7 0 2087 2088 -7 0 2087 2088 -24 0 2087 2088 -10 0 1547 1548 -11 0 -2 61 -3 0 61 -4 0 1547 1548 1547 1548 -74 0 1547 1548 1547 1548 1547 1548 1547 1548 1547 1548 1547 1548 1547 1548 1547 1548 1547 1548 1547 1548 1547 1548 1547 1548 1547 1548 1547 1548 1547 1548 1547 1548 1547 1548 1547 1548 1547 1548 1547 -24 0 1543 1544 -6 0 2087 2088 -5 0 2087 2088 -3 0 1543 1544 -3 0 1547 1548 -4 0 1547 1548 -10 0 1543 1544 1543 1544 -12 0 1543 1544 -14 0 1543 1544 -11 0 1543 1544 1547 1548 -17 0 2087 2088 -6 0 2087 2088 -2 0 1543 1544 61 -25 0 1543 1544 -3 0 2087 2088 -3 0 1543 1544 -33 0 2087 2088 -6 0 1543 1544 61 1547 1548 -10 0 1543 1544 0 1543 1544 -3 0 1543 1544 -23 0 2089 2090 -4 0 1543 1544 -2 0 1543 1544 -6 0 1543 1544 -3 0 1543 1544 -6 0 2087 2088 -6 0 1543 1544 -14 0 2085 2086 -7 0 2087 2088 -7 0 2087 2088 -24 0 2087 2088 -10 0 1543 1544 -21 0 1543 1544 1543 1544 -74 0 1543 1544 1543 1544 1543 1544 1543 1544 1543 1544 1543 1544 1543 1544 1543 1544 1543 1544 1543 1544 1543 1544 1543 1544 1543 1544 1543 1544 1543 1544 1543 1544 1543 1544 1543 1544 1543 1544 1543 -24 0 1547 1548 -6 0 2087 2088 -5 0 2087 2088 -3 0 1547 1548 -3 0 1543 1544 -4 0 1543 1544 -10 0 1547 1548 1547 1548 -12 0 1547 1548 -14 0 1547 1548 -11 0 1547 1548 1543 1544 -17 0 2087 2088 -6 0 2087 2088 -2 0 1547 1548 61 -25 0 1547 1548 -3 0 2087 2088 -3 0 1547 1548 -33 0 2087 2088 -6 0 1547 1548 1543 1544 1549 -10 0 1547 1548 0 1547 1548 -3 0 1547 1548 -23 0 2087 2088 -4 0 1547 1548 -2 0 1547 1548 -6 0 1547 1548 -3 0 1547 1548 -6 0 2087 2088 -6 0 1547 1548 -14 0 2087 2088 -7 0 2087 2088 -7 0 2087 2088 -24 0 2087 2088 -10 0 1547 1548 -21 0 1547 1548 1547 1548 -74 0 1547 1548 1547 1548 1547 1548 1547 1548 1547 1548 1547 1548 1547 1548 1547 1548 1547 1548 1547 1548 1547 1548 1547 1548 1547 1548 1547 1548 1547 1548 1547 1548 1547 1548 1547 1548 1547 1548 1547 -24 0 1543 1544 -6 0 2087 2088 -5 0 2087 2088 -3 0 1543 1544 -3 0 1547 1548 -4 0 1547 1548 -10 0 1543 1544 1543 1544 -5 0 1545 -6 0 1543 1544 -13 0 61 1543 1544 -11 0 1543 1544 1547 1548 -17 0 2087 2088 -6 0 2087 2088 -2 0 61 1543 1544 -3 0 1545 -21 0 1543 1544 -3 0 2087 2088 -3 0 1543 1544 -33 0 2087 2088 -6 0 1543 1544 1547 1548 1549 -10 0 1543 1544 0 1543 1544 -3 0 1543 1544 -23 0 2087 2088 -4 0 1543 1544 -2 0 1543 1544 -6 0 1543 1544 -3 0 1543 1544 -6 0 2087 2088 -6 0 1543 1544 -6 0 2143 -5 2144 2143 2144 2879 2088 -7 0 2087 2088 -7 0 2087 2088 -24 0 2087 2088 -10 0 1543 1544 -21 0 1543 1544 1543 1544 -74 0 1543 1544 1543 1544 1543 1544 1543 1544 1543 1544 1543 1544 1543 1544 1543 1544 1543 1544 1543 1544 1543 1544 1543 1544 1543 1544 1543 1544 1543 1544 1543 1544 1543 1544 1543 1544 1543 1544 1543 -24 0 1547 1548 -6 0 2087 2088 -5 0 2087 2088 -3 0 1547 1548 -3 0 1543 1544 -4 0 1543 1544 -10 0 1547 1548 1547 1548 -3 0 1545 -8 0 1547 1548 -12 0 -2 61 1547 1548 -11 0 1547 1548 1543 1544 -17 0 2087 2088 -6 0 2087 2088 -2 0 61 1547 1548 -2 61 0 1545 -20 0 1549 1547 1548 -3 0 2087 2088 -3 0 1547 1548 -33 0 2087 2088 -6 0 1547 1548 -3 1549 -4 0 -2 1549 -4 0 1547 1548 0 1547 1548 -3 0 1547 1548 -23 0 2087 2088 -4 0 1547 1548 -2 0 1547 1548 -6 0 1547 1548 -3 0 1547 1548 -6 0 2087 2088 -6 0 1547 1548 -6 0 2146 -5 2147 2146 2147 2880 2088 -7 0 2087 2088 -7 0 2087 2088 -11 0 -2 61 -4 0 1543 1544 -5 0 2087 2088 -10 0 1547 1548 -12 0 -2 61 -7 0 1547 1548 1547 1548 -74 0 1547 1548 1547 1548 1547 1548 1547 1548 1547 1548 1547 1548 1547 1548 1547 1548 1547 1548 1547 1548 1547 1548 1547 1548 1547 1548 1547 1548 1547 1548 1547 1548 1547 1548 1547 1548 1547 1548 1547)
    )
    (tilemap
      (solid #f)
      (z-pos 100)
      (name "Foreground")
      (width 525)
      (height 25)
      (tiles -3848 0 85 86 87 88 -521 0 89 90 91 92 -1369 0 130 -524 0 129 -524 0 129 -524 0 129 -16 0 127 -507 0 129 -524 0 129 -524 0 129 -524 0 129 -28 0 2019 2140 2141 2142 2019 2140 2141 2142 2019 2140 2141 2142 2019 2140 2141 2142 2019 2140 2141 2142 2019 2140 2141 2142 2019 2140 2141 2142 2019 2140 2141 2142 2019 2140 2141 2142 2019 2140 2141 2142 2019 2140 2141 2142 2019 2140 2141 2142 2019 2140 2141 2142 2019 2140 2141 2142 2019 2140 2141 2142 2019 2140 2141 2142 2019 2140 2141 2142 2019 2140 2141 2142 2019 2140 2141 2142 2019 2140 2141 2142 2019 2140 2141 2142 2019 2140 2141 2142 2019 2140 2141 2142 2019 2140 2141 2142 2019 2140 2141 2142 2019 2140 2141 2142 2019 2140 2141 2142 2019 2140 2141 2142 2019 2140 2141 2142 2019 2140 2141 2142 2019 2140 2141 2142 2019 2140 2141 2142 2019 2140 2141 2142 2019 2140 2141 2142 2019 2140 2141 2142 2019 2140 2141 2142 2019 2140 2141 2142 2019 2140 2141 2142 2019 2140 2141 2142 2019 2140 2141 2142 2019 2140 2141 2142 2019 2140 2141 2142 2019 2140 2141 2142 2019 2140 2141 2142 2019 2140 2141 2142 2019 2140 2141 2142 2019 2140 2141 2142 2019 2140 2141 2142 2019 2140 2141 2142 2019 2140 2141 2142 2019 2140 2141 2142 2019 2140 2141 2142 2019 2140 2141 2142 2019 2140 2141 2142 2019 2140 2141 2142 2019 2140 2141 2142 2019 2140 2141 2142 2019 2140 2141 2142 2019 2140 2141 2142 2019 2140 2141 2142 2019 2140 2141 2142 2019 2140 2141 2142 2019 2140 2141 2142 2019 2140 2141 2142 2019 2140 2141 2142 2019 2140 2141 2142 2019 2140 2141 2142 2019 2140 2141 2142 2019 2140 2141 2142 2019 2140 2141 2142 2019 2140 2141 2142 2019 2140 2141 2142 2019 2140 2141 2142 2019 2140 2141 2142 2019 2140 2141 2142 2019 2140 2141 2142 2019 2140 2141 2142 2019 2140 2141 2142 2019 2140 2141 2142 2019 2140 2141 2142 2019 2140 2141 2142 2019 2140 2141 2142 2019 2140 2141 2142 2019 2140 2141 2142 2019 2140 2141 2142 2019 2140 2141 2142 2019 2140 2141 2142 2019 2140 2141 2142 2019 2140 2141 2142 2019 2140 2141 2142 2019 2140 2141 2142 2019 2140 2141 2142 2019 2140 2141 2142 2019 2140 2141 2142 2019 2140 2141 2142 2019 2140 2141 2142 2019 2140 2141 2142 2019 2140 2141 2142 2019 2140 2141 2142 2019 2140 2141 2142 2019 2140 2141 2142 2019 2140 2141 2142 2019 2140 2141 2142 2019 2140 2141 2142 2019 2140 2141 2142 2019 2140 2141 2142 2019 2140 2141 2142 2019 2140 2141 2142 2019 2140 2141 2142 2019 2140 2141 2142 2019 2140 2141 2142 2019 2140 2141 2142 2019 2140 2141 2142 2019 2140 2141 2142 2019 2140 2141 2142 2019 2140 2141 2142 2019 2140 2141 2142 2019 2140 2141 2142 2019 2140 2141 2142 2019 2140 2141 2142 2019 2140 2141 2142 2019 2140 -10 0 129 -28 0 -486 2020 -39 0 -486 2020 -39 0 -486 2020 -39 0 -486 2020 -39 0 -486 2020 -39 0 -486 2020 -39 0)
    )
  )
)
