(supertux-level
  (version 3)
  (name (_ "Arctic Ruins"))
  (author "SuperTux Team")
  (license "GPL 2+ / CC-by-sa 3.0")
  (target-time 70)
  (allow-item-pocket "inherit")
  (icon "")
  (icon-locked "")
  (statistics
    (enable-coins #t)
    (enable-secrets #t)
  )
  (sector
    (name "main")
    (ambient-light
      (color 1 1 1)
    )
    (background
      (color 1 1 1)
      (alignment "top")
      (speed 0.2)
      (image "images/background/bridgecloud-dark.png")
      (z-pos -175)
    )
    (background
      (color 1 1 1)
      (alignment "bottom")
      (speed 0.7)
      (image "images/background/bridgeocean-fade.png")
      (z-pos -195)
    )
    (bouncingsnowball
      (z-pos 50)
      (x 7903)
      (y 276)
      (glinting #f)
    )
    (bouncingsnowball
      (z-pos 50)
      (x 9249)
      (y 216)
      (glinting #f)
    )
    (bouncingsnowball
      (z-pos 50)
      (x 13393)
      (y 409)
      (glinting #f)
    )
    (bouncingsnowball
      (z-pos 50)
      (x 9763)
      (y 211)
      (glinting #f)
    )
    (bouncingsnowball
      (z-pos 50)
      (x 11173)
      (y 240)
      (glinting #f)
    )
    (bouncingsnowball
      (z-pos 50)
      (x 13323)
      (y 485)
      (glinting #f)
    )
    (camera
      (name "Camera")
      (mode "normal")
    )
    (captainsnowball
      (z-pos 50)
      (x 8861)
      (y 258)
      (glinting #f)
    )
    (captainsnowball
      (z-pos 50)
      (x 13666)
      (y 389)
      (glinting #f)
    )
    (firefly
      (z-pos 0)
      (x 7002.787)
      (y 480.7158)
    )
    (goldbomb
      (z-pos 50)
      (x 11641)
      (y 337)
      (glinting #t)
    )
    (gradient
      (top_color 0 0 0)
      (bottom_color 0.003921569 0.003921569 0.003921569)
    )
    (haywire
      (z-pos 50)
      (x 4295)
      (y 593)
      (glinting #f)
    )
    (haywire
      (z-pos 50)
      (x 8355)
      (y 369)
      (glinting #f)
    )
    (haywire
      (z-pos 50)
      (x 11097)
      (y 592)
      (glinting #f)
    )
    (jumpy
      (z-pos 50)
      (x 4960)
      (y 578)
      (glinting #f)
    )
    (jumpy
      (z-pos 50)
      (x 6576)
      (y 574)
      (glinting #f)
    )
    (jumpy
      (z-pos 50)
      (x 8608)
      (y 417)
      (glinting #f)
    )
    (jumpy
      (z-pos 50)
      (x 13472)
      (y 378)
      (glinting #f)
    )
    (jumpy
      (z-pos 50)
      (x 6481)
      (y 579)
      (glinting #f)
    )
    (mrbomb
      (z-pos 50)
      (x 4371)
      (y 594)
      (glinting #f)
    )
    (mrbomb
      (z-pos 50)
      (x 4622)
      (y 593)
      (glinting #f)
    )
    (mrbomb
      (z-pos 50)
      (x 5297.203)
      (y 603.926)
      (glinting #f)
    )
    (mrbomb
      (z-pos 50)
      (x 5882)
      (y 369)
      (glinting #f)
    )
    (mrbomb
      (z-pos 50)
      (x 5997)
      (y 594)
      (glinting #f)
    )
    (mrbomb
      (z-pos 50)
      (x 8052)
      (y 242)
      (glinting #f)
    )
    (mrbomb
      (z-pos 50)
      (x 10922)
      (y 593)
      (glinting #f)
    )
    (mrbomb
      (z-pos 50)
      (x 11297)
      (y 592)
      (glinting #f)
    )
    (mrbomb
      (z-pos 50)
      (x 11529)
      (y 592)
      (glinting #f)
    )
    (mrbomb
      (z-pos 50)
      (x 10978)
      (y 370)
      (glinting #f)
    )
    (mriceblock
      (z-pos 50)
      (x 3712)
      (y 413)
      (glinting #f)
    )
    (music
      (file "music/wisphunt.music")
    )
    (secretarea
      (width 245.5464)
      (height 115.4386)
      (x 4561.568)
      (y 306.1512)
    )
    (secretarea
      (width 170.5928)
      (height 143.7229)
      (x 9495.76)
      (y 342.9207)
    )
    (secretarea
      (width 450.6074)
      (height 142.3087)
      (x 12140.2)
      (y 185.1145)
    )
    (smartball
      (z-pos 50)
      (x 1590)
      (y 412)
      (glinting #f)
    )
    (smartball
      (z-pos 50)
      (x 1751)
      (y 412)
      (glinting #f)
    )
    (snowball
      (z-pos 50)
      (x 985)
      (y 412)
      (glinting #f)
    )
    (snowball
      (z-pos 50)
      (x 939)
      (y 411)
      (glinting #f)
    )
    (snowball
      (z-pos 50)
      (x 889)
      (y 411)
      (glinting #f)
    )
    (snowball
      (z-pos 50)
      (x 3797)
      (y 411)
      (glinting #f)
    )
    (snowball
      (z-pos 50)
      (x 12183)
      (y 603)
      (glinting #f)
    )
    (snowball
      (z-pos 50)
      (x 12350)
      (y 603)
      (glinting #f)
    )
    (snowball
      (z-pos 50)
      (x 12520)
      (y 604)
      (glinting #f)
    )
    (snowball
      (z-pos 50)
      (x 10111.13)
      (y 696.9293)
      (glinting #f)
    )
    (snowball
      (z-pos 50)
      (x 9856.13)
      (y 697.9293)
      (glinting #f)
    )
    (spawnpoint
      (name "main")
      (x 96)
      (y 384)
    )
    (spiky
      (z-pos 50)
      (x 7186)
      (y 598)
      (glinting #f)
    )
    (spiky
      (z-pos 50)
      (x 7600)
      (y 596)
      (glinting #f)
    )
    (spiky
      (z-pos 50)
      (x 9910)
      (y 214)
      (glinting #f)
    )
    (spiky
      (z-pos 50)
      (x 9557)
      (y 246)
      (glinting #f)
    )
    (spiky
      (z-pos 50)
      (x 11351)
      (y 245)
      (glinting #f)
    )
    (spiky
      (z-pos 50)
      (x 12093)
      (y 598)
      (glinting #f)
    )
    (spiky
      (z-pos 50)
      (x 12263)
      (y 598)
      (glinting #f)
    )
    (spiky
      (z-pos 50)
      (x 12429)
      (y 599)
      (glinting #f)
    )
    (spiky
      (z-pos 50)
      (x 12600)
      (y 599)
      (glinting #f)
    )
    (spiky
      (z-pos 50)
      (x 7340)
      (y 564)
      (glinting #f)
    )
    (sspiky
      (z-pos 50)
      (x 13738)
      (y 416)
      (glinting #f)
    )
    (tilemap
      (solid #f)
      (z-pos -100)
      (name "Background")
      (width 500)
      (height 25)
      (tiles -1989 0 2813 -498 0 2813 2815 -497 0 2813 2815 -446 0 80 -6 0 80 -6 0 80 -6 0 80 -6 0 80 -22 0 2813 2815 -447 0 79 -6 0 79 -6 0 79 -6 0 79 -6 0 79 -14 0 130 -6 0 2813 2815 -391 0 68 69 -3 0 68 69 -3 0 68 69 -3 0 68 69 -40 0 79 -6 0 79 -6 0 79 -6 0 79 -6 0 79 -14 0 129 -5 0 2813 2815 -320 0 1543 1544 1543 1544 -68 0 68 69 -3 0 68 69 -3 0 68 69 -3 0 68 69 -40 0 79 -6 0 79 -6 0 79 -6 0 79 -6 0 79 -14 0 129 -4 0 2813 2815 -5 0 -3 131 -294 0 -2 1549 -8 0 -2 1549 -7 0 1547 1548 1547 1548 -68 0 68 64 -3 65 -2 64 -3 65 -2 64 -3 65 64 69 -40 0 79 -6 0 79 -6 0 79 -6 0 79 -6 0 79 -14 0 129 -3 0 2813 2815 -6 0 -3 131 -291 0 -3 1549 1543 1544 -8 0 -5 1549 -4 0 -2 1549 -70 0 68 -15 64 69 -40 0 79 -6 0 79 -6 0 79 -6 0 79 -6 0 79 -14 0 129 -2 0 2813 2815 -7 0 -3 131 -294 0 1547 1548 1543 1544 -2 1549 -4 0 1549 1543 1544 -2 1549 -4 0 -2 1549 -70 0 68 -15 64 69 -40 0 79 -6 0 79 -6 0 79 -6 0 79 -6 0 79 -14 0 129 0 2813 2815 -8 0 -3 131 -294 0 1543 1544 1547 1548 1543 1544 -2 1549 1543 1544 1549 1547 1548 1543 1544 -4 0 -2 1549 -70 0 68 -15 64 69 -40 0 79 -6 0 79 -6 0 79 -6 0 79 -6 0 79 -14 0 129 2813 2815 -9 0 -3 131 -294 0 1547 1548 1543 1544 1547 1548 -2 1549 1547 1548 -3 1549 1547 1548 1543 1544 1543 1544 -7 1549 -65 0 68 -15 64 69 -392 0 1543 1544 1547 1548 -9 0 -2 1549 1547 1548 1547 1548 -3 1549 1543 1544 -2 1549 -65 0 68 -15 64 69 -386 0 1549 -5 0 1547 1548 1543 1544 -9 0 -2 1549 -7 0 1547 1548 -67 0 68 -15 64 69 -386 0 1549 -5 0 1543 1544 1547 1548 -9 0 -2 1549 -76 0 68 -15 64 69 -383 0 -4 1549 -5 0 1547 1548 1543 1544 -87 0 68 -15 64 69 -32 0 122 123 -349 0 1549 1543 1544 -2 1549 1543 1544 -2 1549 1543 1544 1547 1548 -3 0 -2 1549 -82 0 68 -15 64 69 -32 0 124 125 -13 0 122 123 -19 0 122 123 -311 0 -3 1549 1547 1548 -2 1549 1547 1548 -2 1549 1547 1548 -7 1549 -82 0 68 -15 64 69 -29 0 122 123 0 124 125 -13 0 124 125 -15 0 122 123 -2 0 124 125 -311 0 1549 1543 1544 -2 1549 1543 1544 1549 1543 1544 1543 1544 -3 1549 1543 1544 1549 1543 1544 -82 0 68 -15 64 69 -29 0 124 125 0 124 125 0 122 123 -10 0 124 125 122 123 -13 0 124 125 -2 0 124 125 -311 0 1549 1547 1548 -2 1549 1547 1548 1549 1547 1548 1547 1548 -3 1549 1547 1548 1549 1547 1548 -82 0 68 -15 64 69 -29 0 124 125 0 124 125 0 124 125 -10 0 124 125 124 125 -13 0 124 125 -2 0 124 125 -311 0 1549 1543 1544 1549 1543 1544 -2 1549 1543 1544 -3 1549 1543 1544 1549 1543 1544 1543 1544 -82 0 68 -15 64 69 -29 0 124 125 0 124 125 0 124 125 -10 0 124 125 124 125 -13 0 124 125 -2 0 124 125 -311 0 1549 1547 1548 1549 1547 1548 1543 1544 1547 1548 1549 1543 1544 1547 1548 1549 1547 1548 1547 1548 -82 0 68 -15 64 69 -25 0 25 -3 24 124 125 0 124 125 24 124 125 0 24 25 0 24 25 0 24 25 0 124 125 124 125 -2 25 24 -2 25 24 -2 25 0 25 0 25 0 124 125 25 0 124 125 0 24 -33 0)
    )
    (tilemap
      (solid #t)
      (z-pos 0)
      (name "Interactive")
      (width 500)
      (height 25)
      (tiles -316 0 1543 1544 1549 1543 1544 1549 1543 1544 1549 1543 1544 -2 1549 -150 0 133 -10 0 68 -9 64 -316 0 1547 1548 1549 1547 1548 1549 1547 1548 1549 1547 1548 -2 1549 -150 0 133 -10 0 68 -9 64 -316 0 -13 1549 -150 0 133 -10 0 68 -9 64 -316 0 -2 1549 1543 1544 1549 1543 1544 1549 1543 1544 1549 1543 1544 -150 0 133 -10 0 68 -9 64 -316 0 -2 1549 1547 1548 1549 1547 1548 1549 1547 1548 1549 1547 1548 -150 0 133 -10 0 68 -9 64 -316 0 -13 1549 -150 0 133 -10 0 68 -9 64 -316 0 1549 1543 1544 1549 1543 1544 1549 1543 1544 1549 1543 1544 1549 -150 0 133 -10 0 68 -9 64 -316 0 1549 1547 1548 1549 1547 1548 1549 1547 1548 1549 1547 1548 1549 -150 0 133 -10 0 68 -9 64 -305 0 -6 1549 -5 0 -13 1549 -150 0 133 -10 0 68 -9 64 -183 0 2947 -65 0 -4 1549 -33 0 -4 1549 -6 0 -4 1549 -5 0 1549 -2 0 -3 1549 -7 0 1549 0 -5 1549 0 1549 -22 0 1543 1544 -5 1549 -11 0 -3 1549 -10 0 -3 44 -2 0 -3 44 -2 0 -3 44 -86 0 133 -18 0 -2 132 -142 0 1549 -7 0 1549 -98 0 1549 1543 1544 1549 -20 0 -5 1549 -5 0 -4 1549 -2 0 1549 -6 0 1549 -2 0 -4 1549 -2 0 1549 -2 0 -3 1549 -23 0 -3 1549 -12 0 1547 1548 1549 -2 0 -2 1549 -11 0 1549 -12 0 -3 65 -2 0 -3 65 -2 0 -3 65 -86 0 133 -18 0 -2 132 -142 0 1549 0 44 0 44 0 44 0 1549 -92 0 -7 1549 1547 1548 1549 -20 0 -2 1549 1543 1544 1549 -5 0 1549 -5 0 -5 1549 -2 0 1549 0 128 -3 0 1549 -2 0 1549 -2 0 -3 1549 -25 0 1549 -10 0 1543 1544 -2 1549 -4 0 1549 -11 0 1549 -111 0 133 -18 0 -2 132 -142 0 1549 44 0 44 0 44 0 44 1549 -20 0 -2 1549 -70 0 -3 1549 1543 1544 1543 1544 -4 1549 -19 0 -2 1549 1547 1548 1549 -5 0 -4 1549 -6 0 -4 1549 -5 0 1549 -2 0 1549 -2 0 1549 -7 0 -13 1549 -7 0 1549 -10 0 1547 1548 0 -2 44 -3 0 1543 1544 -3 0 -5 1549 0 1543 1544 -111 0 133 -18 0 -2 132 -137 0 112 -4 0 -9 1549 -21 0 -2 1549 -9 0 -2 1549 -58 0 -3 1549 1547 1548 1547 1548 1549 1543 1544 1549 -5 0 -5 1549 -7 0 1543 1544 -3 1549 -10 0 1549 -15 0 -4 1549 -2 0 -6 1549 -8 0 1549 -13 0 1549 -5 0 1543 1544 -3 0 1549 -2 0 -2 44 -3 0 1547 1548 1549 -2 44 1549 -3 0 -2 1549 1547 1548 -111 0 133 -18 0 -2 132 -31 1540 1541 -9 0 1551 -13 1540 1541 -52 0 1551 -10 1540 1541 -53 0 -2 1549 -52 0 83 -4 0 83 -8 0 102 -3 0 -2 1549 1543 1544 -2 1549 1547 1548 1549 -5 0 -2 1549 1543 1544 1549 -7 0 1547 1548 1549 1543 1544 -2 0 83 -17 0 44 -2 0 44 -13 0 1549 -8 0 1549 -13 0 1543 1544 -2 44 -2 1549 1547 1548 1549 -2 0 1549 -2 0 1543 1544 -3 0 -6 1549 0 -2 44 -56 0 -49 1549 -9 0 27 -10 28 29 68 -9 64 -30 0 1543 1544 -9 0 1543 1544 -6 0 44 -5 0 44 -5 0 44 -57 0 1543 1544 -53 0 -2 1549 -69 0 -2 1549 1547 1548 -5 1549 -3 0 -4 1549 1547 1548 1549 -4 0 -6 1549 1547 1548 -4 0 -2 1549 -9 0 -9 1549 -2 0 44 -5 0 44 -2 0 44 0 1549 -8 0 1549 -13 0 1547 1548 1549 1543 1544 -4 1549 -2 0 1549 -2 0 1547 1548 -10 0 -2 44 -54 0 1543 1544 1543 1544 -45 0 1543 1544 -20 0 62 68 -9 64 -30 0 1547 1548 -9 0 1547 1548 -6 0 44 -5 0 44 -3 0 1545 0 44 -5 0 1545 -38 0 1545 -12 0 1547 1548 1549 -8 0 -2 83 102 -42 0 -2 1549 -68 0 -3 1549 1543 1544 1549 44 -5 0 -7 1549 -4 0 -3 1549 1543 1544 1549 -6 0 1549 0 1549 -8 0 -9 1549 -2 0 -7 1549 -2 0 -4 1549 -7 0 44 -12 0 102 -3 1549 1547 1548 1549 -2 44 -4 1549 -4 0 112 -9 0 1543 1544 -54 0 1547 1548 1547 1548 -45 0 1547 1548 -21 0 68 -9 64 -30 0 1543 1544 -9 0 1543 1544 -6 0 44 -5 0 44 -5 0 44 0 1545 -24 0 1545 -7 0 1545 -22 0 1543 1544 1543 1544 -53 0 -2 1549 -10 0 -2 1549 -9 0 -2 1549 -7 0 -2 1549 -9 0 -2 1549 -5 0 -3 1549 -2 0 -3 1549 -5 0 -4 1549 -2 0 -3 1549 1547 1548 1549 44 -5 0 -2 1549 1543 1544 1549 -4 0 1543 1544 -3 1549 1547 1548 1549 -3 0 -4 1549 0 1549 -8 0 -9 1549 -2 44 -3 1549 -17 0 44 -3 0 -2 1549 -8 0 -5 1549 -21 0 1547 1548 -52 0 1543 1544 1543 1544 1543 1544 -45 0 1543 1544 -21 0 68 -9 64 -30 0 1547 1548 -9 0 1547 1548 -6 0 44 -5 0 44 -5 0 44 -39 0 1543 1544 -16 0 1547 1548 1547 1548 1549 -65 0 1549 -9 0 1549 -9 0 1549 -9 0 1549 -6 0 -3 1549 -2 0 1549 1543 1544 -5 0 1549 1543 1544 1549 -2 44 -3 1549 1543 1544 -5 1549 -2 44 -2 1549 1547 1548 1549 -4 0 1547 1548 1549 1543 1544 -3 1549 -3 0 1549 -4 0 -5 1549 -4 0 -13 1549 -18 0 44 -3 0 1549 -89 0 1547 1548 1547 1548 1547 1548 -45 0 1547 1548 -21 0 68 -9 64 -30 0 1543 1544 -9 0 1543 1544 -6 0 44 -5 0 44 -5 0 44 -19 0 1543 1544 -8 0 1545 -9 0 1547 1548 -16 0 1543 1544 1543 1544 1543 1544 -39 0 -4 44 -21 0 1549 -9 0 1549 -9 0 1549 -9 0 1549 -6 0 1549 1543 1544 -3 1549 1547 1548 -5 0 1549 1547 1548 1549 -2 44 1549 1543 1544 1547 1548 -2 1549 1543 1544 1549 -2 44 1549 1543 1544 -9 1549 1547 1548 1543 1544 1549 0 -3 1549 -13 0 -3 1549 -2 0 -7 1549 -19 0 44 -3 0 1549 -87 0 1543 1544 1543 1544 1543 1544 1543 1544 -45 0 1543 1544 -21 0 68 -9 64 -30 0 1547 1548 -9 0 1547 1548 -6 0 1545 -5 0 1545 -5 0 1545 -11 0 1543 1544 -6 0 1547 1548 -18 0 1543 1544 -16 0 1547 1548 1547 1548 1547 1548 -14 1549 -3 0 -5 1549 -2 0 -10 1549 -3 0 -8 1549 -2 0 -18 1549 -9 0 -11 1549 -9 0 -8 1549 1547 1548 -11 1549 1543 1544 -4 1549 1547 1548 -4 1549 1547 1548 -4 1549 1547 1548 -7 1549 1543 1544 -2 1549 1547 1548 -3 1549 -20 0 -7 1549 -15 0 -2 1549 -2 0 1549 -3 0 -48 1549 -5 0 -2 1568 0 -4 1568 -2 0 -3 1568 -8 0 -15 1549 1547 1548 1547 1548 1547 1548 1547 1548 -45 0 1547 1548 -21 0 68 -9 64 -30 0 1543 1544 -9 0 1543 1544 -30 0 1547 1548 -6 0 1543 1544 -18 0 1547 1548 -16 0 1543 1544 1543 1544 1543 1544 1543 1544 1543 1544 1543 1544 1543 1544 1543 1544 1543 1544 1543 1544 -3 0 1543 1544 0 1543 1544 -2 0 1543 1544 1543 1544 1543 1544 1543 1544 1543 1544 -3 0 1543 1544 1543 1544 1543 1544 1543 1544 -2 0 1543 1544 1543 1544 1543 1544 1543 1544 1543 1544 1543 1544 1543 1544 1543 1544 1543 1544 -9 0 1543 1544 1543 1544 -3 1549 1543 1544 1543 1544 -9 0 1543 1544 1543 1544 1543 1544 1543 1544 1543 1544 1543 1544 1543 1544 1543 1544 1543 1544 1543 1544 1549 1547 1548 1543 1544 1543 1544 1543 1544 1543 1544 1543 1544 1543 1544 1543 1544 1543 1544 1543 1544 1543 1544 1543 1544 1543 1544 1549 1547 1548 1543 1544 1543 1544 1543 1544 1549 -26 0 1549 -16 0 1549 -2 0 1549 -13 0 1543 1544 -12 0 1543 1544 -10 0 1543 1544 -41 0 1543 1544 -7 0 1543 1544 1543 1544 1543 1544 1543 1544 -45 0 1543 1544 -21 0 68 -9 64 -30 0 1547 1548 -9 0 1547 1548 -30 0 1543 1544 -6 0 1547 1548 -18 0 1543 1544 -16 0 1547 1548 1547 1548 1547 1548 1547 1548 1547 1548 1547 1548 1547 1548 1547 1548 1547 1548 1547 1548 -3 0 1547 1548 0 1547 1548 -2 0 1547 1548 1547 1548 1547 1548 1547 1548 1547 1548 -3 0 1547 1548 1547 1548 1547 1548 1547 1548 -2 0 1547 1548 1547 1548 1547 1548 1547 1548 1547 1548 1547 1548 1547 1548 1547 1548 1547 1548 -9 0 1547 1548 1547 1548 -3 1549 1547 1548 1547 1548 -9 0 1547 1548 1547 1548 1547 1548 1547 1548 1547 1548 1547 1548 1547 1548 1547 1548 1547 1548 1547 1548 1549 1543 1544 1547 1548 1547 1548 1547 1548 1547 1548 1547 1548 1547 1548 1547 1548 1547 1548 1547 1548 1547 1548 1547 1548 1547 1548 1549 1543 1544 1547 1548 1547 1548 1547 1548 1549 -26 0 1549 -16 0 1549 -2 0 1549 -13 0 1547 1548 -12 0 1547 1548 -10 0 1547 1548 -41 0 1547 1548 -7 0 1547 1548 1547 1548 1547 1548 1547 1548 -45 0 1547 1548 -21 0 68 -9 64 -30 0 1543 1544 -9 0 1543 1544 -30 0 1547 1548 -6 0 1543 1544 -18 0 1547 1548 -16 0 1543 1544 1543 1544 1543 1544 1543 1544 1543 1544 1543 1544 1543 1544 1543 1544 1543 1544 1543 1544 -3 0 1543 1544 0 1543 1544 -2 0 1543 1544 1543 1544 1543 1544 1543 1544 1543 1544 -3 0 1543 1544 1543 1544 1543 1544 1543 1544 -2 0 1543 1544 1543 1544 1543 1544 1543 1544 1543 1544 1543 1544 1543 1544 1543 1544 1543 1544 -9 0 1543 1544 1543 1544 -3 1549 1543 1544 1543 1544 -9 0 1543 1544 1543 1544 1543 1544 1543 1544 1543 1544 1543 1544 1543 1544 1543 1544 1543 1544 1543 1544 1549 1547 1548 1543 1544 1543 1544 1543 1544 1543 1544 1543 1544 1543 1544 1543 1544 1543 1544 1543 1544 1543 1544 1543 1544 1543 1544 1549 1547 1548 1543 1544 1543 1544 1543 1544 1549 -26 0 -18 1549 -2 0 1549 -13 0 1543 1544 -12 0 1543 1544 -10 0 1543 1544 -41 0 1543 1544 -7 0 1543 1544 1543 1544 1543 1544 1543 1544 -45 0 1543 1544 -21 0 68 -9 64 -30 0 1547 1548 -9 0 1547 1548 -30 0 1543 1544 -6 0 1547 1548 -18 0 1543 1544 -16 0 1547 1548 1547 1548 1547 1548 1547 1548 1547 1548 1547 1548 1547 1548 1547 1548 1547 1548 1547 1548 -3 0 1547 1548 0 1547 1548 -2 0 1547 1548 1547 1548 1547 1548 1547 1548 1547 1548 -3 0 1547 1548 1547 1548 1547 1548 1547 1548 -2 0 1547 1548 1547 1548 1547 1548 1547 1548 1547 1548 1547 1548 1547 1548 1547 1548 1547 1548 -9 0 1547 1548 1547 1548 -3 1549 1547 1548 1547 1548 -9 0 1547 1548 1547 1548 1547 1548 1547 1548 1547 1548 1547 1548 1547 1548 1547 1548 1547 1548 1547 1548 1549 1543 1544 1547 1548 1547 1548 1547 1548 1547 1548 1547 1548 1547 1548 1547 1548 1547 1548 1547 1548 1547 1548 1547 1548 1547 1548 1549 1543 1544 1547 1548 1547 1548 1547 1548 1549 -46 0 1549 -13 0 1547 1548 -12 0 1547 1548 -10 0 1547 1548 -41 0 1547 1548 -7 0 1547 1548 1547 1548 1547 1548 1547 1548 -45 8 1547 1548 -21 0 68 -9 64)
    )
    (tilemap
      (solid #f)
      (z-pos 100)
      (name "Foreground")
      (width 500)
      (height 25)
      (tiles -3980 0 130 -499 0 129 -499 0 129 -11 0 68 -7 64 -318 0 1549 -3 0 1549 -3 0 1549 -153 0 129 -11 0 68 -7 64 -142 0 1549 2019 2140 2141 2142 2019 2140 2141 1549 -167 0 1549 -3 0 1549 -3 0 1549 -153 0 129 -11 0 68 -7 64 -142 0 1549 -7 2020 1549 -329 0 129 -11 0 68 -7 64 -142 0 -9 1549 -329 0 129 -11 0 68 -7 64 -286 0 1549 -203 0 68 -9 64 -286 0 1549 -22 0 1543 1544 -475 0 1549 -12 0 1549 -9 0 1547 1548 -475 0 1549 -12 0 1549 -200 0 2019 2140 2141 2142 2019 2140 2141 2142 2019 2140 2141 2142 2019 2140 2141 2142 2019 2140 2141 2142 2019 2140 2141 2142 2019 2140 2141 2142 2019 2140 2141 2142 2019 2140 2141 2142 2019 2140 2141 2142 2019 2140 2141 2142 2019 2140 2141 2142 2019 2140 2141 2142 2019 2140 2141 2142 2019 2140 2141 2142 2019 2140 2141 2142 2019 2140 2141 2142 2019 2140 2141 2142 2019 2140 2141 2142 2019 2140 2141 2142 2019 2140 2141 2142 2019 2140 2141 2142 2019 2140 2141 2142 2019 2140 2141 2142 2019 2140 2141 2142 2019 2140 2141 2142 2019 2140 2141 2142 2019 2140 2141 2142 2019 2140 2141 2142 2019 2140 2141 -350 0 2142 2019 2140 2141 2142 2019 2140 2141 2142 2019 2140 2141 2142 2019 2140 2141 2142 2019 2140 2141 2142 -10 0 -119 2020 -350 0 -21 2020 -10 0 -119 2020 -20 0 2140 2141 2142 -5 0 2140 2141 -10 0 2140 2141 2142 -8 0 2019 2140 -17 0 1549 2019 2140 2141 2142 2019 2140 2141 2142 2019 1549 -9 0 1549 2019 2140 2141 2142 2019 2140 2141 2142 2019 1549 -249 0 -21 2020 -10 0 -119 2020 -19 0 1544 -3 2020 1543 0 2020 0 1544 -2 2020 1543 -8 0 1544 -3 2020 1543 -6 0 1544 -2 2020 1543 -16 0 1544 -9 2020 1543 -9 0 1544 -9 2020 1543 -249 0 -21 2020 -10 0 -119 2020 -19 0 1548 -3 2020 1547 0 2020 0 1548 -2 2020 1547 -8 0 1548 -3 2020 1547 -6 0 1548 -2 2020 1547 -16 0 1548 -9 2020 1547 -9 0 1548 -9 2020 1547 -249 0 -21 2020 -10 0 -119 2020 -19 0 1544 -3 2020 1543 0 2020 0 1544 -2 2020 1543 -8 0 1544 -3 2020 1543 -6 0 1544 -2 2020 1543 -16 0 1544 -9 2020 1543 -9 0 1544 -9 2020 1543 -76 0 2141 2142 2019 2140 2141 2142 2019 2140 2141 2142 2019 2140 2141 2142 2019 2140 2141 2142 2019 2140 2141 2142 2019 2140 2141 2142 2019 2140 2141 2142 2019 2140 2141 2142 2019 2140 2141 2142 2019 2140 2141 2142 2019 2140 2141 2142 2019 2140 2141 2142 2019 2140 2141 2142 2019 2140 2141 2142 2019 2140 2141 2142 2019 2140 2141 2142 2019 2140 2141 2142 2019 2140 2141 2142 2019 2140 2141 2142 2019 2140 2141 2142 2019 2140 2141 2142 2019 2140 2141 2142 2019 2140 2141 2142 2019 2140 2141 2142 2019 2140 2141 2142 2019 2140 2141 2142 2019 2140 2141 2142 2019 2140 2141 2142 2019 2140 2141 2142 -55 0 -21 2020 -10 0 -119 2020 -19 0 1548 -3 2020 1547 0 2020 0 1548 -2 2020 1547 -8 0 1548 -3 2020 1547 -6 0 1548 -2 2020 1547 -16 0 1548 -9 2020 1547 -9 0 1548 -9 2020 1547 -76 0 -118 2020 -55 0 -21 2020 -10 0)
    )
    (tilemap
      (solid #t)
      (z-pos 1)
      (name "Ice")
      (width 500)
      (height 25)
      (tiles -4786 0 3041 -2 3042 3043 -6 0 3041 -2 3042 3043 -2208 0 3041 -5 3042 3043 -3 0 3041 -2 3042 3043 -86 0 3041 -10 3042 3043 -1606 0 3041 3042 3043 -2 0 3041 3042 3043 -1428 0 3041 -6 3042 3043 -177 0 3041 -6 3042 3043 -2145 0)
    )
    (unstable_tile
      (sprite "images/objects/unstable_tile/castleblock.sprite")
      (z-pos 0)
      (x 12736)
      (y 640)
    )
    (unstable_tile
      (sprite "images/objects/unstable_tile/castleblock.sprite")
      (z-pos 0)
      (x 12704)
      (y 640)
    )
    (unstable_tile
      (sprite "images/objects/unstable_tile/castleblock.sprite")
      (z-pos 0)
      (x 12672)
      (y 640)
    )
    (unstable_tile
      (sprite "images/objects/unstable_tile/castleblock.sprite")
      (z-pos 0)
      (x 12640)
      (y 640)
    )
    (unstable_tile
      (sprite "images/objects/unstable_tile/castleblock.sprite")
      (z-pos 0)
      (x 12608)
      (y 640)
    )
    (unstable_tile
      (sprite "images/objects/unstable_tile/castleblock.sprite")
      (z-pos 0)
      (x 12576)
      (y 640)
    )
    (unstable_tile
      (sprite "images/objects/unstable_tile/castleblock.sprite")
      (z-pos 0)
      (x 12544)
      (y 640)
    )
    (unstable_tile
      (sprite "images/objects/unstable_tile/castleblock.sprite")
      (z-pos 0)
      (x 12512)
      (y 640)
    )
    (unstable_tile
      (sprite "images/objects/unstable_tile/castleblock.sprite")
      (z-pos 0)
      (x 12384)
      (y 640)
    )
    (unstable_tile
      (sprite "images/objects/unstable_tile/castleblock.sprite")
      (z-pos 0)
      (x 12352)
      (y 640)
    )
    (unstable_tile
      (sprite "images/objects/unstable_tile/castleblock.sprite")
      (z-pos 0)
      (x 12192)
      (y 640)
    )
    (unstable_tile
      (sprite "images/objects/unstable_tile/castleblock.sprite")
      (z-pos 0)
      (x 12096)
      (y 640)
    )
    (unstable_tile
      (sprite "images/objects/unstable_tile/castleblock.sprite")
      (z-pos 0)
      (x 12064)
      (y 640)
    )
    (unstable_tile
      (sprite "images/objects/unstable_tile/castleblock.sprite")
      (z-pos 0)
      (x 12032)
      (y 640)
    )
    (unstable_tile
      (sprite "images/objects/unstable_tile/castleblock.sprite")
      (z-pos 0)
      (x 12000)
      (y 640)
    )
    (unstable_tile
      (sprite "images/objects/unstable_tile/castleblock.sprite")
      (z-pos 0)
      (x 11968)
      (y 640)
    )
    (weak_block
      (linked #f)
      (z-pos 60)
      (x 8192)
      (y 480)
    )
    (weak_block
      (linked #f)
      (z-pos 60)
      (x 8160)
      (y 480)
    )
    (weak_block
      (linked #f)
      (z-pos 60)
      (x 8128)
      (y 480)
    )
    (weak_block
      (linked #f)
      (z-pos 60)
      (x 10816)
      (y 448)
    )
    (weak_block
      (linked #f)
      (z-pos 60)
      (x 10848)
      (y 448)
    )
    (weak_block
      (linked #f)
      (z-pos 60)
      (x 11456)
      (y 416)
    )
    (weak_block
      (linked #f)
      (z-pos 60)
      (x 11488)
      (y 416)
    )
  )
)
