(supertux-level
  (version 3)
  (name (_ "Bombs Are Here"))
  (author "Sophie \"Vaesea\" Ball")
  (license "CC-BY-SA 4.0 International")
  (target-time 60)
  (allow-item-pocket "inherit")
  (icon "")
  (icon-locked "")
  (statistics
    (enable-coins #t)
    (enable-secrets #t)
  )
  (sector
    (name "main")
    (ambient-light
      (color 1 1 1)
    )
    (camera
      (name "Camera")
      (mode "normal")
    )
    (decal
      (z-pos -100)
      (sprite "/images/decal/snow/exitbg.png")
      (x 15680)
      (y 640)
    )
    (decal
      (z-pos 100)
      (sprite "/images/decal/snow/exitfg.png")
      (x 15776)
      (y 640)
    )
    (firefly
      (z-pos 0)
      (x 8736)
      (y 800)
    )
    (flyingsnowball
      (z-pos 50)
      (x 4224)
      (y 768)
      (glinting #f)
    )
    (flyingsnowball
      (z-pos 50)
      (x 6144)
      (y 736)
      (glinting #f)
    )
    (flyingsnowball
      (z-pos 50)
      (x 9344)
      (y 704)
      (glinting #f)
    )
    (flyingsnowball
      (z-pos 50)
      (x 13088)
      (y 768)
      (glinting #f)
    )
    (flyingsnowball
      (z-pos 50)
      (x 14240)
      (y 768)
      (glinting #f)
    )
    (gradient
      (top_color 0.3 0.4 0.75)
      (bottom_color 1 1 1)
    )
    (jumpy
      (z-pos 50)
      (x 7904)
      (y 736)
      (glinting #f)
    )
    (mrbomb
      (z-pos 50)
      (direction "left")
      (x 2464)
      (y 672)
      (glinting #f)
    )
    (mrbomb
      (z-pos 50)
      (direction "left")
      (x 5216)
      (y 736)
      (glinting #f)
    )
    (mrbomb
      (z-pos 50)
      (direction "left")
      (x 3552)
      (y 864)
      (glinting #f)
    )
    (mrbomb
      (z-pos 50)
      (direction "left")
      (x 10208)
      (y 864)
      (glinting #f)
    )
    (mrbomb
      (z-pos 50)
      (direction "left")
      (x 12576)
      (y 864)
      (glinting #f)
    )
    (mrbomb
      (z-pos 50)
      (direction "left")
      (x 11840)
      (y 832)
      (glinting #f)
    )
    (mrbomb
      (z-pos 50)
      (direction "left")
      (x 10816)
      (y 928)
      (glinting #f)
    )
    (mriceblock
      (z-pos 50)
      (direction "left")
      (x 8224)
      (y 768)
      (glinting #f)
    )
    (music
      (file "/music/antarctic/chipdisko.music")
    )
    (particles-snow
      (z-pos -199)
    )
    (sequencetrigger
      (sequence "endsequence")
      (width 32)
      (height 832)
      (x 15392)
      (y 0)
    )
    (sequencetrigger
      (sequence "stoptux")
      (width 32)
      (height 704)
      (x 15968)
      (y 256)
    )
    (smartball
      (z-pos 50)
      (direction "left")
      (x 2304)
      (y 672)
      (glinting #f)
    )
    (smartball
      (z-pos 50)
      (direction "left")
      (x 8800)
      (y 672)
      (glinting #f)
    )
    (smartball
      (z-pos 50)
      (direction "left")
      (x 12448)
      (y 736)
      (glinting #f)
    )
    (smartball
      (z-pos 50)
      (direction "left")
      (x 14112)
      (y 768)
      (glinting #f)
    )
    (smartblock
      (z-pos 50)
      (direction "left")
      (x 13344)
      (y 768)
      (glinting #f)
    )
    (snowball
      (z-pos 50)
      (direction "left")
      (x 1600)
      (y 864)
      (glinting #f)
    )
    (snowball
      (z-pos 50)
      (direction "left")
      (x 3072)
      (y 800)
      (glinting #f)
    )
    (snowball
      (z-pos 50)
      (direction "left")
      (x 4096)
      (y 832)
      (glinting #f)
    )
    (snowball
      (z-pos 50)
      (direction "left")
      (x 7200)
      (y 704)
      (glinting #f)
    )
    (snowball
      (z-pos 50)
      (direction "left")
      (x 6816)
      (y 736)
      (glinting #f)
    )
    (snowman
      (z-pos 50)
      (direction "left")
      (x 1056)
      (y 832)
      (glinting #f)
    )
    (spawnpoint
      (name "main")
      (x 64)
      (y 736)
    )
    (spiky
      (z-pos 50)
      (direction "left")
      (x 10944)
      (y 928)
      (glinting #f)
    )
    (sspiky
      (z-pos 50)
      (direction "left")
      (x 15136)
      (y 800)
      (glinting #f)
    )
    (tilemap
      (solid #f)
      (z-pos -100)
      (width 500)
      (height 35)
      (tiles -3089 0 85 86 87 88 -496 0 89 90 91 92 -651 0 85 86 87 88 -496 0 89 90 91 92 -125 0 85 86 87 88 -496 0 89 90 91 92 -128 0 85 86 87 88 -430 0 85 86 87 88 -62 0 89 90 91 92 -430 0 89 90 91 92 -219 0 85 86 87 88 -324 0 85 86 87 88 -168 0 89 90 91 92 -145 0 85 86 87 88 -175 0 89 90 91 92 -317 0 89 90 91 92 -1165 0 130 -241 0 122 123 -256 0 129 -241 0 124 125 -32 0 122 123 -222 0 129 -80 0 106 107 108 -158 0 124 125 -27 0 25 -4 0 124 125 -41 0 122 123 -63 0 202 -3 0 202 -111 0 129 -23 0 122 123 -20 0 122 123 -33 0 109 110 111 -2 0 24 -2 0 25 -134 0 122 123 -16 0 124 125 -5 0 106 107 108 -24 0 124 125 -41 0 124 125 0 122 123 -54 0 122 123 -113 0 122 123 -5 0 129 -23 0 124 125 -16 0 122 123 -2 0 124 125 -77 0 122 123 -10 0 122 123 -85 0 124 125 -16 0 124 125 24 -4 0 109 110 111 -24 0 124 125 -41 0 124 125 0 124 125 -54 0 124 125 -113 0 124 125 -3 0 122 123 129 -23 0 124 125 0 106 107 108 -12 0 124 125 -2 0 124 125 -22 0 122 123 -48 0 122 123 -3 0 124 125 -10 0 124 125 0 122 123 -78 0 106 107 108 0 124 125 -4 0 24 -4 0 25 -40 0 124 125 -41 0 124 125 0 124 125 -54 0 124 125 -20 0 122 123 -91 0 124 125 -3 0 124 125 129 -21 0 25 24 124 125 0 109 110 111 -5 0 24 0 25 -4 0 124 125 -2 0 124 125 -2 0 122 123 -18 0 124 125 -48 0 124 125 -3 0 124 125 0 122 123 -7 0 124 125 0 124 125 -75 0 25 -2 0 109 110 111 0 124 125 -44 0 24 -2 0 25 -2 0 124 125 -39 0 25 0 124 125 0 124 125 -18 0 122 123 -34 0 124 125 -20 0 124 125 -80 0 122 123 -9 0 124 125 -3 0 124 125 129 -5 0 106 107 108 -33 0 124 125 -2 0 124 125 -2 0 124 125 -18 0 124 125 -35 0 24 -2 0 25 -9 0 124 125 -3 0 124 125 0 124 125 -7 0 124 125 0 124 125 0 106 107 108 -148 0 122 123 -34 0 106 107 108 -9 0 124 125 -34 0 124 125 -20 0 124 125 -80 0 124 125 -9 0 124 125 0 24 0 124 125 129 -3 0 25 0 109 110 111 -37 0 124 125 -2 0 124 125 -13 0 106 107 108 -2 0 124 125 -48 0 124 125 -3 0 124 125 0 124 125 -5 0 24 0 124 125 0 124 125 0 109 110 111 24 -147 0 124 125 -32 0 24 0 109 110 111 -9 0 124 125 -11 0 122 123 -8 0 122 123 -11 0 124 125 0 25 -3 0 24 -14 0 124 125 -5 0 106 107 108 -72 0 124 125 106 107 108 -63 0 124 125 -8 0 25 -2 0 24 0 109 110 111 -2 0 124 125 -48 0 124 125 -2 0 24 124 125 0 124 125 25 -159 0 106 107 108 0 124 125 -42 0 25 -3 0 124 125 -4 0 122 123 -5 0 124 125 -8 0 124 125 0 106 107 108 -29 0 124 125 -3 0 25 0 109 110 111 0 24 -69 0 24 124 125 109 110 111 0 25 -296 0 24 -2 0 25 0 109 110 111 0 124 125 -4 0 24 -47 0 124 125 -5 0 124 125 -8 0 124 125 0 109 110 111 -477 0 124 125 -3 0 24 0 124 125 -2 0 25 -2660 0)
    )
    (tilemap
      (solid #f)
      (z-pos 100)
      (width 500)
      (height 35)
      (tiles -8982 0 130 -499 0 129 -499 0 129 -499 0 129 -499 0 129 -499 0 129 -499 0 129 -499 0 129 -499 0 129 -4517 0)
    )
    (tilemap
      (solid #t)
      (z-pos 0)
      (width 500)
      (height 35)
      (tiles -3541 0 -2 44 -496 0 -2 44 -2 0 -2 44 -493 0 44 -6 0 44 -1495 0 83 2948 -1997 0 -4 83 -821 0 83 102 83 -195 0 78 -3 83 78 0 -3 44 0 -2 83 78 -2 83 -148 0 7 -2 8 9 -42 0 83 2947 83 -451 0 27 -2 28 29 -191 0 -2 44 -9 0 -2 44 -104 0 -3 83 -2 0 -3 83 -153 0 7 -2 8 9 -47 0 7 -2 8 9 -110 0 -5 44 -51 0 44 -13 0 44 -74 0 -5 83 -46 0 2909 2910 -16 8 2913 2914 -119 0 27 -2 28 29 -47 0 13 -2 14 15 -16 0 7 9 -3 0 7 9 -87 0 27 -3 28 29 -189 0 3141 3142 2911 2912 -16 14 2915 2916 3139 3140 -55 0 -3 83 -45 0 -3 83 -33 0 2909 2910 -9 8 9 -17 0 16 -2 17 18 -16 0 27 -5 28 29 -83 0 7 -2 8 9 -5 0 7 -2 8 9 -51 0 7 -5 8 9 -126 0 1837 3145 3146 1834 -18 11 1835 3143 3144 3149 -66 0 -3 83 -21 0 -3 83 -32 0 2909 2910 -9 8 2921 2922 2911 2912 -9 14 15 -7 0 211 -119 0 27 -2 28 29 -5 0 27 -2 28 29 -10 0 7 -6 8 9 -33 0 27 -5 28 29 -69 0 -20 8 2913 2914 -14 0 -2 83 -2 0 -2 83 102 83 -2 0 -2 83 -8 0 1837 1839 3148 -22 11 3147 3151 3152 -76 0 -2 83 102 -2 83 -30 0 7 -10 8 2921 2922 2911 2912 -9 14 2923 2924 1834 -10 11 12 -7 0 212 -5 0 7 -11 8 2913 2914 -7 0 7 8 9 -7 0 7 8 9 -7 0 2909 2910 9 -6 0 7 -6 8 9 -79 0 27 -6 28 29 -21 0 7 -5 8 9 -17 0 7 -5 8 9 -57 0 -20 14 2915 2916 2917 2918 2913 2914 -29 0 3150 1839 1841 -24 11 3155 3156 2917 2918 -11 8 9 -37 0 7 9 -3 44 7 9 -41 0 7 9 -3 44 7 9 -5 0 13 -10 14 2923 2924 1834 -21 11 19 11 12 -7 0 212 27 -3 28 29 13 -11 14 2915 2916 3139 3140 -5 0 27 28 29 -7 0 27 28 29 -5 0 3141 3142 2911 2912 15 -5 0 7 114 -6 14 113 2913 2914 -106 0 27 -5 28 29 -17 0 27 -5 28 29 -29 0 7 -27 8 -21 11 1835 2919 2920 2915 2916 2917 2918 2913 2914 -24 0 3153 3154 1841 -18 11 19 -7 11 1835 2919 2920 -11 14 15 -15 0 7 -15 8 9 -5 0 27 -5 28 29 -5 0 7 9 -3 44 7 9 -17 0 7 9 -3 44 7 9 -5 0 27 -5 28 29 -5 0 10 -36 11 12 78 105 78 -4 0 212 47 -4 0 10 -12 11 1835 3143 3144 3149 -21 0 3150 3145 3146 1834 11 12 -5 0 13 23 -6 11 20 2915 2916 2917 2918 -4 8 2913 2914 -43 0 2909 2910 -14 8 9 -26 0 7 -5 8 9 -41 0 7 -5 8 9 -17 0 13 -27 14 -2 11 115 116 -21 11 1835 2919 2920 2915 2916 2917 2918 -20 8 2921 2922 3157 3158 -41 11 21 -15 8 114 -15 14 15 -17 0 27 -5 28 29 -5 0 202 0 -3 44 0 202 -5 0 27 -5 28 29 -17 0 10 -36 11 12 -7 0 213 -5 0 10 -3 11 19 -10 11 3147 3151 3152 -19 0 3153 3154 3148 11 19 11 12 -5 0 10 -9 11 1835 2919 2920 -4 14 2915 2916 2917 2918 -8 8 9 -28 0 2909 2910 2921 2922 2911 2912 -14 14 15 -5 0 7 -14 8 9 -5 0 27 -5 28 29 -41 0 27 -5 28 29 -5 0 7 -11 8 22 -25 11 19 -3 11 117 118 -5 11 19 -9 11 19 -9 11 1835 2919 2920 -20 14 2923 2924 1834 -11 11 19 -30 11 20 -15 14 23 -15 11 12 -29 0 27 -5 28 29 -29 0 10 -17 11 19 -18 11 12 -6 0 27 29 -5 0 10 -15 11 3155 3156 2917 2918 -15 8 2921 2922 3157 3158 -4 11 12 -5 0 10 11 19 -15 11 1835 2919 2920 -8 14 15 -19 0 7 -6 8 2921 2922 2911 2912 2923 2924 1834 -15 11 12 -5 0 13 -14 14 15 -65 0 13 -11 14 23 -73 11 19 -39 11 19 -38 11 19 -3 11 12 -65 0 10 -24 11 19 -11 11 12 -5 44 27 29 -6 0 10 -16 11 1835 2919 2920 -15 14 2923 2924 1834 -5 11 12 -5 0 10 -28 11 21 -19 8 114 -6 14 2923 2924 1834 -15 11 19 -3 11 12 -5 0 10 -14 11 12 -65 0 10 -66 11 19 -73 11 19 -18 11 115 116 -7 11 12 -65 0 10 11 19 -34 11 12 27 -4 28 29 -7 0 10 -19 11 115 116 -21 11 12 -5 0 10 -28 11 20 -19 14 23 -28 11 12 -5 0 10 -7 11 19 -6 11 12 -65 0 10 -10 11 115 116 -32 11 19 -7 11 19 -44 11 19 -54 11 19 -6 11 117 118 -7 11 12 -65 0 10 -7 11 19 -28 11 12 -13 0 10 -12 11 19 -6 11 117 118 -21 11 12 -5 0 10 -32 11 19 -28 11 19 -15 11 12 -5 0 10 -14 11 12 -65 0 10 -3 11 19 -6 11 117 118 -63 11 19 -92 11 12 -65 0 10 -36 11 12 -13 0 10 -42 11 12 -5 0 10 -72 11 115 116 -3 11 12 -5 0 10 -14 11 12 -65 0 10 -39 11 19 -92 11 19 -35 11 12 -65 0 10 -36 11 12 -13 0 10 -33 11 19 -8 11 12 -5 0 10 -11 11 19 -35 11 19 -24 11 117 118 -3 11 12 -5 0 10 -2 11 19 -11 11 12 -65 0 10 -20 11 19 -147 11 12 -65 0 10 -36 11 12 -13 0 10 -42 11 12 -5 0 10 -77 11 12 -5 0 10 -14 11 12 -65 0 10 -39 11)
    )
    (tilemap
      (solid #f)
      (speed-x 0.5)
      (speed-y 0.5)
      (z-pos -200)
      (width 500)
      (height 35)
      (tiles -6521 0 149 -6 150 151 -29 0 149 -6 150 151 -29 0 149 -6 150 151 -29 0 149 -6 150 151 -29 0 149 -6 150 151 -29 0 149 -6 150 151 -29 0 149 -6 150 151 -29 0 149 -6 150 151 -29 0 149 -6 150 151 -29 0 149 -6 150 151 -29 0 149 -6 150 151 -29 0 149 -6 150 151 -29 0 149 -6 150 151 -48 0 152 -6 153 158 -7 150 151 -21 0 152 -6 153 158 -7 150 151 -21 0 152 -6 153 158 -7 150 151 -21 0 152 -6 153 158 -7 150 151 -21 0 152 -6 153 158 -7 150 151 -21 0 152 -6 153 158 -7 150 151 -21 0 152 -6 153 158 -7 150 151 -21 0 152 -6 153 158 -7 150 151 -21 0 152 -6 153 158 -7 150 151 -21 0 152 -6 153 158 -7 150 151 -21 0 152 -6 153 158 -7 150 151 -21 0 152 -6 153 158 -7 150 151 -21 0 152 -6 153 158 -7 150 151 -32 0 149 -7 150 159 -14 153 154 -13 0 149 -7 150 159 -14 153 154 -13 0 149 -7 150 159 -14 153 154 -13 0 149 -7 150 159 -14 153 154 -13 0 149 -7 150 159 -14 153 154 -13 0 149 -7 150 159 -14 153 154 -13 0 149 -7 150 159 -14 153 154 -13 0 149 -7 150 159 -14 153 154 -13 0 149 -7 150 159 -14 153 154 -13 0 149 -7 150 159 -14 153 154 -13 0 149 -7 150 159 -14 153 154 -13 0 149 -7 150 159 -14 153 154 -13 0 149 -7 150 159 -14 153 154 -13 0 149 -18 150 159 -22 153 158 -13 150 159 -22 153 158 -13 150 159 -22 153 158 -13 150 159 -22 153 158 -13 150 159 -22 153 158 -13 150 159 -22 153 158 -13 150 159 -22 153 158 -13 150 159 -22 153 158 -13 150 159 -22 153 158 -13 150 159 -22 153 158 -13 150 159 -22 153 158 -13 150 159 -22 153 158 -13 150 159 -22 153 158 -13 150 159 -9005 153)
    )
    (tilemap
      (solid #f)
      (speed-x 0.25)
      (speed-y 0.25)
      (z-pos -250)
      (width 500)
      (height 35)
      (tiles -3010 0 161 -3 162 163 -14 0 161 -3 162 163 -14 0 161 -3 162 163 -14 0 161 -3 162 163 -14 0 161 -3 162 163 -14 0 161 -3 162 163 -14 0 161 -3 162 163 -14 0 161 -3 162 163 -14 0 161 -3 162 163 -14 0 161 -3 162 163 -14 0 161 -3 162 163 -14 0 161 -3 162 163 -14 0 161 -3 162 163 -14 0 161 -3 162 163 -14 0 161 -3 162 163 -14 0 161 -3 162 163 -14 0 161 -3 162 163 -14 0 161 -3 162 163 -14 0 161 -3 162 163 -14 0 161 -3 162 163 -14 0 161 -3 162 163 -14 0 161 -3 162 163 -14 0 161 -3 162 163 -14 0 161 -3 162 163 -14 0 161 -3 162 163 -14 0 161 -3 162 163 -20 0 164 -3 165 170 -3 162 163 -10 0 164 -3 165 170 -3 162 163 -10 0 164 -3 165 170 -3 162 163 -10 0 164 -3 165 170 -3 162 163 -10 0 164 -3 165 170 -3 162 163 -10 0 164 -3 165 170 -3 162 163 -10 0 164 -3 165 170 -3 162 163 -10 0 164 -3 165 170 -3 162 163 -10 0 164 -3 165 170 -3 162 163 -10 0 164 -3 165 170 -3 162 163 -10 0 164 -3 165 170 -3 162 163 -10 0 164 -3 165 170 -3 162 163 -10 0 164 -3 165 170 -3 162 163 -10 0 164 -3 165 170 -3 162 163 -10 0 164 -3 165 170 -3 162 163 -10 0 164 -3 165 170 -3 162 163 -10 0 164 -3 165 170 -3 162 163 -10 0 164 -3 165 170 -3 162 163 -10 0 164 -3 165 170 -3 162 163 -10 0 164 -3 165 170 -3 162 163 -10 0 164 -3 165 170 -3 162 163 -10 0 164 -3 165 170 -3 162 163 -10 0 164 -3 165 170 -3 162 163 -10 0 164 -3 165 170 -3 162 163 -10 0 164 -3 165 170 -3 162 163 -10 0 164 -3 165 170 -3 162 163 -12 0 161 -3 162 171 -7 165 166 -6 0 161 -3 162 171 -7 165 166 -6 0 161 -3 162 171 -7 165 166 -6 0 161 -3 162 171 -7 165 166 -6 0 161 -3 162 171 -7 165 166 -6 0 161 -3 162 171 -7 165 166 -6 0 161 -3 162 171 -7 165 166 -6 0 161 -3 162 171 -7 165 166 -6 0 161 -3 162 171 -7 165 166 -6 0 161 -3 162 171 -7 165 166 -6 0 161 -3 162 171 -7 165 166 -6 0 161 -3 162 171 -7 165 166 -6 0 161 -3 162 171 -7 165 166 -6 0 161 -3 162 171 -7 165 166 -6 0 161 -3 162 171 -7 165 166 -6 0 161 -3 162 171 -7 165 166 -6 0 161 -3 162 171 -7 165 166 -6 0 161 -3 162 171 -7 165 166 -6 0 161 -3 162 171 -7 165 166 -6 0 161 -3 162 171 -7 165 166 -6 0 161 -3 162 171 -7 165 166 -6 0 161 -3 162 171 -7 165 166 -6 0 161 -3 162 171 -7 165 166 -6 0 161 -3 162 171 -7 165 166 -6 0 161 -3 162 171 -7 165 166 -6 0 161 -3 162 171 -7 165 166 -6 0 -6 162 171 -11 165 170 -6 162 171 -11 165 170 -6 162 171 -11 165 170 -6 162 171 -11 165 170 -6 162 171 -11 165 170 -6 162 171 -11 165 170 -6 162 171 -11 165 170 -6 162 171 -11 165 170 -6 162 171 -11 165 170 -6 162 171 -11 165 170 -6 162 171 -11 165 170 -6 162 171 -11 165 170 -6 162 171 -11 165 170 -6 162 171 -11 165 170 -6 162 171 -11 165 170 -6 162 171 -11 165 170 -6 162 171 -11 165 170 -6 162 171 -11 165 170 -6 162 171 -11 165 170 -6 162 171 -11 165 170 -6 162 171 -11 165 170 -6 162 171 -11 165 170 -6 162 171 -11 165 170 -6 162 171 -11 165 170 -6 162 171 -11 165 170 -6 162 171 -11 165 170 -6 162 -12500 165)
    )
  )
)
