(supertux-level
  (version 3)
  (name (_ "Bridge Over The Dark Sea"))
  (author "Sophie \"Vaesea\" Ball")
  (license "CC-BY-SA 4.0 International")
  (target-time 61)
  (allow-item-pocket "inherit")
  (icon "")
  (icon-locked "")
  (statistics
    (enable-coins #t)
    (enable-secrets #t)
  )
  (sector
    (name "main")
    (ambient-light
      (color 0.6 0.6 0.6)
    )
    (background
      (color 1 1 1)
      (alignment "bottom")
      (speed 0.5)
      (image "/images/background/bridgeocean-fade.png")
    )
    (background
      (color 1 1 1)
      (alignment "top")
      (speed 0.5)
      (image "/images/background/bridgecloud-dark.png")
      (z-pos -299)
    )
    (background
      (color 1 1 1)
      (speed 0)
      (fill #t)
      (image "/images/background/halloween/vignette.png")
      (z-pos 300)
    )
    (background
      (color 1 1 1)
      (speed 0.25)
      (image-top "/images/background/nightsky_top.png")
      (image "/images/background/nightsky_top.png")
      (image-bottom "/images/background/nightsky_top.png")
      (z-pos -301)
    )
    (bouncingsnowball
      (z-pos 50)
      (direction "left")
      (x 3168)
      (y 544)
      (glinting #f)
    )
    (camera
      (name "Camera")
      (mode "normal")
    )
    (crusher
      (z-pos 50)
      (x 3840)
      (y 640)
    )
    (firefly
      (z-pos 0)
      (x 9120)
      (y 704)
    )
    (flyingsnowball
      (z-pos 50)
      (x 8896)
      (y 704)
      (glinting #f)
    )
    (haywire
      (z-pos 50)
      (direction "left")
      (x 2432)
      (y 832)
      (glinting #f)
    )
    (jumpy
      (z-pos 50)
      (x 3168)
      (y 384)
      (glinting #f)
    )
    (jumpy
      (z-pos 50)
      (x 3680)
      (y 576)
      (glinting #f)
    )
    (jumpy
      (z-pos 50)
      (x 7488)
      (y 800)
      (glinting #f)
    )
    (jumpy
      (z-pos 50)
      (x 4448)
      (y 512)
      (glinting #f)
    )
    (mriceblock
      (z-pos 50)
      (direction "left")
      (x 1824)
      (y 832)
      (glinting #f)
    )
    (mriceblock
      (z-pos 50)
      (direction "left")
      (x 2752)
      (y 832)
      (glinting #f)
    )
    (mriceblock
      (z-pos 50)
      (direction "left")
      (x 3328)
      (y 832)
      (glinting #f)
    )
    (mriceblock
      (z-pos 50)
      (direction "left")
      (x 3680)
      (y 832)
      (glinting #f)
    )
    (mriceblock
      (z-pos 50)
      (direction "left")
      (x 4384)
      (y 544)
      (glinting #f)
    )
    (mriceblock
      (z-pos 50)
      (direction "left")
      (x 10240)
      (y 576)
      (glinting #f)
    )
    (mriceblock
      (z-pos 50)
      (direction "left")
      (x 10336)
      (y 576)
      (glinting #f)
    )
    (mriceblock
      (z-pos 50)
      (direction "left")
      (x 12672)
      (y 672)
      (glinting #f)
    )
    (mriceblock
      (z-pos 50)
      (direction "left")
      (x 12352)
      (y 736)
      (glinting #f)
    )
    (music
      (file "/music/forest/wisphunt.music")
    )
    (particles-rain
    )
    (secretarea
      (width 192)
      (height 224)
      (x 2144)
      (y 0)
    )
    (sequencetrigger
      (sequence "endsequence")
      (width 32)
      (height 800)
      (x 15296)
      (y 0)
    )
    (sequencetrigger
      (sequence "stoptux")
      (width 32)
      (height 64)
      (x 15968)
      (y 768)
    )
    (short_fuse
      (z-pos 50)
      (direction "left")
      (x 3200)
      (y 832)
      (glinting #f)
    )
    (short_fuse
      (z-pos 50)
      (direction "left")
      (x 2880)
      (y 832)
      (glinting #f)
    )
    (short_fuse
      (z-pos 50)
      (direction "left")
      (x 2944)
      (y 832)
      (glinting #f)
    )
    (short_fuse
      (z-pos 50)
      (direction "left")
      (x 2592)
      (y 832)
      (glinting #f)
    )
    (short_fuse
      (z-pos 50)
      (direction "left")
      (x 3520)
      (y 832)
      (glinting #f)
    )
    (smartball
      (z-pos 50)
      (direction "left")
      (x 8864)
      (y 864)
      (glinting #f)
    )
    (smartball
      (z-pos 50)
      (direction "left")
      (x 9728)
      (y 864)
      (glinting #f)
    )
    (smartblock
      (z-pos 50)
      (direction "left")
      (x 1696)
      (y 832)
      (glinting #f)
    )
    (smartblock
      (z-pos 50)
      (direction "left")
      (x 1632)
      (y 704)
      (glinting #f)
    )
    (smartblock
      (z-pos 50)
      (direction "left")
      (x 2528)
      (y 576)
      (glinting #f)
    )
    (smartblock
      (z-pos 50)
      (direction "left")
      (x 10144)
      (y 576)
      (glinting #f)
    )
    (snowball
      (z-pos 50)
      (direction "left")
      (x 3040)
      (y 832)
      (glinting #f)
    )
    (snowball
      (z-pos 50)
      (direction "left")
      (x 9088)
      (y 864)
      (glinting #f)
    )
    (snowball
      (z-pos 50)
      (direction "left")
      (x 9504)
      (y 864)
      (glinting #f)
    )
    (snowman
      (z-pos 50)
      (direction "left")
      (x 6144)
      (y 800)
      (glinting #f)
    )
    (snowman
      (z-pos 50)
      (direction "left")
      (x 6816)
      (y 800)
      (glinting #f)
    )
    (snowman
      (z-pos 50)
      (direction "left")
      (x 7424)
      (y 800)
      (glinting #f)
    )
    (snowman
      (z-pos 50)
      (direction "left")
      (x 12960)
      (y 640)
      (glinting #f)
    )
    (spawnpoint
      (name "main")
      (x 64)
      (y 800)
    )
    (tilemap
      (solid #f)
      (z-pos -100)
      (width 500)
      (height 35)
      (tiles -8477 0 130 -499 0 129 -105 0 1809 1812 -392 0 129 -105 0 1810 1813 -392 0 129 -105 0 1811 1814 -392 0 129 -14 0 -2 2035 -483 0 129 -14 0 -2 2035 -455 0 1809 1812 -3 0 1809 1812 -3 0 1809 1812 -3 0 1809 1812 -3 0 1809 1812 -3 0 1809 1812 0 129 -8 0 1809 1812 -4 0 -2 2035 -381 0 1809 1812 -72 0 1810 1813 -3 0 1810 1813 -3 0 1810 1813 -3 0 1810 1813 -3 0 1810 1813 -3 0 1810 1813 0 129 -3 0 106 107 108 -2 0 1810 1813 -4 0 -2 2035 -17 0 1809 1812 -167 0 1809 1812 -50 0 1809 1812 -141 0 1810 1813 -72 0 1811 1814 -3 0 1811 1814 -3 0 1811 1814 -3 0 1811 1814 -3 0 1811 1814 -3 0 1811 1814 0 129 -2 0 24 109 110 111 0 24 1811 1814 0 25 -2 0 -2 2035 -17 0 1810 1813 -167 0 1810 1813 -50 0 1810 1813 -141 0 1811 1814 -134 0 1811 1814 -167 0 1811 1814 -50 0 1811 1814 -4266 0)
    )
    (tilemap
      (solid #f)
      (z-pos 100)
      (width 500)
      (height 35)
      (tiles -8479 0 130 -499 0 129 -499 0 129 -499 0 129 -11 0 1355 -487 0 129 -11 0 1356 -2 0 68 -5 64 -479 0 129 -11 0 1356 -2 0 68 -5 64 -479 0 129 -11 0 1356 -2 0 68 -5 64 -479 0 129 -11 0 1356 -2 0 68 -5 64 -479 0 129 -11 0 1411 -2 0 68 -5 64 -5000 0)
    )
    (tilemap
      (solid #t)
      (z-pos 0)
      (width 500)
      (height 35)
      (tiles -491 0 68 -8 64 -491 0 68 -8 64 -491 0 68 -8 64 -69 0 -2 128 -420 0 68 -8 64 -491 0 68 -8 64 -491 0 68 -8 64 -66 0 -8 44 -417 0 68 -8 64 -66 0 1551 1549 -4 1540 1549 1541 -417 0 68 -8 64 -491 0 68 -8 64 -491 0 68 -8 64 -491 0 68 -8 64 -74 0 112 -416 0 68 -8 64 -491 0 68 -8 64 -491 0 68 -8 64 -97 0 1551 1549 1540 1549 1541 -389 0 68 -8 64 -74 0 77 -2 78 105 -232 0 -3 83 -6 0 83 102 83 -169 0 68 -8 64 -112 0 -2 83 -3 0 102 83 -30 0 44 -341 0 68 -8 64 -105 0 1551 1549 1541 -41 0 44 -341 0 68 -8 64 -93 0 1551 1549 -3 1540 1549 1541 -27 0 1551 1549 -10 1540 1549 1541 -8 0 44 -185 0 44 -155 0 68 -8 64 -71 0 1551 1549 -6 1540 1549 1541 -14 0 -3 83 -51 0 44 -157 0 1551 1549 -14 1540 1549 1541 -10 0 44 -156 0 67 66 3519 -5 64 -111 0 1551 1549 -5 1540 1549 1541 -29 0 44 -134 0 -3 83 -48 0 44 -244 0 1551 1549 -4 1540 1549 1541 -61 0 44 -185 0 44 -210 0 -5 44 -98 0 44 -144 0 1551 1549 -3 1540 1549 1541 -34 0 44 -40 0 78 -2 83 78 -2 83 78 -5 0 3187 1551 -16 1540 1541 -114 0 -3 83 102 -3 83 -16 0 1551 1549 -5 1540 1549 1541 -14 0 1551 1549 -5 1540 1549 1541 -12 0 1551 1549 -7 1540 1549 1541 -50 0 44 -185 0 44 -51 0 3187 1551 -16 1540 1541 -7 0 1551 -4 1540 1541 -363 0 1551 1549 -3 1540 1549 1541 -46 0 44 -50 0 3187 1551 1541 3194 -24 0 1551 -2 1540 1541 -6 0 1551 -4 1540 1541 -48 0 7 -21 8 -385 0 3187 1551 1541 3194 -36 0 1551 -2 1540 1541 -6 0 1551 -4 1540 1541 -6 0 1551 -28 1540 1543 1544 13 -21 14 -21 0 -7 44 -17 0 -7 44 -322 0 1551 -11 1540 1541 3194 -48 0 1551 -2 1540 1541 -8 0 1551 -27 1540 1547 1548 10 -21 11 -2 1540 1543 1544 -30 1540 1541 -4 0 1551 -18 1540 1541 -4 0 1551 -37 1540 1543 1544 -18 1540 1541 -56 0 1551 -14 1540 1541 -5 0 1551 -14 1540 1541 -5 0 1551 -11 1540 1543 1544 1540 1541 -139 0 1551 -9 1540 1541 3194 -86 0 1551 1541 1542 -2 1546 10 -21 11 -2 1540 1547 1548 -29 1540 1541 -4 0 1551 -18 1540 1541 -4 0 1551 -38 1540 1547 1548 -17 1540 1541 -58 0 1551 -12 1540 1541 -7 0 1551 -12 1540 1541 -7 0 1551 -10 1540 1547 1548 1541 -40 0 1551 -30 1540 1541 -167 0 1545 -3 1546 10 -21 11 -2 0 -2 1546 -97 0 -2 1546 -129 0 -2 1546 -42 0 1551 -28 1540 1541 -169 0 1550 -2 1546 10 -21 11 -2 0 -2 1546 -97 0 -2 1546 -45 0 1551 1540 1541 -19 0 1551 1540 1541 -59 0 -2 1546 -10 0 1551 1540 1541 -19 0 1551 1540 1541 -65 0 1551 1540 1541 -13 0 1551 1540 1541 -13 0 1551 1540 1541 -107 0 -2 1546 10 -21 11 -2 0 -2 1546 -97 0 -2 1546 -56 0 1551 1540 1541 -70 0 -2 1546 -21 0 1551 1540 1541 -84 0 1551 1540 1541 -13 0 1551 1540 1541 -115 0 -2 1546 10 -21 11 -2 0 -2 1546 -97 0 -2 1546 -129 0 -2 1546 -242 0 -2 1546 10 -21 11 -2 0 -2 1546 -97 0 -2 1546 -129 0 -2 1546 -242 0 -2 1546 10 -21 11 -2 0 -2 1546 -97 0 -2 1546 -129 0 -2 1546 -242 0 -2 1546 10 -21 11)
    )
    (tilemap
      (solid #f)
      (tint 0.5 0.5 0.5)
      (z-pos -50)
      (width 500)
      (height 35)
      (tiles -4067 0 1546 -4 0 1546 -494 0 1546 -4 0 1546 -494 0 1546 -4 0 1546 -494 0 1546 -4 0 1546 -494 0 1546 -4 0 1546 -494 0 1546 -4 0 1546 -494 0 1546 -4 0 1546 -494 0 1546 -4 0 1546 -25 0 1546 0 1546 -466 0 1546 -4 0 1546 -25 0 1546 0 1546 -466 0 1546 -4 0 1546 -25 0 1546 0 1546 -466 0 1546 -4 0 1546 -27 0 1546 -5 0 1546 -460 0 1546 -26 0 1546 -3 0 1546 0 1546 -5 0 1546 -21 0 1546 -10 0 1546 -427 0 1546 -4 0 1546 -6 0 1546 -14 0 1546 -3 0 1546 0 1546 -5 0 1546 -21 0 1546 -10 0 1546 -168 0 1546 -14 0 1546 -243 0 1546 -4 0 1546 -6 0 1546 -14 0 1546 -3 0 1546 0 1546 -5 0 1546 -5 0 1546 -5 0 1546 -9 0 1546 -10 0 1546 -168 0 1546 -14 0 1546 -243 0 1546 -4 0 1546 -6 0 1546 0 1546 -4 0 1546 -7 0 1546 -3 0 1546 0 1546 -5 0 1546 -5 0 1546 -5 0 1546 -9 0 1546 -10 0 1546 -168 0 1546 -14 0 1546 -255 0 1546 0 1546 -4 0 1546 -13 0 1546 -5 0 1546 -5 0 1546 -5 0 1546 -9 0 1546 -10 0 1546 -155 0 1546 -3 0 1546 -8 0 1546 -14 0 1546 -221 0 1546 -5 0 1546 -16 0 1546 -5 0 1546 -4 0 1546 0 1546 -4 0 1546 -2 0 1546 -7 0 1546 -2 0 1546 -5 0 1546 -5 0 1546 -5 0 1546 -9 0 1546 -10 0 1546 -155 0 1546 -3 0 1546 -8 0 1546 -14 0 1546 -221 0 1546 -5 0 1546 -16 0 1546 -5 0 1546 -4 0 1546 0 1546 -4 0 1546 -2 0 1546 -7 0 1546 -2 0 1546 -5 0 1546 -5 0 1546 -5 0 1546 -9 0 1546 -10 0 1546 -143 0 1546 -3 0 1546 -7 0 1546 -3 0 1546 -8 0 1546 -14 0 1546 -221 0 1546 -5 0 1546 -16 0 1546 -5 0 1546 -4 0 1546 0 1546 -4 0 1546 -2 0 1546 -7 0 1546 -2 0 1546 -5 0 1546 -5 0 1546 -5 0 1546 -9 0 1546 -10 0 1546 -143 0 1546 -3 0 1546 -7 0 1546 -3 0 1546 -8 0 1546 -14 0 1546 -304 0 1546 -10 0 1546 -143 0 1546 -3 0 1546 -7 0 1546 -3 0 1546 -8 0 1546 -14 0 1546 -304 0 1546 -10 0 1546 -168 0 1546 -14 0 1546 -304 0 1546 -10 0 1546 -168 0 1546 -14 0 1546 -304 0 1546 -10 0 1546 -168 0 1546 -14 0 1546 -304 0 1546 -10 0 1546 -168 0 1546 -14 0 1546 -304 0 1546 -10 0 1546 -168 0 1546 -14 0 1546 -304 0 1546 -10 0 1546 -168 0 1546 -14 0 1546 -304 0 1546 -10 0 1546 -168 0 1546 -191 0)
    )
    (tilemap
      (solid #t)
      (z-pos 1)
      (width 500)
      (height 35)
      (tiles -8605 0 3041 3042 3043 -965 0 3041 -4 3042 3043 -232 0 3041 -8 3042 3043 -293 0 3041 3042 3043 -1178 0 3041 -3 3042 3043 -245 0 3041 -5 3042 3043 -38 0 3041 -5 3042 3043 -317 0 3041 -2 3042 3043 -365 0 3041 -3 3042 3043 -137 0 3041 -2 3042 3043 -507 0 3041 -2 3042 3043 -437 0 3041 -3 3042 3043 -138 0 3041 -7 3042 3043 -15 0 3041 -7 3042 3043 -12 0 3041 -32 3042 3043 -2060 0 3041 3042 3043 -93 0 3041 3042 3043 -1742 0)
    )
    (tilemap
      (solid #t)
      (z-pos 99)
      (width 500)
      (height 35)
      (tiles -15000 0 2019 2140 2141 2142 2019 2140 2141 2142 2019 2140 2141 2142 2019 2140 2141 2142 2019 2140 2141 2142 2019 2140 2141 2142 2019 2140 2141 2142 2019 2140 2141 2142 2019 2140 2141 2142 2019 2140 2141 2142 2019 2140 2141 2142 2019 2140 2141 2142 2019 2140 2141 2142 2019 2140 2141 2142 2019 2140 2141 2142 2019 2140 2141 2142 2019 2140 2141 2142 2019 2140 2141 2142 2019 2140 2141 2142 2019 2140 2141 2142 2019 2140 2141 2142 2019 2140 2141 2142 2019 2140 2141 2142 2019 2140 2141 2142 2019 2140 2141 2142 2019 2140 2141 2142 2019 2140 2141 2142 2019 2140 2141 2142 2019 2140 2141 2142 2019 2140 2141 2142 2019 2140 2141 2142 2019 2140 2141 2142 2019 2140 2141 2142 2019 2140 2141 2142 2019 2140 2141 2142 2019 2140 2141 2142 2019 2140 2141 2142 2019 2140 2141 2142 2019 2140 2141 2142 2019 2140 2141 2142 2019 2140 2141 2142 2019 2140 2141 2142 2019 2140 2141 2142 2019 2140 2141 2142 2019 2140 2141 2142 2019 2140 2141 2142 2019 2140 2141 2142 2019 2140 2141 2142 2019 2140 2141 2142 2019 2140 2141 2142 2019 2140 2141 2142 2019 2140 2141 2142 2019 2140 2141 2142 2019 2140 2141 2142 2019 2140 2141 2142 2019 2140 2141 2142 2019 2140 2141 2142 2019 2140 2141 2142 2019 2140 2141 2142 2019 2140 2141 2142 2019 2140 2141 2142 2019 2140 2141 2142 2019 2140 2141 2142 2019 2140 2141 2142 2019 2140 2141 2142 2019 2140 2141 2142 2019 2140 2141 2142 2019 2140 2141 2142 2019 2140 2141 2142 2019 2140 2141 2142 2019 2140 2141 2142 2019 2140 2141 2142 2019 2140 2141 2142 2019 2140 2141 2142 2019 2140 2141 2142 2019 2140 2141 2142 2019 2140 2141 2142 2019 2140 2141 2142 2019 2140 2141 2142 2019 2140 2141 2142 2019 2140 2141 2142 2019 2140 2141 2142 2019 2140 2141 2142 2019 2140 2141 2142 2019 2140 2141 2142 2019 2140 2141 2142 2019 2140 2141 2142 2019 2140 2141 2142 2019 2140 2141 2142 2019 2140 2141 2142 2019 2140 2141 2142 2019 2140 2141 2142 2019 2140 2141 2142 2019 2140 2141 2142 2019 2140 2141 2142 2019 2140 2141 2142 2019 2140 2141 2142 2019 2140 2141 2142 2019 2140 2141 2142 2019 2140 2141 2142 2019 2140 2141 2142 2019 2140 2141 2142 2019 2140 2141 2142 2019 2140 2141 2142 2019 2140 2141 2142 2019 2140 2141 2142 2019 2140 2141 2142 2019 2140 2141 2142 2019 2140 2141 2142 2019 2140 2141 2142 2019 2140 2141 2142 2019 2140 2141 2142 2019 2140 2141 2142 2019 2140 2141 2142 2019 2140 2141 2142 2019 2140 2141 2142 2019 2140 2141 2142 2019 2140 2141 2142 2019 2140 2141 2142 2019 2140 2141 2142 2019 2140 2141 2142 2019 2140 2141 2142 2019 2140 2141 2142 2019 2140 2141 2142 2019 2140 2141 2142 -2000 2020)
    )
    (tilemap
      (solid #f)
      (z-pos 101)
      (width 500)
      (height 35)
      (tiles -10497 0 1511 1512 -496 0 1419 0 1513 1514 -496 0 1420 0 1515 1516 -6001 0)
    )
    (torch
      (z-pos 0)
      (x 512)
      (y 768)
    )
    (torch
      (sprite "/images/objects/torch/torch3.sprite")
      (z-pos 0)
      (x 3680)
      (y 768)
    )
    (torch
      (sprite "/images/objects/torch/torch2.sprite")
      (z-pos 0)
      (x 5696)
      (y 768)
    )
    (torch
      (z-pos 0)
      (x 10368)
      (y 512)
    )
    (torch
      (sprite "/images/objects/torch/torch3.sprite")
      (z-pos 0)
      (x 14336)
      (y 704)
    )
    (torch
      (z-pos 0)
      (x 15488)
      (y 704)
    )
  )
)
