(supertux-level
  (version 3)
  (name (_ "Broken Bridge"))
  (author "Sophie \"Vaesea\" Ball")
  (license "CC-BY-SA 4.0 International")
  (target-time 59)
  (allow-item-pocket "inherit")
  (icon "")
  (icon-locked "")
  (statistics
    (enable-coins #t)
    (enable-secrets #t)
  )
  (sector
    (name "main")
    (ambient-light
      (color 0.6 0.6 0.6)
    )
    (background
      (color 1 1 1)
      (alignment "bottom")
      (speed 0.5)
      (image "/images/background/bridgeocean-fade.png")
    )
    (background
      (color 1 1 1)
      (alignment "top")
      (speed 0.5)
      (image "/images/background/bridgecloud-dark.png")
      (z-pos -299)
    )
    (background
      (color 1 1 1)
      (speed 0.25)
      (image-top "/images/background/nightsky_top.png")
      (image "/images/background/nightsky_top.png")
      (image-bottom "/images/background/nightsky_top.png")
      (z-pos -301)
    )
    (background
      (color 1 1 1)
      (speed 0)
      (fill #t)
      (image "/images/background/halloween/vignette.png")
      (z-pos 300)
    )
    (camera
      (name "Camera")
      (mode "normal")
    )
    (decal
      (z-pos -100)
      (sprite "/images/decal/snow/exitbg.png")
      (x 15584)
      (y 672)
    )
    (decal
      (z-pos 100)
      (sprite "/images/decal/snow/exitfg.png")
      (x 15680)
      (y 672)
    )
    (firefly
      (z-pos 0)
      (x 8704)
      (y 832)
    )
    (fish-jumping
      (z-pos 50)
      (x 4128)
      (y 736)
      (glinting #f)
    )
    (fish-jumping
      (z-pos 50)
      (x 4736)
      (y 736)
      (glinting #f)
    )
    (fish-jumping
      (z-pos 50)
      (x 5344)
      (y 736)
      (glinting #f)
    )
    (goldbomb
      (z-pos 50)
      (direction "left")
      (x 10656)
      (y 1056)
      (glinting #t)
    )
    (goldbomb
      (z-pos 50)
      (direction "left")
      (x 11296)
      (y 512)
      (glinting #t)
    )
    (haywire
      (z-pos 50)
      (direction "left")
      (x 10944)
      (y 1056)
      (glinting #f)
    )
    (haywire
      (z-pos 50)
      (direction "left")
      (x 10368)
      (y 1056)
      (glinting #f)
    )
    (jumpy
      (z-pos 50)
      (x 2336)
      (y 768)
      (glinting #f)
    )
    (jumpy
      (z-pos 50)
      (x 6720)
      (y 704)
      (glinting #f)
    )
    (jumpy
      (z-pos 50)
      (x 10720)
      (y 512)
      (glinting #f)
    )
    (jumpy
      (z-pos 50)
      (x 12416)
      (y 288)
      (glinting #f)
    )
    (jumpy
      (z-pos 50)
      (x 13024)
      (y 416)
      (glinting #f)
    )
    (jumpy
      (z-pos 50)
      (x 12832)
      (y 352)
      (glinting #f)
    )
    (mrbomb
      (z-pos 50)
      (direction "left")
      (x 11456)
      (y 352)
      (glinting #f)
    )
    (mrbomb
      (z-pos 50)
      (direction "left")
      (x 11936)
      (y 224)
      (glinting #f)
    )
    (mriceblock
      (z-pos 50)
      (direction "left")
      (x 2656)
      (y 800)
      (glinting #f)
    )
    (mriceblock
      (z-pos 50)
      (direction "left")
      (x 3264)
      (y 800)
      (glinting #f)
    )
    (mriceblock
      (z-pos 50)
      (direction "left")
      (x 4000)
      (y 896)
      (glinting #f)
    )
    (mriceblock
      (z-pos 50)
      (direction "left")
      (x 3808)
      (y 896)
      (glinting #f)
    )
    (mriceblock
      (z-pos 50)
      (direction "left")
      (x 7360)
      (y 736)
      (glinting #f)
    )
    (mriceblock
      (z-pos 50)
      (direction "left")
      (x 13664)
      (y 544)
      (glinting #f)
    )
    (music
      (file "/music/forest/wisphunt.music")
    )
    (particles-rain
    )
    (path
      (name "gen17673114432545377550496")
      (path
        (mode "oneshot")
        (adapt_speed #f)
        (node
          (x 1664)
          (y 832)
        )
      )
    )
    (path
      (name "gen17673114452545377555968")
      (path
        (mode "oneshot")
        (adapt_speed #f)
        (node
          (x 1792)
          (y 800)
        )
      )
    )
    (path
      (name "gen17673114462545377549200")
      (path
        (mode "oneshot")
        (adapt_speed #f)
        (node
          (x 1920)
          (y 832)
        )
      )
    )
    (path
      (name "gen17673114472545377555824")
      (path
        (mode "oneshot")
        (adapt_speed #f)
        (node
          (x 2048)
          (y 864)
        )
      )
    )
    (path
      (name "gen17673114482545377551072")
      (path
        (mode "oneshot")
        (adapt_speed #f)
        (node
          (x 2176)
          (y 832)
        )
      )
    )
    (platform
      (z-pos 50)
      (handle
        (scale_x 0)
        (scale_y 0)
        (offset_x 0)
        (offset_y 0)
      )
      (running #f)
      (path-ref "gen17673114432545377550496")
    )
    (platform
      (z-pos 50)
      (handle
        (scale_x 0)
        (scale_y 0)
        (offset_x 0)
        (offset_y 0)
      )
      (running #f)
      (path-ref "gen17673114452545377555968")
    )
    (platform
      (z-pos 50)
      (handle
        (scale_x 0)
        (scale_y 0)
        (offset_x 0)
        (offset_y 0)
      )
      (running #f)
      (path-ref "gen17673114462545377549200")
    )
    (platform
      (z-pos 50)
      (handle
        (scale_x 0)
        (scale_y 0)
        (offset_x 0)
        (offset_y 0)
      )
      (running #f)
      (path-ref "gen17673114472545377555824")
    )
    (platform
      (z-pos 50)
      (handle
        (scale_x 0)
        (scale_y 0)
        (offset_x 0)
        (offset_y 0)
      )
      (running #f)
      (path-ref "gen17673114482545377551072")
    )
    (secretarea
      (width 352)
      (height 128)
      (x 8864)
      (y 960)
    )
    (sequencetrigger
      (sequence "endsequence")
      (width 32)
      (height 864)
      (x 15264)
      (y 0)
    )
    (sequencetrigger
      (sequence "stoptux")
      (width 64)
      (height 96)
      (x 15872)
      (y 832)
    )
    (smartball
      (z-pos 50)
      (direction "left")
      (x 5920)
      (y 896)
      (glinting #f)
    )
    (smartball
      (z-pos 50)
      (direction "left")
      (x 5760)
      (y 896)
      (glinting #f)
    )
    (smartball
      (z-pos 50)
      (direction "left")
      (x 12032)
      (y 448)
      (glinting #f)
    )
    (smartball
      (z-pos 50)
      (direction "left")
      (x 11616)
      (y 576)
      (glinting #f)
    )
    (smartblock
      (z-pos 50)
      (direction "left")
      (x 3904)
      (y 896)
      (glinting #f)
    )
    (snowball
      (z-pos 50)
      (direction "left")
      (x 7200)
      (y 736)
      (glinting #f)
    )
    (snowball
      (z-pos 50)
      (direction "left")
      (x 7040)
      (y 736)
      (glinting #f)
    )
    (snowball
      (z-pos 50)
      (direction "left")
      (x 11744)
      (y 864)
      (glinting #f)
    )
    (snowball
      (z-pos 50)
      (direction "left")
      (x 12704)
      (y 864)
      (glinting #f)
    )
    (snowball
      (z-pos 50)
      (direction "left")
      (x 12960)
      (y 704)
      (glinting #f)
    )
    (snowball
      (z-pos 50)
      (direction "left")
      (x 13216)
      (y 640)
      (glinting #f)
    )
    (snowman
      (z-pos 50)
      (direction "left")
      (x 4608)
      (y 864)
      (glinting #f)
    )
    (snowman
      (z-pos 50)
      (direction "left")
      (x 5216)
      (y 864)
      (glinting #f)
    )
    (spawnpoint
      (name "main")
      (x 64)
      (y 800)
    )
    (spiky
      (z-pos 50)
      (direction "left")
      (x 1728)
      (y 800)
      (glinting #f)
    )
    (spiky
      (z-pos 50)
      (direction "left")
      (x 10560)
      (y 864)
      (glinting #f)
    )
    (spiky
      (z-pos 50)
      (direction "left")
      (x 10432)
      (y 864)
      (glinting #f)
    )
    (tilemap
      (solid #f)
      (z-pos -100)
      (width 500)
      (height 35)
      (tiles -7347 0 1809 1812 -498 0 1810 1813 -498 0 1811 1814 -1127 0 130 -499 0 129 -499 0 129 -499 0 129 -499 0 129 -58 0 1809 1812 -439 0 129 -58 0 1810 1813 -436 0 1809 1812 0 129 -23 0 108 -34 0 1811 1814 -436 0 1810 1813 0 129 -23 0 111 -192 0 1809 1812 -278 0 1811 1814 0 129 -216 0 1810 1813 -498 0 1811 1814 -3305 0)
    )
    (tilemap
      (solid #f)
      (z-pos 100)
      (width 500)
      (height 35)
      (tiles -9478 0 130 -499 0 129 -499 0 129 -499 0 129 -499 0 129 -499 0 129 -499 0 129 -499 0 129 -499 0 129 -4021 0)
    )
    (tilemap
      (solid #t)
      (z-pos 0)
      (width 500)
      (height 35)
      (tiles -2368 0 83 2947 83 -1512 0 -3 83 -5 0 -3 83 -470 0 1551 1549 -7 1540 1549 1541 -1496 0 -3 83 -6 0 1551 1549 -13 1540 1549 1541 -395 0 83 102 83 -52 0 -2 83 1551 1549 -7 1540 1549 1541 -540 0 1551 1549 1541 -519 0 -2 83 -438 0 83 -4 0 1551 1549 -7 1540 1549 1541 -28 0 1551 1549 1541 -26 0 44 -352 0 1551 1549 -7 1540 1549 1541 -502 0 -4 83 -18 0 -3 83 -18 0 1551 1549 -7 1540 1549 1541 -80 0 44 -396 0 1551 1549 -3 1540 1549 1541 -77 0 3187 1551 -10 1540 1541 -285 0 -2 44 -9 0 -2 44 -133 0 1551 1540 1549 1540 1541 -50 0 3187 1551 -10 1540 1541 -7 0 44 -277 0 44 -2 0 44 0 -2 83 102 -2 83 0 44 -2 0 44 -186 0 3187 1551 1541 3194 -167 0 44 0 44 -208 0 1551 1549 -9 1540 1549 1541 -12 0 1551 1549 -3 1540 1549 1541 -84 0 3187 1551 1540 1541 3194 -18 0 44 -73 0 -2 44 -11 0 -2 44 -60 0 44 -3 0 44 -5 0 83 0 83 0 83 -311 0 3187 1551 -2 1540 1541 3194 -92 0 44 -2 0 44 -2 0 -2 83 102 -2 83 -2 0 44 -2 0 44 -330 0 1551 1549 -7 1540 1549 1541 -38 0 3187 1551 -6 1540 1541 3194 -21 0 44 -192 0 44 0 44 -16 0 44 0 44 -16 0 44 0 44 -19 0 44 0 44 -17 0 3187 1551 -18 1540 1543 1544 1540 1541 -52 0 1551 1549 -3 1540 1549 1541 -24 0 1543 1544 -15 0 1543 1544 -38 0 1543 1544 -5 0 1543 1544 -22 0 3187 1551 -5 1540 1541 3194 -215 0 44 -3 0 44 -14 0 44 -3 0 44 -14 0 44 -3 0 44 -17 0 44 -3 0 44 -15 0 3187 1551 -19 1540 1547 1548 1541 -83 0 1549 1547 1548 -15 0 1547 1548 1549 -36 0 1549 1547 1548 -5 0 1547 1548 1549 -20 0 3187 1551 1541 3194 -94 0 8 9 -27 0 3187 1551 -6 1540 1541 -5 0 1551 -7 1540 1541 -20 0 1551 -10 1540 1541 -5 0 1551 -13 1540 1541 -102 0 3187 1551 1541 3194 -18 0 -2 1546 -83 0 1543 1544 1543 1544 -15 0 1543 1544 1543 1544 -34 0 1543 1544 1543 1544 -5 0 1543 1544 1543 1544 -17 0 3187 1551 1540 1541 3194 -95 0 14 15 1543 1544 -34 1540 1541 -5 0 1551 -5 1540 1541 -21 0 1551 -9 1540 1541 -7 0 1551 -13 1540 1541 -99 0 3187 1551 1540 1541 3194 -19 0 -2 1546 -82 0 1549 1547 1548 1547 1548 0 44 0 44 0 44 0 44 0 44 0 44 0 44 0 1547 1548 1547 1548 1549 -32 0 1549 1547 1548 1547 1548 -5 295 1547 1548 1547 1548 1549 -14 0 3187 1551 -2 1540 1541 3194 -68 0 1551 -27 1540 11 12 1547 1548 -25 1540 1541 3194 -72 0 1551 1540 1541 -96 0 3187 1551 -2 1540 1541 3194 -20 0 -2 1546 -38 0 1551 -6 1540 1543 1544 -69 1540 1541 -5 0 1551 -47 1540 1541 3194 -70 0 1551 -27 1540 11 12 -2 1546 1542 1551 1541 -97 0 1551 -21 1540 1541 -5 0 1551 -12 1540 1541 -5 0 1551 -5 1540 1543 1544 -5 1540 1541 -5 0 1551 -15 1540 1541 -5 0 1551 -11 1540 1541 3194 -22 0 -2 1546 -10 0 -3 44 -17 0 -3 44 -6 0 1551 -5 1540 1547 1548 -68 1540 1541 -7 0 1551 -44 1540 1541 3194 -34 0 -3 44 -17 0 -3 44 -43 0 11 12 -3 1546 1545 -99 0 1551 -19 1540 1541 -7 0 1551 -12 1540 1541 -5 0 1551 -4 1540 1547 1548 -4 1540 1541 -5 0 1551 -15 1540 1541 -5 0 1551 -10 1540 1541 3194 -24 0 -2 1546 -10 0 1551 1540 1541 -7 0 -3 44 -7 0 1551 1540 1541 -12 0 -2 1546 -4 0 2947 128 2947 -64 0 1551 1540 1541 -83 0 1551 1540 1541 -7 0 -3 44 -7 0 1551 1540 1541 -7 0 -3 44 -33 0 11 12 -2 1546 1550 -152 0 -2 1546 -69 0 -2 1546 -20 0 1551 1540 1541 -22 0 -2 1546 -167 0 1551 1540 1541 -17 0 1551 1540 1541 -33 0 11 12 -2 1546 -153 0 -2 1546 -69 0 -2 1546 -45 0 -2 1546 -223 0 11 12 -2 1546 -153 0 -2 1546 -69 0 -2 1546 -45 0 -2 1546 -223 0 11 12 -2 1546 -153 0 -2 1546 -69 0 -2 1546 -45 0 -2 1546 1543 1544 -73 2144 1543 1544 -146 0)
    )
    (tilemap
      (solid #t)
      (z-pos 99)
      (width 500)
      (height 35)
      (tiles -15000 0 2019 2140 2141 2142 2019 2140 2141 2142 2019 2140 2141 2142 2019 2140 2141 2142 2019 2140 2141 2142 2019 2140 2141 2142 2019 2140 2141 2142 2019 2140 2141 2142 2019 2140 2141 2142 2019 2140 2141 2142 2019 2140 2141 2142 2019 2140 2141 2142 2019 2140 2141 2142 2019 2140 2141 2142 2019 2140 2141 2142 2019 2140 2141 2142 2019 2140 2141 2142 2019 2140 2141 2142 2019 2140 2141 2142 2019 2140 2141 2142 2019 2140 2141 2142 2019 2140 2141 2142 2019 2140 2141 2142 2019 2140 2141 2142 2019 2140 2141 2142 2019 2140 2141 2142 2019 2140 2141 2142 2019 2140 2141 2142 2019 2140 2141 2142 2019 2140 2141 2142 2019 2140 2141 2142 2019 2140 2141 2142 2019 2140 2141 2142 2019 2140 2141 2142 2019 2140 2141 2142 2019 2140 2141 2142 2019 2140 2141 2142 2019 2140 2141 2142 2019 2140 2141 2142 2019 2140 2141 2142 2019 2140 2141 2142 2019 2140 2141 2142 2019 2140 2141 2142 2019 2140 2141 2142 2019 2140 2141 2142 2019 2140 2141 2142 2019 2140 2141 2142 2019 2140 2141 2142 2019 2140 2141 2142 2019 2140 2141 2142 2019 2140 2141 2142 2019 2140 2141 2142 2019 2140 2141 2142 2019 2140 2141 2142 2019 2140 2141 2142 2019 2140 2141 2142 2019 2140 2141 2142 2019 2140 2141 2142 2019 2140 2141 2142 2019 2140 2141 2142 2019 2140 2141 2142 2019 2140 2141 2142 2019 2140 2141 2142 2019 2140 2141 2142 2019 2140 2141 2142 2019 2140 2141 2142 2019 2140 2141 2142 2019 2140 2141 2142 2019 2140 2141 2142 2019 2140 2141 2142 2019 2140 2141 2142 2019 2140 2141 2142 2019 2140 2141 2142 2019 2140 2141 2142 2019 2140 2141 2142 2019 2140 2141 2142 2019 2140 2141 2142 2019 2140 2141 2142 2019 2140 2141 2142 2019 2140 2141 2142 2019 2140 2141 2142 2019 2140 2141 2142 2019 2140 2141 2142 2019 2140 2141 2142 2019 2140 2141 2142 2019 2140 2141 2142 2019 2140 2141 2142 2019 2140 2141 2142 2019 2140 2141 2142 2019 2140 2141 2142 2019 2140 2141 2142 2019 2140 2141 2142 2019 2140 2141 2142 2019 2140 2141 2142 2019 2140 2141 2142 2019 2140 2141 2142 2019 2140 2141 2142 2019 2140 2141 2142 2019 2140 2141 2142 2019 2140 2141 2142 2019 2140 2141 2142 2019 2140 2141 2142 2019 2140 2141 2142 2019 2140 2141 2142 2019 2140 2141 2142 2019 2140 2141 2142 2019 2140 2141 2142 2019 2140 2141 2142 2019 2140 2141 2142 2019 2140 2141 2142 2019 2140 2141 2142 2019 2140 2141 2142 2019 2140 2141 2142 2019 2140 2141 2142 2019 2140 2141 2142 2019 2140 2141 2142 2019 2140 2141 2142 2019 2140 2141 2142 2019 2140 2141 2142 2019 2140 2141 2142 2019 2140 2141 2142 2019 2140 2141 2142 2019 2140 2141 2142 2019 2140 2141 2142 2019 2140 2141 2142 -2000 2020)
    )
    (tilemap
      (solid #f)
      (tint 0.5 0.5 0.5)
      (z-pos -50)
      (width 500)
      (height 35)
      (tiles -4865 0 1546 -7 0 1546 -491 0 1546 -7 0 1546 -491 0 1546 -7 0 1546 -491 0 1546 -7 0 1546 -7 0 1546 -13 0 1546 -454 0 1546 -7 0 1546 -6 0 1546 -7 0 1546 -7 0 1546 -13 0 1546 -454 0 1546 -7 0 1546 -6 0 1546 -7 0 1546 -7 0 1546 -13 0 1546 -5 0 1546 -448 0 1546 -7 0 1546 -6 0 1546 -15 0 1546 -13 0 1546 -5 0 1546 -448 0 1546 -7 0 1546 -6 0 1546 -2 0 1546 -7 0 1546 -4 0 1546 -13 0 1546 -5 0 1546 -5 0 1546 -381 0 1546 -7 0 1546 -60 0 1546 -6 0 1546 -2 0 1546 -7 0 1546 -4 0 1546 -13 0 1546 -5 0 1546 -5 0 1546 -381 0 1546 -7 0 1546 -47 0 1546 -7 0 1546 -4 0 1546 -6 0 1546 -2 0 1546 -7 0 1546 -4 0 1546 -13 0 1546 -5 0 1546 -5 0 1546 -381 0 1546 -7 0 1546 -35 0 1546 -3 0 1546 -7 0 1546 -7 0 1546 -4 0 1546 -6 0 1546 -2 0 1546 -7 0 1546 -4 0 1546 -13 0 1546 -5 0 1546 -5 0 1546 -381 0 1546 -7 0 1546 -35 0 1546 -3 0 1546 -7 0 1546 -7 0 1546 -4 0 1546 -3 0 1546 -2 0 1546 -2 0 1546 -7 0 1546 -4 0 1546 -13 0 1546 -5 0 1546 -5 0 1546 -381 0 1546 -43 0 1546 -3 0 1546 -7 0 1546 -7 0 1546 -4 0 1546 -3 0 1546 -2 0 1546 -2 0 1546 -7 0 1546 -4 0 1546 -13 0 1546 -5 0 1546 -5 0 1546 -381 0 1546 -7 0 1546 -9 0 1546 -14 0 1546 -3 0 1546 -6 0 1546 -3 0 1546 -7 0 1546 -7 0 1546 -4 0 1546 -3 0 1546 -2 0 1546 -2 0 1546 -7 0 1546 -4 0 1546 -13 0 1546 -5 0 1546 -5 0 1546 -381 0 1546 -7 0 1546 -9 0 1546 -14 0 1546 -3 0 1546 -6 0 1546 -3 0 1546 -7 0 1546 -7 0 1546 -14 0 1546 -7 0 1546 -4 0 1546 -13 0 1546 -5 0 1546 -395 0 1546 -9 0 1546 -14 0 1546 -3 0 1546 -10 0 1546 -7 0 1546 -7 0 1546 -2 0 1546 -7 0 1546 -3 0 1546 -7 0 1546 -4 0 1546 -13 0 1546 -5 0 1546 -383 0 1546 -3 0 1546 -7 0 1546 -9 0 1546 -14 0 1546 -3 0 1546 -10 0 1546 -7 0 1546 -7 0 1546 -2 0 1546 -7 0 1546 -3 0 1546 -7 0 1546 -18 0 1546 -5 0 1546 -383 0 1546 -3 0 1546 -7 0 1546 -9 0 1546 -14 0 1546 -3 0 1546 -10 0 1546 -7 0 1546 -7 0 1546 -2 0 1546 -7 0 1546 -3 0 1546 -7 0 1546 -18 0 1546 -389 0 1546 -3 0 1546 -7 0 1546 -9 0 1546 -14 0 1546 -3 0 1546 -10 0 1546 -7 0 1546 -7 0 1546 -2 0 1546 -7 0 1546 -3 0 1546 -7 0 1546 -18 0 1546 -3604 0)
    )
    (torch
      (z-pos 0)
      (x 192)
      (y 768)
    )
    (torch
      (sprite "/images/objects/torch/torch2.sprite")
      (z-pos 0)
      (x 4224)
      (y 832)
    )
    (torch
      (sprite "/images/objects/torch/torch2.sprite")
      (z-pos 0)
      (x 8576)
      (y 800)
    )
    (torch
      (sprite "/images/objects/torch/torch3.sprite")
      (z-pos 0)
      (x 11168)
      (y 864)
    )
    (torch
      (z-pos 0)
      (x 13696)
      (y 480)
    )
    (torch
      (sprite "/images/objects/torch/torch2.sprite")
      (z-pos 0)
      (x 15520)
      (y 768)
    )
    (torch
      (z-pos 0)
      (x 15936)
      (y 768)
    )
  )
)
