(supertux-level
  (version 3)
  (name (_ "Can't Go Under It"))
  (author "Sophie \"Vaesea\" Ball")
  (license "CC-BY-SA 4.0 International")
  (target-time 85)
  (allow-item-pocket "inherit")
  (icon "")
  (icon-locked "")
  (statistics
    (enable-coins #t)
    (enable-secrets #t)
  )
  (sector
    (name "main")
    (ambient-light
      (color 1 1 1)
    )
    (background
      (color 1 1 1)
      (alignment "bottom")
      (speed 0.25)
      (image "/images/background/arcticskies1.png")
    )
    (background
      (scroll-offset-x 797)
      (scroll-offset-y 682)
      (color 1 1 1)
      (alignment "bottom")
      (speed 0.5)
      (image "/images/background/arcticskies2.png")
      (z-pos -299)
    )
    (background
      (scroll-offset-x 791)
      (scroll-offset-y 548)
      (color 1 1 1)
      (speed 1.25)
      (image-top "/images/background/fog.png")
      (image "/images/background/fog.png")
      (image-bottom "/images/background/fog.png")
      (z-pos 300)
    )
    (bonusblock
      (z-pos 51)
      (count 3)
      (sprite "/images/objects/bonus_block/orangeblock.sprite")
      (x 5440)
      (y 416)
    )
    (camera
      (name "Camera")
      (mode "normal")
    )
    (decal
      (z-pos -100)
      (sprite "/images/decal/snow/exitbg.png")
      (x 15584)
      (y 672)
    )
    (decal
      (z-pos 100)
      (sprite "/images/decal/snow/exitfg.png")
      (x 15680)
      (y 672)
    )
    (firefly
      (z-pos 0)
      (x 6528)
      (y 416)
    )
    (flyingsnowball
      (z-pos 50)
      (x 11840)
      (y 512)
      (glinting #f)
    )
    (flyingsnowball
      (z-pos 50)
      (x 14144)
      (y 576)
      (glinting #f)
    )
    (flyingsnowball
      (z-pos 50)
      (x 7984)
      (y 448)
      (glinting #f)
    )
    (flyingsnowball
      (z-pos 50)
      (x 7600)
      (y 416)
      (glinting #f)
    )
    (haywire
      (z-pos 50)
      (direction "left")
      (x 5536)
      (y 768)
      (glinting #f)
    )
    (jumpy
      (z-pos 50)
      (x 1824)
      (y 704)
      (glinting #f)
    )
    (jumpy
      (z-pos 50)
      (x 3168)
      (y 480)
      (glinting #f)
    )
    (jumpy
      (z-pos 50)
      (x 9184)
      (y 480)
      (glinting #f)
    )
    (jumpy
      (z-pos 50)
      (x 11104)
      (y 448)
      (glinting #f)
    )
    (jumpy
      (z-pos 50)
      (x 12352)
      (y 608)
      (glinting #f)
    )
    (jumpy
      (z-pos 50)
      (x 12640)
      (y 608)
      (glinting #f)
    )
    (jumpy
      (z-pos 50)
      (x 12704)
      (y 608)
      (glinting #f)
    )
    (jumpy
      (z-pos 50)
      (x 12960)
      (y 608)
      (glinting #f)
    )
    (jumpy
      (z-pos 50)
      (x 12992)
      (y 608)
      (glinting #f)
    )
    (jumpy
      (z-pos 50)
      (x 13024)
      (y 608)
      (glinting #f)
    )
    (jumpy
      (z-pos 50)
      (x 13344)
      (y 608)
      (glinting #f)
    )
    (jumpy
      (z-pos 50)
      (x 13280)
      (y 608)
      (glinting #f)
    )
    (jumpy
      (z-pos 50)
      (x 13632)
      (y 608)
      (glinting #f)
    )
    (jumpy
      (z-pos 50)
      (x 14464)
      (y 768)
      (glinting #f)
    )
    (jumpy
      (z-pos 50)
      (x 9664)
      (y 352)
      (glinting #f)
    )
    (mriceblock
      (z-pos 50)
      (direction "left")
      (x 992)
      (y 864)
      (glinting #f)
    )
    (mriceblock
      (z-pos 50)
      (direction "left")
      (x 5408)
      (y 768)
      (glinting #f)
    )
    (mriceblock
      (z-pos 50)
      (direction "left")
      (x 5280)
      (y 768)
      (glinting #f)
    )
    (music
      (file "/music/antarctic/airship_remix.music")
    )
    (particles-clouds
    )
    (particles-snow
    )
    (path
      (name "gen17670315482185786064352")
      (path
        (mode "pingpong")
        (adapt_speed #f)
        (node
          (x 5536)
          (y 544)
          (time 8)
        )
        (node
          (x 6304)
          (y 480)
          (time 8)
        )
      )
    )
    (path
      (name "gen17670333012185786081776")
      (path
        (mode "pingpong")
        (adapt_speed #f)
        (node
          (x 9856)
          (y 416)
          (time 7)
        )
        (node
          (x 10816)
          (y 512)
          (time 7)
        )
      )
    )
    (platform
      (z-pos 50)
      (handle
        (scale_x 0)
        (scale_y 0)
        (offset_x 0)
        (offset_y 0)
      )
      (running #f)
      (name "platform")
      (path-ref "gen17670315482185786064352")
    )
    (platform
      (z-pos 50)
      (handle
        (scale_x 0)
        (scale_y 0)
        (offset_x 0)
        (offset_y 0)
      )
      (running #f)
      (name "platform2")
      (path-ref "gen17670333012185786081776")
    )
    (sequencetrigger
      (sequence "endsequence")
      (width 32)
      (height 288)
      (x 15072)
      (y 416)
    )
    (sequencetrigger
      (sequence "stoptux")
      (width 64)
      (height 480)
      (x 15872)
      (y 480)
    )
    (smartball
      (z-pos 50)
      (direction "left")
      (x 1280)
      (y 448)
      (glinting #f)
    )
    (smartball
      (z-pos 50)
      (direction "left")
      (x 5152)
      (y 768)
      (glinting #f)
    )
    (smartball
      (z-pos 50)
      (direction "left")
      (x 11680)
      (y 544)
      (glinting #f)
    )
    (smartball
      (z-pos 50)
      (direction "left")
      (x 9312)
      (y 256)
      (glinting #f)
    )
    (smartball
      (z-pos 50)
      (direction "left")
      (x 8832)
      (y 576)
      (glinting #f)
    )
    (spawnpoint
      (name "main")
      (x 64)
      (y 832)
    )
    (spiky
      (z-pos 50)
      (direction "left")
      (x 3232)
      (y 768)
      (glinting #f)
    )
    (spiky
      (z-pos 50)
      (direction "left")
      (x 3168)
      (y 768)
      (glinting #f)
    )
    (sspiky
      (z-pos 50)
      (direction "right")
      (x 4304)
      (y 960)
      (glinting #f)
    )
    (sspiky
      (z-pos 50)
      (direction "left")
      (x 4192)
      (y 576)
      (glinting #f)
    )
    (switch
      (z-pos 1)
      (script "platform.start_moving();")
      (sprite "/images/objects/switch/switch.sprite")
      (x 4132)
      (y 896)
    )
    (switch
      (z-pos 1)
      (script "platform2.start_moving();")
      (sprite "/images/objects/switch/switch.sprite")
      (x 9060)
      (y 160)
    )
    (tilemap
      (solid #f)
      (z-pos -100)
      (width 500)
      (height 35)
      (tiles -283 0 2162 -499 0 2162 -499 0 2162 -499 0 2162 -499 0 2162 -499 0 2162 -499 0 2162 -499 0 2162 -5 0 106 107 108 -491 0 2162 -5 0 109 110 111 -2421 0 106 107 108 -2 0 141 142 -250 0 130 -242 0 109 110 111 -2 0 143 144 -250 0 129 -499 0 129 -128 0 2162 -370 0 129 -409 0 106 107 108 -47 0 106 107 108 -34 0 122 123 0 129 -124 0 2052 2056 2060 2061 2060 2061 2058 2055 2054 -276 0 109 110 111 -47 0 109 110 111 -34 0 124 125 0 129 -124 0 2057 2058 2065 2066 2065 2066 2060 2061 2059 -363 0 124 125 0 129 -123 0 2052 2056 2066 2060 2061 2060 2061 2065 2066 2055 2054 -120 0 122 123 -240 0 124 125 0 129 -69 0 7 9 -3 0 7 9 -46 0 2052 2056 2060 2061 2065 2066 2065 2066 2060 2061 2060 2055 2054 -119 0 124 125 -32 0 122 123 -203 0 25 0 24 124 125 0 129 -122 0 2057 2058 2065 2066 2058 2066 2058 2066 2065 2066 2060 2061 2059 -119 0 124 125 -32 0 124 125 -183 0 122 123 -141 0 106 107 108 -2 0 2052 2056 2060 2061 2060 2061 2060 2061 2060 2061 2060 2065 2066 2055 2054 -48 0 106 107 108 -67 0 124 125 -32 0 124 125 -183 0 124 125 -38 0 122 123 -101 0 109 110 111 0 2052 2056 2058 2065 2066 2065 2066 2065 2066 2065 2066 2065 2066 2060 2061 2055 2054 -47 0 109 110 111 -67 0 124 125 -32 0 124 125 -31 0 122 123 -150 0 124 125 0 106 107 108 -34 0 124 125 -16 0 122 123 -114 0 2162 -10 0 2162 -10 0 2162 -84 0 124 125 -32 0 124 125 -31 0 124 125 -147 0 24 25 0 124 125 0 109 110 111 -3 0 24 -30 0 124 125 -12 0 106 -2 107 108 124 125 -22 0 106 107 108 -196 0 124 125 -32 0 124 125 -31 0 124 125 -190 0 124 125 -12 0 109 -2 110 111 124 125 -3 0 25 -18 0 109 110 111 -55 0 122 123 -43 0 2162 0 122 123 -92 0 124 125 -32 0 124 125 -31 0 124 125 -18 0 122 123 -42 0 122 123 -155 0 25 -2 0 122 123 -66 0 124 125 -43 0 2162 0 124 125 -9 0 122 123 -33 0 122 123 -46 0 124 125 -32 0 124 125 -31 0 124 125 -18 0 124 125 -21 0 122 123 -19 0 124 125 -158 0 124 125 -66 0 124 125 -36 0 122 123 -5 0 2162 0 124 125 -9 0 124 125 -33 0 124 125 -46 0 124 125 -32 0 124 125 -31 0 124 125 -18 0 124 125 -21 0 124 125 -19 0 124 125 -33 0 122 123 -123 0 124 125 -19 0 122 123 -32 0 122 123 -11 0 124 125 -36 0 124 125 -7 0 124 125 -9 0 124 125 -8 0 122 123 -23 0 124 125 -46 0 124 125 -32 0 124 125 -31 0 124 125 -18 0 124 125 -21 0 124 125 -19 0 124 125 -33 0 124 125 -123 0 124 125 -19 0 124 125 -32 0 124 125 -11 0 124 125 -36 0 124 125 -7 0 124 125 -9 0 124 125 -8 0 124 125 -23 0 124 125 -46 0 124 125 -32 0 124 125 -31 0 124 125 -18 0 124 125 -21 0 124 125 -19 0 124 125 -33 0 124 125 -36 0 122 123 -85 0 124 125 -19 0 124 125 -32 0 124 125 -11 0 124 125 -36 0 124 125 -7 0 124 125 -9 0 124 125 -8 0 124 125 -23 0 124 125 -46 0 124 125 -32 0 124 125 -31 0 124 125 -18 0 124 125 -21 0 124 125 -19 0 124 125 -33 0 124 125 -36 0 124 125 -85 0 124 125 -19 0 124 125 -32 0 124 125 -11 0 124 125 -36 0 124 125 -7 0 124 125 -9 0 124 125 -8 0 124 125 -23 0 124 125 -46 0 124 125 -32 0 124 125 -31 0 124 125 -18 0 124 125 -21 0 124 125 -19 0 124 125 -33 0 124 125 -36 0 124 125 -85 0 124 125 -19 0 124 125 -32 0 124 125 -11 0 124 125 -36 0 124 125 -7 0 124 125 -9 0 124 125 -8 0 124 125 -23 0 124 125 -46 0 124 125 -32 0 124 125 -31 0 124 125 -18 0 124 125 -21 0 124 125 -19 0 124 125 -33 0 124 125 -36 0 124 125 -69 0)
    )
    (tilemap
      (solid #f)
      (z-pos 100)
      (width 500)
      (height 35)
      (tiles -6972 0 130 -499 0 129 -499 0 129 -499 0 129 -499 0 129 -499 0 129 -499 0 129 -499 0 129 -499 0 129 -6527 0)
    )
    (tilemap
      (solid #t)
      (z-pos 0)
      (width 500)
      (height 35)
      (tiles -445 0 10 -2 11 19 -10 11 19 -6 11 19 -10 11 19 -7 11 19 -10 11 19 -3 11 -445 0 10 -5 11 19 -17 11 19 -18 11 19 -10 11 19 -445 0 10 19 -53 11 -445 0 10 -9 11 19 -17 11 19 -7 11 19 -10 11 19 -7 11 -445 0 10 -3 11 19 -14 11 19 -2 11 19 -18 11 19 -13 11 -99 0 2947 -345 0 10 -10 11 19 -37 11 19 -5 11 -445 0 10 -31 11 -2 19 -10 11 19 -10 11 -445 0 10 11 19 -12 11 19 11 19 -8 11 19 -9 11 19 -16 11 19 11 -445 0 10 -4 11 19 -3 11 19 -10 11 19 -26 11 19 -7 11 -97 0 2155 2156 2164 2156 2157 -180 0 2155 -4 2156 2164 -4 2156 2157 -152 0 10 -39 11 19 -14 11 -99 0 2162 -112 0 -2 44 -73 0 2162 -157 0 10 -8 11 19 -14 11 19 -9 11 19 11 19 -10 11 19 -7 11 -37 0 83 3161 83 -59 0 2162 -108 0 -2 83 0 44 -2 0 44 0 3161 83 -69 0 2162 -157 0 10 -2 11 19 -14 11 19 -20 11 19 -4 11 19 -10 11 -99 0 2162 -187 0 2162 -157 0 10 19 -45 11 19 -7 11 -88 0 2155 2156 2164 2156 2157 -6 0 2162 -6 0 2155 2156 2164 2156 2157 -40 0 -3 83 -15 0 83 0 83 -115 0 2162 -9 0 2155 -4 2156 2164 -4 2156 2157 -137 0 10 -5 11 2929 2930 -20 17 2925 2926 -13 11 19 -11 11 -90 0 2162 -8 0 2162 -8 0 2162 -109 0 7 9 -67 0 2162 -14 0 2162 -142 0 10 11 19 11 2929 2930 2931 -22 0 2928 2925 2926 -5 11 19 -13 11 19 -3 11 -35 0 2155 -2 2156 2164 -2 2156 2157 -48 0 2162 -8 0 2162 -8 0 2162 -92 0 2155 -8 2156 2164 -8 2156 2157 -67 0 2162 -14 0 2162 -98 0 3161 -9 0 83 -33 0 10 11 2929 2930 2931 -26 0 2928 2925 2926 -11 11 19 -9 11 -38 0 2162 -51 0 2162 -5 0 2067 -5 2068 2069 -5 0 2162 -6 0 2155 -2 2156 2164 -2 2156 2157 -88 0 2162 -20 0 2163 -55 0 2162 -14 0 2162 -39 0 2155 -4 2156 2164 -4 2156 2157 -92 0 16 17 2931 -30 0 2928 2925 2926 -19 11 -38 0 2162 -51 0 2162 -5 0 2072 -5 2073 2074 -5 0 2162 -9 0 2162 -31 0 2155 2156 2164 2156 2157 -13 0 2155 2156 2164 2156 2157 -37 0 2162 -20 0 2162 -11 0 2163 -38 0 2155 -4 2156 2164 -4 2156 2157 -9 0 2162 -44 0 2162 -132 0 2928 2925 2926 -17 11 -38 0 2162 -7 0 2155 2156 2164 2156 2157 -39 0 2162 -17 0 2162 -9 0 2162 -33 0 2162 -17 0 2162 -39 0 2162 -20 0 2162 -11 0 2162 -11 0 2163 -31 0 2162 -14 0 2162 -44 0 2162 -12 0 2155 -2 2156 2164 -2 2156 2157 -115 0 2928 -17 17 -38 0 2162 -9 0 2162 -41 0 2162 -17 0 2162 -9 0 2162 -7 0 2155 -2 2156 2164 -2 2156 2157 -19 0 2162 -17 0 2162 -39 0 2162 -20 0 2162 -11 0 2162 -11 0 2162 -11 0 2155 -4 2156 2164 -4 2156 2157 -9 0 2162 -14 0 2162 -44 0 2162 -15 0 2162 -15 0 2155 2156 2164 2156 2157 -5 0 2155 2156 2164 2156 2157 -5 0 2155 2156 2164 2156 2157 -5 0 2155 2156 2164 2156 2157 -5 0 2155 2156 2164 2156 2157 -5 0 2155 2156 2164 2156 2157 -104 0 2162 -9 0 2162 -41 0 2162 -17 0 2162 -9 0 2162 -10 0 2162 -22 0 2162 -17 0 2162 -39 0 2162 -20 0 2162 -11 0 2162 -11 0 2162 -16 0 2162 -14 0 2162 -14 0 2162 -44 0 2162 -15 0 2162 -10 0 2155 2156 2164 2156 2157 -2 0 2162 -9 0 2162 -9 0 2162 -9 0 2162 -9 0 2162 -9 0 2162 -6 0 7 9 -98 0 2162 -2 0 -5 44 -2 0 2162 -18 0 2155 2164 2157 -20 0 2162 -2 0 27 -3 28 29 -3 0 27 -3 28 29 -2 0 2162 -9 0 2162 -10 0 2162 -22 0 2162 -5 0 83 2155 2156 2164 2156 2157 83 -5 0 2162 -39 0 2162 -20 0 2162 -11 0 2162 -11 0 2162 -16 0 2162 -14 0 2162 -14 0 2162 -44 0 2162 -15 0 2162 -12 0 2162 -4 0 2162 -2 0 2155 2156 2164 2156 2157 -2 0 2162 -2 0 2155 2156 2164 2156 2157 -2 0 2162 -2 0 2155 2156 2164 2156 2157 -2 0 2162 -2 0 2155 2156 2164 2156 2157 -2 0 2162 -2 0 2155 2156 2164 2156 2157 -2 0 2162 -6 0 13 15 -21 0 2909 2910 -9 8 2913 2914 -64 0 2162 0 27 29 -3 83 27 29 0 2162 -19 0 2162 -21 0 2162 -4 0 211 -7 0 211 -4 0 2162 -9 0 2162 -10 0 2162 -7 0 2155 -2 2156 2164 -2 2156 2157 -8 0 2162 -8 0 2162 -8 0 2162 -39 0 2162 -20 0 2162 -11 0 2162 -11 0 2162 -16 0 2162 -14 0 2162 -14 0 2162 -44 0 2162 -15 0 2162 -12 0 2162 -4 0 2162 -4 0 2162 -4 0 2162 -4 0 2162 -4 0 2162 -4 0 2162 -4 0 2162 -4 0 2162 -4 0 2162 -4 0 2162 -4 0 2162 -6 0 10 12 -19 0 3141 3142 2911 2912 -9 14 2915 2916 1832 1827 -62 0 2162 -9 0 2162 -19 0 2162 -21 0 2162 -4 0 212 -7 0 212 -4 0 2162 -9 0 2162 -10 0 2162 -10 0 2162 -11 0 2162 -8 0 2162 -8 0 2162 -39 0 2162 -20 0 2162 -11 0 2162 -11 0 2162 -16 0 2162 -14 0 2162 -14 0 2162 -44 0 2162 -15 0 2162 -12 0 2162 -4 0 2162 -4 0 2162 -4 0 2162 -4 0 2162 -4 0 2162 -4 0 2162 -4 0 2162 -4 0 2162 -4 0 2162 -4 0 2162 -4 0 2162 -6 0 10 12 -18 0 3150 3145 3146 1834 -5 11 19 -5 11 1835 1836 1831 1832 1827 -47 0 -3 44 -10 0 2162 -9 0 2162 -5 0 2155 -2 2156 2164 -2 2156 2157 -7 0 2162 -21 0 2162 -4 0 213 -7 0 213 -4 0 2162 -9 0 2162 -10 0 2162 -10 0 2162 -11 0 2162 -8 0 2162 -8 0 2162 -39 0 2162 -20 0 2162 -11 0 2162 -11 0 2162 -16 0 2162 -14 0 2162 -14 0 2162 -44 0 2162 -15 0 2162 -12 0 2162 -4 0 2162 -4 0 2162 -4 0 2162 -4 0 2162 -4 0 2162 -4 0 2162 -4 0 2162 -4 0 2162 -4 0 2162 -4 0 2162 -4 0 2162 -6 0 10 12 -17 0 3153 3154 3148 11 2929 2930 -10 17 2925 2926 1835 1836 1831 1832 1827 -58 0 2162 -9 0 2162 -8 0 2162 -7 0 2155 -2 2156 2164 -2 2156 2157 -15 0 2155 -11 2156 2164 -11 2156 2157 -3 0 -29 2178 -4 0 2155 -12 2156 2164 -12 2156 2157 -35 0 2162 -20 0 2162 -11 0 2162 -11 0 2162 -16 0 2162 -14 0 2162 -14 0 2162 -44 0 2162 -15 0 2162 -12 0 2162 -4 0 2162 -4 0 2162 -4 0 2162 -4 0 2162 -4 0 2162 -4 0 2162 -4 0 2162 -4 0 2162 -4 0 2162 -4 0 2162 -4 0 2162 -6 0 10 12 7 -14 8 2921 2922 3157 3158 11 2935 2931 -12 0 2928 2925 2926 1835 1836 1831 1832 1827 -55 0 2155 -5 2156 2164 -5 2156 2157 -7 0 2162 -10 0 2162 -7 0 2155 -2 2156 2164 -2 2156 2157 -16 0 2162 -15 0 2155 -2 2156 2164 -10 2156 2164 -10 2156 2164 -2 2156 2157 -17 0 2162 -48 0 2162 -20 0 2162 -11 0 2162 -11 0 2162 -16 0 2162 -14 0 2162 -14 0 2162 -44 0 2162 -15 0 2162 -12 0 2162 -4 0 2162 -4 0 2162 -4 0 2162 -4 0 2162 -4 0 2162 -4 0 2162 -4 0 2162 -4 0 2162 -4 0 2162 -4 0 2162 -4 0 2162 -6 0 10 12 13 -14 14 2923 2924 1834 2929 2930 2936 -15 0 2928 2925 2926 1835 1836 1831 2917 2918 -26 8 2913 2914 -31 0 2162 -13 0 2162 -10 0 2162 -10 0 2162 -19 0 2162 -18 0 2162 -21 0 2162 -6 0 -2 48 -12 0 2162 -48 0 2162 -20 0 2162 -11 0 2162 -11 0 2162 -16 0 2162 -14 0 2162 -14 0 2162 -44 0 2162 -15 0 2162 -12 0 2162 -4 0 2162 -4 0 2162 -4 0 2162 -4 0 2162 -4 0 2162 -4 0 2162 -4 0 2162 -4 0 2162 -4 0 2162 -4 0 2162 -4 0 2162 -6 0 10 12 10 19 -14 11 2929 2930 2931 -19 0 2928 2925 2926 1835 2919 2920 -26 14 2915 2916 2917 2918 9 -5 0 2155 -5 2156 2164 -5 2156 2157 -10 0 2162 -13 0 2162 -10 0 2162 -10 0 2162 -19 0 2162 -18 0 2162 -21 0 2162 -5 0 -2 48 -13 0 2162 -48 0 2162 -20 0 2162 -11 0 2162 -11 0 2162 -16 0 2162 -14 0 2162 -14 0 2162 -44 0 2162 -15 0 2162 -12 0 2162 -4 0 2162 -4 0 2162 -4 0 2162 -4 0 2162 -4 0 2162 -4 0 2162 -4 0 2162 -4 0 2162 -4 0 2162 -4 0 2162 -4 0 2162 -6 0 10 12 10 2929 2930 -13 17 2931 -23 0 2928 2925 2926 -3 11 19 -11 11 19 -12 11 1835 2919 2920 15 -11 0 2162 -16 0 2162 -13 0 2162 -10 0 2162 -10 0 2162 -19 0 2162 -18 0 2162 -21 0 2162 -4 0 -2 48 -14 0 2162 -48 0 2162 -20 0 2162 -11 0 2162 -11 0 2162 -16 0 2162 -14 0 2162 -14 0 2162 -44 0 2162 -15 0 2162 -12 0 2162 -4 0 2162 -4 0 2162 -4 0 2162 -4 0 2162 -4 0 2162 -4 0 2162 -4 0 2162 -4 0 2162 -4 0 2162 -4 0 2162 -4 0 2162 -6 0 10 12 16 2931 -40 0 2928 -7 17 2925 2926 -9 11 19 -10 11 19 11 12 -11 0 2162 -16 0 2162 -13 0 2162 -10 0 2162 -10 0 2162 -19 0 2162 -18 0 2162 -10 0 2162 -10 0 2162 -20 0 2162 -48 0 2162 -20 0 2162 -11 0 2162 -11 0 2162 -16 0 2162 -14 0 2162 -14 0 2162 -44 0 2162 -15 0 2162 -12 0 2162 -4 0 2162 -4 0 2162 -4 0 2162 -4 0 2162 -4 0 2162 -4 0 2162 -4 0 2162 -4 0 2162 -4 0 2162 -4 0 2162 -4 0 2162 -6 0 10 12 -51 0 2928 2925 2926 19 -9 11 19 -9 11 12 -11 0 2162 -16 0 2162 -13 0 2162 -10 0 2162 -10 0 2162 -19 0 2162 -18 0 2162 -5 0 2155 -4 2156 2164 -10 2156 2164 -4 2156 2157 -15 0 2162 -48 0 2162 -20 0 2162 -11 0 2162 -11 0 2162 -16 0 2162 -14 0 2162 -14 0 2162 -44 0 2162 -15 0 2162 -12 0 2162 -4 0 2162 -4 0 2162 -4 0 2162 -4 0 2162 -4 0 2162 -4 0 2162 -4 0 2162 -4 0 2162 -4 0 2162 -4 0 2162 -4 0 2162 -6 0 10 12 -53 0 2928 2925 2926 -18 11 12 -11 0 2162 -16 0 2162 -13 0 2162 -10 0 2162 -10 0 2162 -19 0 2162 -18 0 2162 -10 0 2162 -10 0 2162 -20 0 2162 -48 0 2162 -20 0 2162 -11 0 2162 -11 0 2162 -16 0 2162 -14 0 2162 -14 0 2162 -44 0 2162 -15 0 2162 -12 0 2162 -4 0 2162 -4 0 2162 -4 0 2162 -4 0 2162 -4 0 2162 -4 0 2162 -4 0 2162 -4 0 2162 -4 0 2162 -4 0 2162 -4 0 2162 -6 0 10 12 -55 0 2928 2933 -11 11 19 -5 11 12 -11 0 2162 -16 0 2162 -13 0 2162 -10 0 2162 -10 0 2162 -19 0 2162 -18 0 2162 -10 0 2162 -10 0 2162 -20 0 2162 -48 0 2162 -20 0 2162 -11 0 2162 -11 0 2162 -16 0 2162 -14 0 2162 -14 0 2162 -44 0 2162 -15 0 2162 -12 0 2162 -4 0 2162 -4 0 2162 -4 0 2162 -4 0 2162 -4 0 2162 -4 0 2162 -4 0 2162 -4 0 2162 -4 0 2162 -4 0 2162 -4 0 2162 -6 0 10 12 -56 0 2934 2933 11 19 -2 11 19 -11 11 12 -11 0 2162 -16 0 2162 -13 0 2162 -10 0 2162 -10 0 2162 -19 0 2162 -18 0 2162 -10 0 2162 -10 0 2162 -20 0 2162 -48 0 2162 -20 0 2162 -11 0 2162 -11 0 2162 -16 0 2162 -14 0 2162 -14 0 2162 -44 0 2162 -15 0 2162 -12 0 2162 -4 0 2162 -4 0 2162 -4 0 2162 -4 0 2162 -4 0 2162 -4 0 2162 -4 0 2162 -4 0 2162 -4 0 2162 -4 0 2162 -4 0 2162 -6 0 10 12 -57 0 2934 2937 11)
    )
    (trampoline
      (type "stationary")
      (z-pos 50)
      (x 7392)
      (y 480)
    )
    (trampoline
      (type "stationary")
      (z-pos 50)
      (x 7776)
      (y 512)
    )
    (trampoline
      (type "stationary")
      (z-pos 50)
      (x 8160)
      (y 544)
    )
  )
)
