(supertux-level
  (version 3)
  (name (_ "Dark Ice"))
  (author "Sophie \"Vaesea\" Ball")
  (license "CC-BY-SA 4.0 International")
  (allow-item-pocket "inherit")
  (icon "")
  (icon-locked "")
  (statistics
    (enable-coins #t)
    (enable-secrets #t)
  )
  (sector
    (name "main")
    (ambient-light
      (color 0.5 0.5 0.5)
    )
    (background
      (color 1 1 1)
      (speed 0.5)
      (image-top "/images/background/cave2.jpg")
      (image "/images/background/cave2.jpg")
      (image-bottom "/images/background/cave2.jpg")
    )
    (bonusblock
      (z-pos 51)
      (count 5)
      (sprite "/images/objects/bonus_block/purpleblock.sprite")
      (x 6048)
      (y 672)
    )
    (camera
      (name "Camera")
      (mode "normal")
    )
    (crusher
      (z-pos 50)
      (x 3840)
      (y 448)
    )
    (crystallo
      (z-pos 50)
      (glinting #f)
      (direction "left")
      (x 9792)
      (y 960)
    )
    (crystallo
      (z-pos 50)
      (glinting #f)
      (direction "left")
      (x 9664)
      (y 960)
    )
    (crystallo
      (z-pos 50)
      (glinting #f)
      (direction "left")
      (x 9536)
      (y 960)
    )
    (crystallo
      (z-pos 50)
      (glinting #f)
      (direction "left")
      (x 8808)
      (y 808)
    )
    (firefly
      (z-pos 0)
      (x 5248)
      (y 576)
    )
    (flyingsnowball
      (z-pos 50)
      (x 9056)
      (y 800)
      (glinting #f)
    )
    (flyingsnowball
      (z-pos 50)
      (x 9120)
      (y 768)
      (glinting #f)
    )
    (flyingsnowball
      (z-pos 50)
      (x 9184)
      (y 896)
      (glinting #f)
    )
    (jumpy
      (z-pos 50)
      (x 2144)
      (y 896)
      (glinting #f)
    )
    (jumpy
      (z-pos 50)
      (x 2304)
      (y 896)
      (glinting #f)
    )
    (jumpy
      (z-pos 50)
      (x 2464)
      (y 896)
      (glinting #f)
    )
    (jumpy
      (z-pos 50)
      (x 2624)
      (y 896)
      (glinting #f)
    )
    (jumpy
      (z-pos 50)
      (x 8384)
      (y 960)
      (glinting #f)
    )
    (mriceblock
      (z-pos 50)
      (direction "left")
      (x 5760)
      (y 736)
      (glinting #f)
    )
    (mriceblock
      (z-pos 50)
      (direction "left")
      (x 6112)
      (y 768)
      (glinting #f)
    )
    (mriceblock
      (z-pos 50)
      (direction "left")
      (x 6464)
      (y 800)
      (glinting #f)
    )
    (mriceblock
      (z-pos 50)
      (direction "left")
      (x 13472)
      (y 832)
      (glinting #f)
    )
    (mriceblock
      (z-pos 50)
      (direction "left")
      (x 13824)
      (y 800)
      (glinting #f)
    )
    (mriceblock
      (z-pos 50)
      (direction "left")
      (x 14176)
      (y 768)
      (glinting #f)
    )
    (mriceblock
      (z-pos 50)
      (direction "left")
      (x 14560)
      (y 736)
      (glinting #f)
    )
    (music
      (file "/music/antarctic/cave.music")
    )
    (secretarea
      (fade-tilemap "secret")
      (width 128)
      (height 96)
      (x 3808)
      (y 352)
    )
    (sequencetrigger
      (sequence "stoptux")
      (width 16)
      (height 128)
      (x 15984)
      (y 640)
    )
    (sequencetrigger
      (sequence "endsequence")
      (width 32)
      (height 224)
      (x 15424)
      (y 544)
    )
    (smartball
      (z-pos 50)
      (direction "left")
      (x 6272)
      (y 672)
      (glinting #f)
    )
    (smartball
      (z-pos 50)
      (direction "left")
      (x 6624)
      (y 672)
      (glinting #f)
    )
    (smartball
      (z-pos 50)
      (direction "left")
      (x 7584)
      (y 672)
      (glinting #f)
    )
    (smartball
      (z-pos 50)
      (direction "left")
      (x 7392)
      (y 672)
      (glinting #f)
    )
    (smartball
      (z-pos 50)
      (direction "left")
      (x 12992)
      (y 864)
      (glinting #f)
    )
    (smartball
      (z-pos 50)
      (direction "left")
      (x 3264)
      (y 960)
      (glinting #f)
    )
    (smartball
      (z-pos 50)
      (direction "left")
      (x 8576)
      (y 992)
      (glinting #f)
    )
    (snowball
      (z-pos 50)
      (direction "left")
      (x 11136)
      (y 704)
      (glinting #f)
    )
    (snowball
      (z-pos 50)
      (direction "left")
      (x 11648)
      (y 800)
      (glinting #f)
    )
    (snowball
      (z-pos 50)
      (direction "left")
      (x 11712)
      (y 800)
      (glinting #f)
    )
    (snowball
      (z-pos 50)
      (direction "left")
      (x 11776)
      (y 800)
      (glinting #f)
    )
    (snowball
      (z-pos 50)
      (direction "left")
      (x 11840)
      (y 800)
      (glinting #f)
    )
    (snowball
      (z-pos 50)
      (direction "left")
      (x 1152)
      (y 864)
      (glinting #f)
    )
    (snowball
      (z-pos 50)
      (direction "left")
      (x 1056)
      (y 864)
      (glinting #f)
    )
    (snowball
      (z-pos 50)
      (direction "left")
      (x 1696)
      (y 832)
      (glinting #f)
    )
    (snowball
      (z-pos 50)
      (direction "left")
      (x 1600)
      (y 832)
      (glinting #f)
    )
    (snowball
      (z-pos 50)
      (direction "left")
      (x 1504)
      (y 832)
      (glinting #f)
    )
    (snowball
      (z-pos 50)
      (direction "left")
      (x 3648)
      (y 768)
      (glinting #f)
    )
    (snowball
      (z-pos 50)
      (direction "left")
      (x 3968)
      (y 704)
      (glinting #f)
    )
    (spawnpoint
      (name "main")
      (x 64)
      (y 864)
    )
    (spiky
      (z-pos 50)
      (direction "left")
      (x 6400)
      (y 800)
      (glinting #f)
    )
    (spiky
      (z-pos 50)
      (direction "left")
      (x 6816)
      (y 768)
      (glinting #f)
    )
    (spiky
      (z-pos 50)
      (direction "left")
      (x 7200)
      (y 736)
      (glinting #f)
    )
    (spiky
      (z-pos 50)
      (direction "left")
      (x 12256)
      (y 928)
      (glinting #f)
    )
    (spiky
      (z-pos 50)
      (direction "left")
      (x 12480)
      (y 960)
      (glinting #f)
    )
    (spiky
      (z-pos 50)
      (direction "left")
      (x 12704)
      (y 992)
      (glinting #f)
    )
    (spiky
      (z-pos 50)
      (direction "left")
      (x 5056)
      (y 832)
      (glinting #f)
    )
    (spiky
      (z-pos 50)
      (direction "left")
      (x 4928)
      (y 832)
      (glinting #f)
    )
    (spiky
      (z-pos 50)
      (direction "left")
      (x 4800)
      (y 832)
      (glinting #f)
    )
    (spiky
      (z-pos 50)
      (direction "left")
      (x 4672)
      (y 832)
      (glinting #f)
    )
    (spiky
      (z-pos 50)
      (direction "left")
      (x 4544)
      (y 832)
      (glinting #f)
    )
    (tilemap
      (solid #f)
      (z-pos -100)
      (width 500)
      (height 35)
      (tiles -8981 0 130 -178 0 106 107 108 -318 0 129 -178 0 109 110 111 -318 0 129 -201 0 106 107 108 -28 0 106 107 108 -264 0 129 -14 0 -2 2035 -185 0 109 110 111 -28 0 109 110 111 -264 0 129 -10 0 1809 1812 -2 0 -2 2035 -448 0 106 107 108 -27 0 106 107 108 -2 0 129 -10 0 1810 1813 -2 0 -2 2035 -448 0 109 110 111 -27 0 109 110 111 -2 0 129 -10 0 1811 1814 -2 0 -2 2035 -368 0 106 107 108 -176 0 106 107 108 -84 0 106 107 108 -231 0 109 110 111 -47 0 106 107 108 -126 0 109 110 111 -84 0 109 110 111 -115 0 106 107 108 -77 0 106 107 108 -69 0 106 107 108 -11 0 109 110 111 -81 0 108 -16 0 106 107 108 -230 0 109 110 111 -77 0 109 110 111 -69 0 109 110 111 -95 0 111 -16 0 109 110 111 -549 0 106 107 108 -27 0 106 107 108 -189 0 106 107 108 -275 0 109 110 111 -27 0 109 110 111 -189 0 109 110 111 -2206 0)
    )
    (tilemap
      (solid #f)
      (z-pos 100)
      (width 500)
      (height 35)
      (tiles -8983 0 130 -499 0 129 -499 0 129 -499 0 129 -14 0 38 36 -483 0 129 -14 0 38 36 -483 0 129 -14 0 38 36 -483 0 129 -14 0 38 36 -5500 0)
    )
    (tilemap
      (solid #t)
      (z-pos 0)
      (width 500)
      (height 35)
      (tiles -4619 36 -4 41 -495 36 43 -2 83 128 83 38 -494 36 43 -4 0 38 -494 36 43 -4 0 38 -492 36 -2 41 42 -4 0 40 -3 41 -27 36 -89 41 -372 36 42 -11 0 40 -25 36 42 -89 0 40 -370 36 42 -13 0 40 -23 36 42 -91 0 40 -91 36 -36 41 -230 36 -11 41 42 -15 0 40 -21 36 42 -93 0 40 -89 36 42 -36 0 40 -53 36 -70 41 -105 36 42 -28 0 40 -19 41 42 -95 0 40 -87 36 42 -38 0 40 -51 36 42 -70 0 38 -103 36 42 -127 0 -3 83 -3 0 -3 83 -10 0 40 -33 36 -9 41 -43 36 42 -40 0 40 -49 36 42 -71 0 38 -102 36 42 -60 0 33 -7 32 34 -79 0 40 -31 36 43 -9 0 38 -41 36 42 -42 0 40 -47 36 42 -72 0 40 41 -2 36 -98 41 42 -61 0 35 -7 37 39 34 -8 0 83 -44 0 83 -25 0 40 -30 41 42 -9 0 40 -40 41 42 -44 0 40 -45 41 42 -73 0 27 29 -162 0 38 -8 36 39 -5 32 34 -5 0 33 -4 32 34 -5 0 33 -4 32 34 -5 0 33 -4 32 34 -2 0 2948 -2 0 33 -5 32 34 -5 0 33 -11 32 34 -377 0 33 -8 32 34 -14 0 33 32 34 -11 0 33 32 34 -3 0 38 -9 36 -5 37 39 -5 0 35 -4 37 39 -5 0 35 -4 37 39 -2 0 102 -2 0 35 -4 37 39 -5 0 35 -5 37 39 -5 0 35 -11 37 39 34 -105 0 33 -3 32 34 -15 0 -5 83 -171 0 -3 83 -6 0 83 102 83 -63 0 35 -8 37 39 34 -6 0 -3 83 -4 0 119 121 120 -4 0 83 102 83 -4 0 119 121 120 -3 0 38 -14 36 43 -5 32 38 -4 36 43 -5 0 38 -4 36 43 -5 0 38 -4 36 43 -5 0 38 -5 36 43 -5 32 38 -12 36 39 34 -101 0 33 -2 32 35 -3 37 39 -2 32 34 -92 0 33 -10 32 34 -16 0 33 -24 32 -111 0 33 -6 32 38 -9 36 39 34 -32 0 38 -15 36 -5 37 -5 36 43 -5 32 38 -4 36 43 -5 0 38 -4 36 43 -5 32 38 -6 36 -5 37 -14 36 39 -4 32 34 -93 0 33 -2 32 35 -2 37 -5 36 -2 37 39 -2 32 34 -45 0 -4 83 -29 0 33 -10 32 35 -10 37 39 -16 0 35 -24 37 -2 36 -19 0 -3 83 -86 0 33 35 -6 37 -11 36 39 34 -31 0 38 -26 36 -5 37 -5 36 43 -5 32 38 -5 36 -5 37 -27 36 -4 37 39 34 -24 0 33 -8 32 34 -32 0 33 -7 32 34 -5 0 33 34 -5 0 33 -4 32 35 -2 37 -11 36 -2 37 39 -15 32 34 -51 0 33 -10 32 35 -10 37 -11 36 43 -16 0 38 -26 36 -38 0 33 -16 32 34 -51 0 33 35 -19 36 39 -31 32 38 -37 36 -5 37 -43 36 39 34 -23 0 35 -8 37 39 -32 0 35 -7 37 39 -5 0 35 39 -5 0 35 -4 37 -17 36 -15 37 39 -9 0 83 -31 0 33 -9 32 35 -10 37 -22 36 43 -4 0 33 34 -4 0 33 34 -4 0 38 -26 36 -28 0 33 -9 32 35 -16 37 39 34 -5 0 -2 83 -22 0 -2 83 -18 0 33 35 -21 36 -31 37 -87 36 39 -4 32 34 -18 0 38 -8 36 43 -29 0 83 102 83 38 -7 36 43 -5 2178 38 43 -5 2178 38 -36 36 43 -6 32 34 -5 0 33 34 -2 0 103 -2 0 33 34 -5 0 33 -8 32 34 -5 0 35 -9 37 -33 36 43 -4 0 35 39 -4 0 35 39 -4 0 38 -26 36 -28 32 35 -9 37 -18 36 39 34 -47 0 33 35 -141 36 -4 37 39 34 -16 0 33 38 -8 36 43 -32 0 38 -8 36 -5 37 -2 36 -5 37 -38 36 -6 37 39 -5 0 35 39 -5 0 35 39 -2 0 102 -2 0 35 -8 37 39 -5 0 38 -42 36 43 -4 0 38 43 -4 0 38 43 -4 0 38 -26 36 -28 37 -29 36 39 34 -8 0 1741 -4 0 1741 -4 0 1741 -4 0 1741 -21 0 33 35 -147 36 39 34 -15 0 35 -9 36 43 -32 0 38 -64 36 43 -5 32 38 43 -5 0 38 43 -5 0 38 -8 36 43 -5 0 38 -42 36 43 -4 0 38 43 -4 0 38 43 -4 0 38 -84 36 39 -8 32 1740 -4 32 1740 -4 32 1740 -4 32 1740 -7 32 34 -5 0 33 -7 32 35 -149 36 39 -15 0 38 -9 36 43 -9 0 33 -22 32 38 -65 36 -5 37 36 43 -5 32 38 43 -5 0 38 -8 36 43 -5 0 38 -42 36 43 -4 0 38 43 -4 0 38 43 -4 0 38 -85 36 -8 37 36 -4 37 36 -4 37 36 -4 37 36 -7 37 39 -5 0 35 -7 37 -150 36 43 -15 32 38 -9 36 43 -9 0 35 -22 37 -73 36 -5 37 36 43 -5 32 38 -8 36 43 -5 0 38 -42 36 43 -4 0 38 43 -4 0 38 43 -4 0 38 -116 36 43 -5 0 38 -158 36 -15 37 -10 36 43 -9 0 40 -56 41 -46 36 -5 37 -9 36 43 -5 0 38 -42 36 43 -4 0 38 43 -4 0 38 43 -4 0 38 -116 36 43 -5 0 38 -183 36 43 -66 0 40 -59 36 43 -5 0 38 -42 36 43 -4 0 38 43 -4 0 38 43 -4 0 38 -116 36 43 -5 0 38 -183 36 43 -67 0 38 -58 36 43 -5 0 38 -42 36 43 -4 0 38 43 -4 0 38 43 -4 0 38 -26 36)
    )
    (tilemap
      (solid #f)
      (z-pos 101)
      (name "secret")
      (width 500)
      (height 35)
      (tiles -4618 0 -6 36 -494 0 -6 36 -494 0 -6 36 -494 0 -6 36 -494 0 -6 41 -10876 0)
    )
    (torch
      (z-pos 0)
      (x 256)
      (y 832)
    )
    (torch
      (sprite "/images/objects/torch/torch2.sprite")
      (z-pos 0)
      (x 3072)
      (y 896)
    )
    (torch
      (sprite "/images/objects/torch/torch3.sprite")
      (z-pos 0)
      (x 6944)
      (y 608)
    )
    (torch
      (z-pos 0)
      (x 8960)
      (y 736)
    )
    (torch
      (sprite "/images/objects/torch/torch3.sprite")
      (z-pos 0)
      (x 12768)
      (y 800)
    )
    (torch
      (sprite "/images/objects/torch/torch2.sprite")
      (z-pos 0)
      (x 15136)
      (y 672)
    )
  )
)
