(supertux-level
  (version 3)
  (name (_ "Finding Stars"))
  (author "Sophie \"Vaesea\" Ball")
  (license "CC-BY-SA 4.0 International")
  (target-time 64)
  (allow-item-pocket "inherit")
  (icon "")
  (icon-locked "")
  (statistics
    (enable-coins #t)
    (enable-secrets #t)
  )
  (sector
    (name "main")
    (ambient-light
      (color 0.5 0.5 0.5)
    )
    (background
      (color 1 1 1)
      (speed 0.25)
      (image-top "/images/background/nightsky_top.png")
      (image "/images/background/nightsky_middle.png")
      (image-bottom "/images/background/nightsky_bottom.png")
    )
    (camera
      (name "Camera")
      (mode "normal")
    )
    (candle
      (z-pos -99)
      (x 1952)
      (y 2400)
    )
    (candle
      (z-pos -99)
      (x 2016)
      (y 2400)
    )
    (candle
      (z-pos -99)
      (x 2336)
      (y 2400)
    )
    (candle
      (z-pos -99)
      (x 2272)
      (y 2400)
    )
    (climbable
      (width 64)
      (height 544)
      (x 2592)
      (y 800)
    )
    (crusher
      (z-pos 50)
      (x 1984)
      (y 1216)
    )
    (crusher
      (z-pos 50)
      (x 672)
      (y 1120)
    )
    (crusher
      (z-pos 50)
      (x 832)
      (y 2016)
    )
    (crusher
      (z-pos 50)
      (x 1440)
      (y 2016)
    )
    (crusher
      (z-pos 50)
      (x 1344)
      (y 2016)
    )
    (decal
      (z-pos -100)
      (sprite "/images/decal/snow/exitbg.png")
      (x 9088)
      (y 2144)
    )
    (decal
      (z-pos 100)
      (sprite "/images/decal/snow/exitfg.png")
      (x 9184)
      (y 2144)
    )
    (firefly
      (z-pos 0)
      (x 2944)
      (y 2848)
    )
    (jumpy
      (z-pos 50)
      (x 1904)
      (y 1568)
      (glinting #f)
    )
    (jumpy
      (z-pos 50)
      (x 400)
      (y 1536)
      (glinting #f)
    )
    (jumpy
      (z-pos 50)
      (x 768)
      (y 2240)
      (glinting #f)
    )
    (jumpy
      (z-pos 50)
      (x 2144)
      (y 2368)
      (glinting #f)
    )
    (mriceblock
      (z-pos 50)
      (direction "left")
      (x 3648)
      (y 2912)
      (glinting #f)
    )
    (mriceblock
      (z-pos 50)
      (direction "left")
      (x 3520)
      (y 2912)
      (glinting #f)
    )
    (music
      (file "/music/antarctic/voc-night.music")
    )
    (particles-snow
    )
    (path
      (name "gen17670451211577205349904")
      (path
        (mode "pingpong")
        (adapt_speed #f)
        (node
          (x 4896)
          (y 2272)
          (time 1.5)
        )
        (node
          (x 4896)
          (y 2336)
          (time 1.5)
        )
      )
    )
    (path
      (name "gen17670456181577205376832")
      (path
        (mode "pingpong")
        (adapt_speed #f)
        (node
          (x 6208)
          (y 2432)
          (time 1.5)
        )
        (node
          (x 6208)
          (y 2496)
          (time 1.5)
        )
      )
    )
    (path
      (name "gen17670456191577205374528")
      (path
        (mode "pingpong")
        (adapt_speed #f)
        (node
          (x 6720)
          (y 2432)
          (time 1.5)
        )
        (node
          (x 6720)
          (y 2496)
          (time 1.5)
        )
      )
    )
    (platform
      (z-pos 50)
      (handle
        (scale_x 0)
        (scale_y 0)
        (offset_x 0)
        (offset_y 0)
      )
      (path-ref "gen17670451211577205349904")
    )
    (platform
      (z-pos 50)
      (handle
        (scale_x 0)
        (scale_y 0)
        (offset_x 0)
        (offset_y 0)
      )
      (path-ref "gen17670456181577205376832")
    )
    (platform
      (z-pos 50)
      (handle
        (scale_x 0)
        (scale_y 0)
        (offset_x 0)
        (offset_y 0)
      )
      (path-ref "gen17670456191577205374528")
    )
    (secretarea
      (fade-tilemap "secret")
      (width 160)
      (height 160)
      (x 3232)
      (y 1088)
    )
    (sequencetrigger
      (sequence "endsequence")
      (width 32)
      (height 2336)
      (x 8672)
      (y 0)
    )
    (sequencetrigger
      (sequence "stoptux")
      (width 128)
      (height 608)
      (x 9376)
      (y 1824)
    )
    (smartball
      (z-pos 50)
      (direction "left")
      (x 3136)
      (y 1344)
      (glinting #f)
    )
    (smartball
      (z-pos 50)
      (direction "left")
      (x 1472)
      (y 1376)
      (glinting #f)
    )
    (smartball
      (z-pos 50)
      (direction "left")
      (x 960)
      (y 1440)
      (glinting #f)
    )
    (smartball
      (z-pos 50)
      (direction "left")
      (x 1504)
      (y 2336)
      (glinting #f)
    )
    (smartball
      (z-pos 50)
      (direction "left")
      (x 7296)
      (y 2368)
      (glinting #f)
    )
    (smartball
      (z-pos 50)
      (direction "left")
      (x 5984)
      (y 2368)
      (glinting #f)
    )
    (smartball
      (z-pos 50)
      (direction "left")
      (x 5216)
      (y 2208)
      (glinting #f)
    )
    (smartball
      (z-pos 50)
      (direction "left")
      (x 4224)
      (y 2080)
      (glinting #f)
    )
    (smartblock
      (z-pos 50)
      (direction "left")
      (x 2336)
      (y 2400)
      (glinting #f)
    )
    (snowball
      (z-pos 50)
      (direction "left")
      (x 800)
      (y 928)
      (glinting #f)
    )
    (snowball
      (z-pos 50)
      (direction "left")
      (x 960)
      (y 928)
      (glinting #f)
    )
    (snowball
      (z-pos 50)
      (direction "left")
      (x 8000)
      (y 2624)
      (glinting #f)
    )
    (snowball
      (z-pos 50)
      (direction "left")
      (x 5600)
      (y 2336)
      (glinting #f)
    )
    (spawnpoint
      (name "main")
      (x 64)
      (y 864)
    )
    (stalactite
      (glinting #f)
      (z-pos -1)
      (x 2720)
      (y 1120)
    )
    (stalactite
      (glinting #f)
      (z-pos -1)
      (x 3040)
      (y 1088)
    )
    (stalactite
      (glinting #f)
      (z-pos -1)
      (x 3008)
      (y 1088)
    )
    (stalactite
      (glinting #f)
      (z-pos -1)
      (x 768)
      (y 1184)
    )
    (stalactite
      (glinting #f)
      (z-pos -1)
      (x 832)
      (y 1184)
    )
    (stalactite
      (glinting #f)
      (z-pos -1)
      (x 704)
      (y 2080)
    )
    (tilemap
      (solid #f)
      (z-pos -100)
      (width 300)
      (height 95)
      (tiles -6343 0 106 107 108 -29 0 122 123 -264 0 25 0 109 110 111 -29 0 124 125 -298 0 124 125 -263 0 2192 2180 -33 0 124 125 -263 0 2192 2188 2189 -26 0 25 -11 0 -2 2047 -218 0 122 123 -19 0 122 123 -15 0 2185 2200 2197 2187 2195 -13 0 -2 8 0 -2 8 24 -2 8 -16 0 -2 2048 -218 0 124 125 -15 0 122 123 -2 0 124 125 -2 0 122 123 -11 0 2192 -2 2180 2181 2196 -37 0 -2 2048 -217 0 24 124 125 25 -4 0 106 107 108 -7 0 124 125 -2 0 124 125 -2 0 124 125 -10 0 2185 2200 2188 2189 -2 2179 2180 -36 0 -2 2048 -225 0 109 110 111 0 25 -5 0 124 125 0 24 124 125 -2 0 124 125 -10 0 2192 2180 2197 2187 2195 2180 2188 -36 0 -2 2048 -2 0 8 24 -2 8 0 8 -2 0 106 107 108 -241 0 2185 2200 2188 2180 2181 2196 2188 2197 2187 -35 0 -2 2048 -10 0 109 110 111 -234 0 2180 2181 -2 2196 2198 2199 2186 2192 2180 2197 2187 2195 -2 2180 2181 2196 -27 0 -6 8 9 0 -2 2048 -15 0 25 -231 0 2188 2189 -2 2179 2189 2181 2198 2200 2188 2180 2181 2196 -2 2188 2189 -2 2179 -34 0 -2 2048 -13 0 2185 -10 2199 -223 0 2197 2187 2195 2180 2181 2196 2180 2181 2197 2187 2195 2180 2181 -2 2196 2195 2180 -34 0 -2 2048 -8 0 2185 -4 2199 2200 2187 2195 2180 2187 2195 2180 2187 2195 2180 2195 -223 0 2180 2181 2196 2188 2180 2181 -2 2196 2180 2181 2196 2197 2187 2195 -3 2180 2181 -33 0 -2 2048 0 2185 -6 2199 2200 2180 2181 2196 2188 2180 2181 2196 2188 2181 2196 2188 2181 2196 2188 2196 -222 0 2181 -2 2196 2180 2181 2197 2187 2195 -2 2180 2197 2187 2195 -2 2180 -2 2188 -2 2196 -33 0 -2 2048 0 2193 2184 -2 2180 2187 2195 -2 2180 2187 2195 -2 2180 2187 2195 -2 2180 2195 -2 2180 2195 -3 2180 -220 0 2179 2188 2189 2179 -2 2188 2189 2195 -2 2180 -2 2188 2180 2181 2196 -2 2188 2181 2196 2179 2188 2189 -32 0 -2 2048 -2 0 2193 2184 2188 2189 -2 2179 2188 2189 -2 2179 2188 2189 -2 2179 2188 -2 2179 2188 -2 2179 2188 2179 -220 0 -3 2183 2184 2196 -2 2188 2196 -2 2188 2181 2196 2187 2195 2180 2181 2196 2189 2179 2180 2182 -2 2183 -31 0 -2 2048 -3 0 2192 2197 2187 2195 2180 2197 2187 2195 2180 2197 2187 2195 2180 2197 2195 2180 2197 2195 2180 2197 2180 -223 0 2193 2184 2196 2188 2181 2196 2188 2189 2179 2181 2196 2188 2189 2179 2196 2189 2182 2194 -30 0 122 123 0 -2 2048 -3 0 2192 2180 2181 2196 2188 2180 2181 2196 2188 2180 2181 2196 2188 2180 2196 2188 2180 2196 2188 2180 2188 -224 0 2193 2183 2184 2196 2180 -2 2181 2196 2187 2195 2181 2196 2189 2182 2183 2194 -31 0 124 125 0 -2 2048 -2 0 2185 2200 2187 2195 -2 2180 2187 2195 -2 2180 2187 2195 -2 2180 2187 2180 -232 0 2193 -2 2183 2184 2189 2179 2181 2196 2182 -2 2183 2194 -33 0 124 125 0 -2 2048 0 2185 2200 2188 2189 -2 2179 2188 2189 -2 2179 2188 2189 -2 2179 2188 2189 2179 -228 0 122 123 -5 0 2193 -4 2183 2194 -36 0 124 125 25 -2 2049 2185 2200 2187 2197 2187 2195 2180 2197 2187 2195 2180 2197 2187 2195 2180 2197 2187 2180 -219 0 122 123 -7 0 124 125 -52 0 2193 -3 2183 2184 2196 2188 2180 2181 2196 2188 2180 2181 2196 2188 2180 2181 2188 -219 0 124 125 -7 0 124 125 -56 0 2193 2184 2180 2187 2195 -2 2180 2187 2195 -2 2180 2187 2195 2180 -219 0 124 125 -7 0 124 125 -57 0 2193 -12 2183 -219 0 124 125 0 25 -3 0 24 0 124 125 -68 0 2183 -257 0 122 123 -298 0 124 125 -2 0 122 123 -5 0 25 -243 0 106 107 108 -42 0 124 125 -2 0 124 125 -249 0 109 110 111 -42 0 124 125 -2 0 124 125 -294 0 124 125 24 0 124 125 -3667 0 122 123 -298 0 124 125 -291 0 25 -6 0 124 125 -138 0 130 -143 0 25 -13 0 24 0 124 125 -138 0 129 -35 0 122 123 -262 0 129 -35 0 124 125 -129 0 25 -132 0 129 -35 0 124 125 -155 0 106 107 108 -104 0 129 -6 0 122 123 -24 0 25 -2 0 124 125 -135 0 24 -2 0 25 -16 0 109 110 111 -104 0 129 -3 0 122 123 0 124 125 0 122 123 -32 0 25 -167 0 122 123 -86 0 129 -3 0 124 125 0 124 125 0 124 125 -39 0 24 -46 0 122 123 -39 0 24 -68 0 122 123 -2 0 124 125 -2 0 122 123 -32 0 122 123 -48 0 129 -3 0 124 125 0 124 125 0 124 125 -52 0 25 -30 0 122 123 0 124 125 -108 0 124 125 -2 0 124 125 -2 0 124 125 -32 0 124 125 -44 0 24 0 25 0 129 -3 0 124 125 0 124 125 0 124 125 -60 0 24 -10 0 106 107 108 -9 0 124 125 0 124 125 -108 0 124 125 -2 0 124 125 -2 0 124 125 -32 0 124 125 -39 0 106 107 108 -89 0 109 110 111 -9 0 124 125 0 124 125 -39 0 106 107 108 -66 0 124 125 0 24 124 125 -2 0 124 125 -15 0 24 -16 0 124 125 0 24 0 25 -35 0 109 110 111 -98 0 25 -2 0 124 125 0 124 125 -2 0 24 -35 0 25 109 110 111 -444 0 25 -590 0 122 123 -162 0 25 -135 0 124 125 -298 0 124 125 -291 0 106 107 108 -4 0 124 125 -291 0 109 110 111 24 0 25 0 124 125 -1360 0 122 123 -6 0 24 -271 0 122 123 -3 0 122 123 -13 0 124 125 -3 0 122 123 -273 0 124 125 -3 0 124 125 -13 0 124 125 -3 0 124 125 -273 0 124 125 -3 0 124 125 -6 0 106 107 108 -4 0 124 125 -3 0 124 125 -273 0 124 125 0 25 24 124 125 -4 0 25 0 109 110 111 0 24 -2 0 124 125 0 25 0 124 125 -1084 0)
    )
    (tilemap
      (solid #f)
      (z-pos 100)
      (width 300)
      (height 95)
      (tiles -19472 0 130 -299 0 129 -299 0 129 -299 0 129 -299 0 129 -299 0 129 -299 0 129 -299 0 129 -299 0 129 -6627 0)
    )
    (tilemap
      (solid #t)
      (z-pos 0)
      (width 300)
      (height 95)
      (tiles -100 0 10 -5 11 19 12 -292 0 10 -6 11 12 -292 0 10 19 -5 11 12 -292 0 10 -5 11 19 12 -292 0 10 -3 11 19 -2 11 12 -292 0 10 -6 11 12 -292 0 10 11 19 -4 11 12 -292 0 10 -6 11 12 -292 0 10 -6 11 12 -292 0 10 -6 11 12 -292 0 10 19 -4 11 19 12 -292 0 10 -3 11 19 -2 11 12 -292 0 10 -6 11 12 -292 0 10 11 19 -4 11 12 -292 0 10 -6 11 12 -292 0 10 -6 11 12 -292 0 10 -6 11 12 -292 0 10 -3 11 19 -2 11 12 -234 0 -3 44 -55 0 10 19 -5 11 12 -233 0 44 -3 0 44 -54 0 10 11 19 -4 11 12 -292 0 10 -6 11 12 -292 0 10 -6 11 12 -222 0 83 102 83 -6 0 7 -7 8 2913 2914 -51 0 10 -6 11 12 -231 0 13 -7 14 2915 2916 1832 1827 -49 0 10 -5 11 19 12 -231 0 16 2925 2926 -3 11 19 -2 11 1835 1836 1831 1832 1827 -18 0 2909 2910 -6 8 9 -20 0 10 -6 11 12 -233 0 2928 2933 -7 11 1835 1836 1831 1832 1827 -12 0 2909 2910 2921 2922 2911 2912 -6 14 15 -20 0 10 19 -5 11 12 -234 0 2934 2937 -8 11 1835 1836 1831 2917 2918 -2 44 8 -2 44 8 -2 44 2921 2922 2911 2912 2923 2924 1834 -7 11 12 -7 0 83 2948 -11 0 10 -5 11 19 12 -235 0 2938 -4 11 19 -5 11 1835 2919 2920 -8 14 2923 2924 1834 -5 11 2929 2930 -4 17 18 -14 0 -2 83 -4 0 10 -3 11 19 -2 11 12 -192 0 -6 8 9 -36 0 2939 2937 -15 11 19 -11 11 30 2931 -24 0 -2 83 10 -6 11 12 -192 0 -6 14 113 -27 8 9 -9 0 2938 -24 11 19 -2 11 12 -11 0 7 44 8 -2 44 8 44 2913 2914 -7 0 10 11 19 -4 11 12 -192 0 -2 11 19 -3 11 20 -27 14 15 -9 0 2939 2937 -4 11 19 -2 11 19 -18 11 12 -11 0 13 -6 14 2915 2916 2917 2918 2913 2914 -3 0 10 -6 11 12 -192 0 19 -4 11 19 -7 11 19 -14 11 19 -3 11 2929 2930 18 -10 0 2938 -21 11 19 -4 11 21 -7 44 -4 0 10 11 19 -5 11 1835 2919 2920 2915 2916 2917 2918 9 10 -6 11 12 -192 0 -2 11 115 116 -16 11 19 -10 11 2935 2931 -12 0 2939 2937 11 19 -23 11 20 -6 14 15 -4 0 10 -6 11 19 -4 11 1835 2919 2920 15 10 -3 11 19 -2 11 12 -192 0 -2 11 117 118 -6 11 19 -6 11 19 -12 11 2940 2936 -14 0 2938 -9 11 19 -22 11 12 -4 0 10 19 -4 11 19 -6 11 2929 2930 18 10 -6 11 12 -192 0 -7 11 19 -17 11 19 -4 11 2941 -15 0 2939 2937 -15 11 19 -11 11 19 -3 11 12 -4 0 10 -7 11 2929 2930 -3 17 2931 -2 0 16 -5 17 31 12 -192 0 11 19 -13 11 19 -4 11 30 -2 17 31 -5 11 2935 2942 -16 0 2938 -5 11 19 -23 11 2929 2930 18 -4 0 16 -7 17 2931 -9 0 44 128 44 0 10 12 -192 0 -20 11 12 -2 0 10 -3 11 2929 2930 2936 -17 0 2939 2933 -19 11 19 -6 11 2929 2930 2931 -28 0 10 12 -192 0 -20 17 18 -2 0 16 -3 17 2931 -20 0 2934 2925 2926 -23 11 2935 2931 -30 0 10 12 -242 0 2928 2925 2926 -6 11 19 11 30 -2 17 31 -6 11 19 11 2935 2936 -25 0 7 -5 8 22 12 -244 0 2928 2925 2926 -6 11 12 -2 0 10 -6 11 2929 2930 2936 -18 0 83 103 -4 83 -2 0 13 -5 14 23 12 -231 0 83 102 -2 83 -11 0 2928 -6 17 18 -2 0 16 -6 17 2931 -28 0 10 -5 11 19 12 -269 0 7 -8 8 9 -13 0 10 -6 11 12 -269 0 13 -8 14 15 -3 0 7 -8 8 9 10 19 -5 11 12 -269 0 10 11 19 -5 11 19 12 -3 0 13 -8 14 15 10 -5 11 19 12 -264 0 7 8 9 -2 0 16 -8 17 18 -3 0 10 19 11 19 -4 11 19 12 10 -3 11 19 -2 11 12 -211 0 7 -11 8 9 -40 0 13 14 15 -15 0 16 -8 17 18 10 -6 11 12 -211 0 13 -11 14 15 -40 0 10 11 12 -25 0 10 11 19 -4 11 12 -211 0 10 -7 11 19 -3 11 12 -35 0 7 8 9 -2 0 16 17 18 -25 0 10 -6 11 12 -211 0 16 2925 2926 11 19 -5 11 19 11 12 -35 0 13 14 15 -30 0 10 -6 11 12 -213 0 2928 2933 -8 11 12 -35 0 10 19 12 -30 0 10 -6 11 12 -214 0 2934 2925 2926 11 19 -4 11 12 -23 0 7 -8 8 9 -2 0 16 17 18 -30 0 10 -4 11 19 11 12 -216 0 2928 -6 17 18 -23 0 13 -8 14 15 -35 0 10 -6 11 12 -247 0 10 -8 11 12 -35 0 10 -6 11 12 -247 0 16 -8 17 18 -35 0 10 -2 11 19 -3 11 12 -292 0 10 19 -4 11 19 12 -292 0 10 -6 11 12 -292 0 10 -3 11 19 -2 11 12 -292 0 10 -6 11 12 -292 0 10 11 19 -4 11 12 -197 0 44 -94 0 10 -6 11 12 -192 0 -3 2178 -2 0 44 -2 0 -92 2178 10 -5 11 19 12 -192 0 -2 14 15 -2 0 44 -2 0 13 -90 14 15 10 -6 11 12 -192 0 -2 11 12 -2 0 44 -2 0 10 -10 11 115 116 19 -12 11 19 -22 11 19 -12 11 19 -17 11 19 -7 11 19 -2 11 12 10 -4 11 19 11 12 -192 0 -2 17 18 -2 0 44 -2 0 16 2925 2926 -6 11 19 11 117 118 -2 11 19 11 30 -2 17 31 -9 11 19 -2 11 30 -2 17 3055 -2 17 31 -15 11 19 -14 11 19 -3 11 19 -11 11 19 -4 11 12 10 -6 11 12 -11 0 7 2913 2914 -183 0 44 -4 0 2928 2925 2926 19 -11 11 12 -2 0 10 11 19 -10 11 12 -2 0 206 -2 0 10 11 19 -4 11 19 -33 11 19 -10 11 12 10 -6 11 12 -11 0 13 2915 2916 2917 2918 2913 2914 -186 0 2928 -12 17 18 -2 0 16 -12 17 18 -2 0 3059 -2 0 16 -51 17 18 10 -2 11 19 -3 11 12 -4 0 7 -2 8 9 -3 0 10 11 1835 2919 2920 2915 2916 2917 2918 -5 8 9 -266 0 10 -6 11 12 -4 0 13 -2 14 15 -3 0 10 11 19 -3 11 1835 2919 2920 -5 14 15 -9 0 83 102 83 -254 0 10 -5 11 19 21 9 -3 0 16 -2 17 18 -3 0 10 -7 11 19 -3 11 19 11 21 -6 8 9 -259 0 10 -6 11 20 15 -10 0 10 -3 11 115 116 -8 11 20 -6 14 15 -161 0 7 -5 8 9 -91 0 10 19 -5 11 30 18 -10 0 10 -2 11 19 117 118 19 -13 11 19 21 -6 8 9 -14 0 7 -3 8 2913 2914 -134 0 13 -5 14 15 -4 0 7 8 9 -84 0 10 -5 11 19 12 -11 0 10 -8 11 19 -3 11 19 -7 11 20 -6 14 15 -14 0 13 -3 14 2915 2916 1832 1827 -132 0 10 19 -4 11 12 -4 0 13 14 15 -4 0 7 -7 8 9 -71 0 10 -3 11 19 -2 11 21 -2 8 9 -8 0 10 -3 11 19 -9 11 19 -10 11 19 -2 11 12 -14 0 10 -4 11 1835 1836 1831 1832 1827 -51 0 -3 83 -76 0 16 -5 17 18 -4 0 10 11 12 -4 0 13 -7 14 15 -4 0 7 8 9 -64 0 10 -6 11 20 -2 14 15 -8 0 10 -16 11 19 -3 11 19 -6 11 21 -14 2178 22 -2 11 19 -3 11 1835 1836 1831 1832 1827 -91 0 7 -34 8 -13 0 16 17 18 -4 0 10 -3 11 19 -3 11 12 -4 0 13 14 15 -4 0 7 -7 8 9 -51 0 10 11 19 -4 11 30 -2 17 18 -8 0 10 11 19 -21 11 19 -3 11 20 -14 14 23 -8 11 1835 1836 1831 1832 1827 -79 0 -2 83 -8 0 13 -34 14 -20 0 16 -7 17 18 -4 0 10 11 12 -4 0 13 -7 14 15 -4 0 7 8 9 -23 0 7 9 -19 0 10 -6 11 12 -11 0 10 -4 11 19 -4 11 19 -30 11 19 -12 11 1835 1836 1831 2917 2918 -10 8 9 -14 0 7 9 -14 0 7 -8 8 2913 2914 -29 0 7 -5 8 22 19 -5 11 19 -10 11 19 -10 11 19 -3 11 19 11 -33 0 16 17 18 -4 0 10 19 -3 11 19 -2 11 12 -4 0 13 14 15 -4 0 7 -13 8 9 -4 0 13 15 -19 0 10 -6 11 21 -4 8 9 -6 0 10 -43 11 19 -3 11 19 -7 11 1835 2919 2920 -10 14 15 -14 0 13 15 -14 0 13 -8 14 2915 2916 3139 3140 -27 0 13 -5 14 23 -15 11 19 -8 11 19 -9 11 -40 0 16 -7 17 18 -4 0 10 11 12 -4 0 13 -13 14 15 -4 0 16 18 -4 0 7 9 -13 0 10 -6 11 20 -4 14 15 -6 0 10 -2 11 19 -9 11 19 -4 11 19 -32 11 19 -3 11 19 -13 11 12 -14 0 10 12 -14 0 10 -9 11 1835 3143 3144 1838 -20 0 7 -5 8 22 19 -8 11 19 -5 11 19 -9 11 19 -5 11 19 -8 11 -53 0 16 17 18 -4 0 10 -5 11 19 -7 11 12 -10 0 13 15 -13 0 10 -4 11 19 11 30 -4 17 18 -6 0 10 -28 11 19 -3 11 19 -24 11 19 -3 11 19 -6 11 21 -14 2178 22 21 -14 2178 22 -3 11 19 -7 11 3147 1840 1838 -19 0 13 -5 14 23 -3 11 19 -3 11 19 -10 11 19 -21 11 -60 0 16 2925 2926 -6 11 19 -2 11 2929 2930 18 -10 0 16 18 -13 0 10 -5 11 19 12 -11 0 10 -20 11 19 -14 11 19 -28 11 19 -3 11 20 -14 14 23 20 -14 14 23 -6 11 19 -5 11 1842 1840 1838 -18 0 10 19 -14 11 19 -15 11 19 -9 11 19 -4 11 -62 0 2928 2925 2926 -3 11 19 11 2929 2930 2931 -27 0 10 -6 11 21 -6 8 9 -4 0 10 -9 11 19 -34 11 19 -38 11 19 -17 11 19 -11 11 1842 1840 1838 -16 0 7 22 -4 11 19 -6 11 19 -17 11 19 -10 11 115 116 -3 11 19 -64 0 2928 -5 17 2931 -29 0 10 -2 11 19 -3 11 20 -6 14 15 -4 0 10 11 19 -3 11 19 -67 11 19 -12 11 19 -3 11 19 -17 11 19 -5 11 1842 1840 3149 -15 0 13 23 -18 11 19 -3 11 19 -11 11 19 -3 11 19 11 117 118 -4 11 -100 0 10 -6 11 30 -6 17 18 -4 0 10 -2 11 19 -5 11 19 -3 11 19 -5 11 19 -10 11 19 -17 11 19 -10 11 19 -20 11 19 -13 11 19 -9 11 19 -11 11 1842 3151 3152 -14 0 10 -4 11 19 -3 11 19 -19 11 19 -18 11 -92 0 44 -7 0 10 -6 11 12 -11 0 10 -13 11 19 -11 11 19 -14 11 19 -75 11 3155 3156 2917 2918 -12 8 22 -43 11 19 -3 11 -90 2178 -2 0 44 -2 0 -5 2178 10 -6 11 12 -10 0 7 22 -6 11 19 -9 11 19 -3 11 19 -5 11 19 -5 11 19 -10 11 19 -17 11 19 -12 11 19 -32 11 19 -9 11 1835 2919 2920 -12 14 23 -33 11 19 -13 11 -89 14 15 -2 0 44 -2 0 13 -3 14 15 10 -4 11 19 11 12 -10 0 13 23 11 19 -11 11 19 -67 11 19 -5 11 19 -37 11 19 -29 11 19 -15 11 19 -10 11 19 -7 11 19 -7 11 19 -2 11 19 -9 11 19 -11 11 19 -9 11 19 -7 11 19 -11 11 19 -13 11 19 11 12 -2 0 44 -2 0 10 11 19 11 12 10 -5 11 19 12 -10 0 10 -5 11 19 -3 11 19 -6 11 19 -28 11 19 -24 11 19 -29 11 19 -28 11 19 -6 11 19 -12 11 19 -15 11 19 -15 11 -89 17 18 -2 0 44 -2 0 16 -3 17 18 10 -2 11 19 -3 11 12 -10 0 10 -21 11 19 -8 11 19 -17 11 19 -3 11 19 -6 11 19 -13 11 19 -17 11 19 -22 11 19 -18 11 19 -10 11 19 -14 11 19 -9 11 19 -5 11 19 -2 11 19 -2 11 -92 0 44 -7 0 10 19 -5 11 12 -9 0 7 22 19 -37 11 19 -16 11 19 -11 11 19 -29 11 19 -5 11 19 -17 11 19 -9 11 19 -49 11 -97 0 103 -2 0 16 -6 17 18 -9 0 13 23 -3 11 19 -3 11 19 -16 11 19 -8 11 19 -7 11 19 -16 11 19 -3 11 19 -45 11 19 -10 11 19 -3 11 19 11 19 -14 11 19 -14 11 19 -5 11 19 -9 11 19 -5 11 19 -3 11 -117 0 10 -11 11 19 -56 11 19 -10 11 19 -10 11 19 -51 11 19 -37 11 19 11 -117 0 10 -14 11 19 -35 11 19 -34 11 19 -11 11 19 -23 11 19 -35 11 19 -15 11 19 -8 11 -87 0 7 -29 8 22 -23 11 19 -15 11 19 -21 11 -2 19 -8 11 19 -11 11 19 -4 11 19 -3 11 19 -19 11 19 -18 11 19 11 19 -12 11 19 -6 11 19 -15 11 19 -12 11 -87 0 13 -29 14 23 -2 11 19 -2 11 19 -24 11 19 -4 11 19 -17 11 19 -51 11 19 -20 11 19 -2 11 19 -18 11 -2 19 -32 11 -87 0 10 -9 11 19 -9 11 19 -7 11 19 -23 11 19 -3 11 19 -12 11 19 -3 11 19 -17 11 19 -17 11 19 -28 11 19 -21 11 19 -25 11 19 -6 11 19 -19 11 -87 0 10 -2 11 19 -11 11 19 -9 11 19 -13 11 19 -10 11 19 -49 11 19 -112 11)
    )
    (tilemap
      (solid #t)
      (z-pos -1)
      (width 300)
      (height 95)
      (tiles -7528 0 2067 -5 2068 2069 -293 0 2072 -5 2073 2074 -293 0 2057 2060 2061 2060 2061 2065 2059 -293 0 2062 2051 2066 2065 2066 2050 2064 -294 0 2057 2061 2065 2061 2059 0 -10 2178 -289 0 -12 28 -5397 0 2166 2167 2168 2167 2168 2167 2168 2169 -292 0 2170 2171 2172 2171 2172 2171 2172 2173 -292 0 2174 2175 2176 2175 2176 2175 2176 2177 -292 0 2170 2171 2172 2171 2172 2171 2172 2173 -292 0 2174 2175 2176 2175 2176 2175 2176 2177 -292 0 2170 2171 2172 2171 2172 2171 2172 2173 -258 0 2166 2167 2168 2169 -30 0 2174 2175 2176 2175 2176 2175 2176 2177 -258 0 2170 2171 2172 2173 -30 0 2170 2171 2172 2171 2172 2171 2172 2173 -258 0 2174 2175 2176 2177 -30 0 2174 2175 2176 2175 2176 2175 2176 2177 -258 0 2170 2171 2172 2173 -30 0 2170 2171 2172 2171 2172 2171 2172 2173 -258 0 2174 2175 2176 2177 -30 0 2174 2175 2176 2175 2176 2175 2176 2177 -258 0 2170 2171 2172 2173 -30 0 2170 2171 2172 2171 2172 2171 2172 2173 -258 0 2174 2175 2176 2177 -30 0 2174 2175 2176 2175 2176 2175 2176 2177 -3396 0 2019 2140 2141 2142 2019 2140 2141 2142 2019 2140 2141 2142 2019 2140 2141 2142 2019 2140 2141 2142 -280 0 -20 2020 -280 0 -20 2020 -280 0 -20 2020 -280 0 -20 2020 -280 0 -20 2020 -21 0 2019 2140 2141 2142 2019 2140 2141 2142 2019 2140 2141 2142 2019 2140 2141 2142 2019 2140 2141 2142 2019 2140 2141 2142 2019 2140 2141 2142 2019 2140 2141 2142 -227 0 -20 2020 -21 0 -32 2020 -227 0 -20 2020 -21 0 -32 2020 -227 0 -20 2020 -21 0 -32 2020 -227 0 -20 2020 -21 0 -32 2020 -227 0 -20 2020 -21 0 -32 2020 -227 0 -20 2020 -21 0 -32 2020 -227 0 -20 2020 -21 0 -32 2020 -227 0 -20 2020 -21 0 -32 2020 -227 0 -20 2020 -21 0 -32 2020 -227 0 -20 2020 -21 0 -32 2020 -227 0 -20 2020 -21 0 -32 2020 -227 0 -20 2020 -21 0 -32 2020 -227 0 -20 2020 -21 0 -32 2020 -227 0 -20 2020 -21 0 -32 2020 -227 0 -20 2020 -21 0 -32 2020 -227 0 -20 2020 -21 0 -32 2020 -80 0 2019 2140 2141 2142 2019 2140 2141 2142 2019 2140 2141 2142 2019 2140 2141 2142 2019 2140 2141 2142 2019 2140 2141 2142 2019 2140 2141 2142 2019 2140 2141 2142 2019 2140 2141 2142 2019 2140 2141 2142 2019 2140 2141 2142 2019 2140 2141 2142 2019 2140 2141 2142 2019 2140 2141 2142 2019 2140 2141 2142 2019 2140 2141 2142 2019 2140 2141 2142 2019 2140 2141 2142 2019 2140 2141 2142 2019 2140 2141 2142 2019 2140 2141 2142 2019 2140 2141 2142 -59 0 -20 2020 -21 0 -32 2020 -80 0 -88 2020 -59 0 -20 2020 -21 0 -32 2020 -80 0)
    )
    (tilemap
      (solid #t)
      (z-pos -2)
      (width 300)
      (height 95)
      (tiles -13236 0 2166 2167 2168 2167 2168 2167 2168 2167 2168 2167 2168 2169 -288 0 2170 2171 2172 2171 2172 2171 2172 2171 2172 2171 2172 2173 -288 0 2174 2175 2176 2175 2176 2175 2176 2175 2176 2175 2176 2177 -288 0 2170 2171 2172 2171 2172 2171 2172 2171 2172 2171 2172 2173 -288 0 2174 2175 2176 2175 2176 2175 2176 2175 2176 2175 2176 2177 -288 0 2170 2171 2172 2171 2172 2171 2172 2171 2172 2171 2172 2173 -263 0 2166 2167 2168 2169 -21 0 2174 2175 2176 2175 2176 2175 2176 2175 2176 2175 2176 2177 -263 0 2170 2171 2172 2173 -21 0 2170 2171 2172 2171 2172 2171 2172 2171 2172 2171 2172 2173 -263 0 2174 2175 2176 2177 -21 0 2174 2175 2176 2175 2176 2175 2176 2175 2176 2175 2176 2177 -263 0 2170 2171 2172 2173 -21 0 2170 2171 2172 2171 2172 2171 2172 2171 2172 2171 2172 2173 -263 0 2174 2175 2176 2177 -21 0 2174 2175 2176 2175 2176 2175 2176 2175 2176 2175 2176 2177 -263 0 2170 2171 2172 2173 -21 0 2170 2171 2172 2171 2172 2171 2172 2171 2172 2171 2172 2173 -263 0 2174 2175 2176 2177 -21 0 2174 2175 2176 2175 2176 2175 2176 2175 2176 2175 2176 2177 -263 0 2170 2171 2172 2173 -21 0 2170 2171 2172 2171 2172 2171 2172 2171 2172 2171 2172 2173 -263 0 2174 2175 2176 2177 -21 0 2174 2175 2176 2175 2176 2175 2176 2175 2176 2175 2176 2177 -263 0 2170 2171 2172 2173 -21 0 2170 2171 2172 2171 2172 2171 2172 2171 2172 2171 2172 2173 -263 0 2174 2175 2176 2177 -21 0 2174 2175 2176 2175 2176 2175 2176 2175 2176 2175 2176 2177 -10452 0)
    )
    (tilemap
      (solid #f)
      (z-pos 101)
      (name "secret")
      (width 300)
      (height 95)
      (tiles -10300 0 10 -4 11 19 11 -293 0 10 19 115 116 -2 11 19 -293 0 10 11 117 118 -3 11 -293 0 10 11 19 11 19 -2 11 -293 0 10 -6 11 -293 0 10 -2 11 19 -3 11 -16693 0)
    )
    (torch
      (z-pos 0)
      (x 480)
      (y 864)
    )
    (torch
      (sprite "/images/objects/torch/torch2.sprite")
      (z-pos 0)
      (x 2304)
      (y 704)
    )
    (torch
      (z-pos 0)
      (x 2752)
      (y 1248)
    )
    (torch
      (sprite "/images/objects/torch/torch3.sprite")
      (z-pos 0)
      (x 160)
      (y 2144)
    )
    (torch
      (z-pos 0)
      (x 2816)
      (y 2848)
    )
    (torch
      (z-pos 0)
      (x 4704)
      (y 2144)
    )
    (torch
      (sprite "/images/objects/torch/torch2.sprite")
      (z-pos 0)
      (x 7008)
      (y 2304)
    )
    (torch
      (sprite "/images/objects/torch/torch2.sprite")
      (z-pos 0)
      (x 9024)
      (y 2240)
    )
    (torch
      (z-pos 0)
      (x 9440)
      (y 2240)
    )
  )
)
