(supertux-level
  (version 3)
  (name (_ "Good Morning"))
  (author "Sophie \"Vaesea\" Ball")
  (license "CC-BY-SA 4.0 International")
  (target-time 66)
  (allow-item-pocket "inherit")
  (icon "")
  (icon-locked "")
  (statistics
    (enable-coins #t)
    (enable-secrets #t)
  )
  (sector
    (name "main")
    (ambient-light
      (color 1 1 1)
    )
    (background
      (color 1 1 1)
      (speed 0.5)
      (image-top "/images/background/bluemountain-top.png")
      (image "/images/background/bluemountain-middle.png")
      (image-bottom "/images/background/bluemountain-bottom.png")
    )
    (bonusblock
      (z-pos 51)
      (count 3)
      (sprite "/images/objects/bonus_block/orangeblock.sprite")
      (x 2560)
      (y 1696)
    )
    (bonusblock
      (z-pos 51)
      (count 5)
      (sprite "/images/objects/bonus_block/purpleblock.sprite")
      (x 7104)
      (y 1248)
    )
    (camera
      (name "Camera")
      (mode "normal")
    )
    (climbable
      (width 32)
      (height 704)
      (x 5440)
      (y 672)
    )
    (decal
      (z-pos -100)
      (sprite "/images/decal/snow/exitbg.png")
      (x 9280)
      (y 2208)
    )
    (decal
      (z-pos 100)
      (sprite "/images/decal/snow/exitfg.png")
      (x 9376)
      (y 2208)
    )
    (firefly
      (z-pos 0)
      (x 5568)
      (y 1312)
    )
    (flyingsnowball
      (z-pos 50)
      (x 2208)
      (y 1792)
      (glinting #f)
    )
    (flyingsnowball
      (z-pos 50)
      (x 2432)
      (y 1760)
      (glinting #f)
    )
    (flyingsnowball
      (z-pos 50)
      (x 2880)
      (y 1696)
      (glinting #f)
    )
    (jumpy
      (z-pos 50)
      (x 3632)
      (y 576)
      (glinting #f)
    )
    (jumpy
      (z-pos 50)
      (x 3280)
      (y 800)
      (glinting #f)
    )
    (jumpy
      (z-pos 50)
      (x 3280)
      (y 96)
      (glinting #f)
    )
    (jumpy
      (z-pos 50)
      (x 5920)
      (y 1312)
      (glinting #f)
    )
    (jumpy
      (z-pos 50)
      (x 7776)
      (y 1696)
      (glinting #f)
    )
    (music
      (file "/music/antarctic/airship_remix.music")
    )
    (particles-clouds
    )
    (particles-snow
    )
    (path
      (name "gen17672065212239974540080")
      (path
        (mode "pingpong")
        (adapt_speed #f)
        (node
          (x 2640)
          (y 2880)
          (time 8)
        )
        (node
          (x 2640)
          (y 1824)
          (time 8)
        )
      )
    )
    (platform
      (z-pos 50)
      (handle
        (scale_x 0)
        (scale_y 0)
        (offset_x 0)
        (offset_y 0)
      )
      (running #f)
      (name "platform")
      (path-ref "gen17672065212239974540080")
      (sprite "/images/objects/platforms/small.sprite")
    )
    (scripttrigger
      (oneshot #t)
      (script "platform.start_moving();")
      (button #f)
      (width 32)
      (height 16)
      (x 2656)
      (y 2864)
    )
    (secretarea
      (width 64)
      (height 256)
      (x 2528)
      (y 2624)
    )
    (sequencetrigger
      (sequence "endsequence")
      (width 32)
      (height 2400)
      (x 9024)
      (y 0)
    )
    (sequencetrigger
      (sequence "stoptux")
      (width 96)
      (height 128)
      (x 9568)
      (y 2272)
    )
    (smartball
      (z-pos 50)
      (direction "left")
      (x 1440)
      (y 1952)
      (glinting #f)
    )
    (smartball
      (z-pos 50)
      (direction "left")
      (x 3360)
      (y 576)
      (glinting #f)
    )
    (smartball
      (z-pos 50)
      (direction "left")
      (x 3040)
      (y 160)
      (glinting #f)
    )
    (smartball
      (z-pos 50)
      (direction "left")
      (x 2784)
      (y 160)
      (glinting #f)
    )
    (smartball
      (z-pos 50)
      (direction "left")
      (x 4032)
      (y 224)
      (glinting #f)
    )
    (smartball
      (z-pos 50)
      (direction "left")
      (x 4480)
      (y 352)
      (glinting #f)
    )
    (smartball
      (z-pos 50)
      (direction "left")
      (x 6624)
      (y 1472)
      (glinting #f)
    )
    (smartball
      (z-pos 50)
      (direction "left")
      (x 6496)
      (y 1472)
      (glinting #f)
    )
    (smartball
      (z-pos 50)
      (direction "left")
      (x 7328)
      (y 1600)
      (glinting #f)
    )
    (smartball
      (z-pos 50)
      (direction "left")
      (x 7200)
      (y 1600)
      (glinting #f)
    )
    (smartblock
      (z-pos 50)
      (direction "left")
      (x 2912)
      (y 160)
      (glinting #f)
    )
    (snowball
      (z-pos 50)
      (direction "left")
      (x 3008)
      (y 416)
      (glinting #f)
    )
    (snowball
      (z-pos 50)
      (direction "left")
      (x 2656)
      (y 480)
      (glinting #f)
    )
    (snowball
      (z-pos 50)
      (direction "left")
      (x 6560)
      (y 1472)
      (glinting #f)
    )
    (snowball
      (z-pos 50)
      (direction "left")
      (x 7264)
      (y 1600)
      (glinting #f)
    )
    (spawnpoint
      (name "main")
      (x 64)
      (y 1856)
    )
    (tilemap
      (solid #f)
      (z-pos -100)
      (width 500)
      (height 100)
      (tiles -2092 0 106 107 108 -6 0 24 0 25 -9 0 106 107 108 -464 0 25 -3 0 24 -2 0 25 -2 0 24 0 109 110 111 -16 0 25 0 109 110 111 24 -1007 0 24 25 -442 0 106 107 108 -497 0 109 110 111 24 25 -1030 0 106 107 108 -6 0 25 0 24 -22 0 25 -3 0 24 -459 0 25 0 109 110 111 -483 0 24 0 25 -487 0 106 107 108 -41 0 106 107 108 -26 0 106 107 108 -424 0 109 110 111 25 -40 0 109 110 111 24 -24 0 24 109 110 111 -949 0 106 107 108 -483 0 106 107 108 -7 0 25 -2 0 24 109 110 111 -481 0 25 0 109 110 111 0 24 -16 0 24 -3 0 25 -550 0 25 0 24 -501 0 2047 -409 0 106 107 108 -87 0 2048 -407 0 25 0 109 110 111 -87 0 2048 -499 0 2048 -419 0 122 123 -9 0 106 107 108 -66 0 2048 -419 0 124 125 -9 0 109 110 111 25 -65 0 2048 -418 0 24 124 125 25 -19 0 25 0 24 -55 0 2048 -499 0 2048 -499 0 2048 -452 0 24 0 25 -44 0 2048 -499 0 2048 -499 0 2048 -499 0 2048 -499 0 2048 -463 0 25 0 24 -33 0 2048 -499 0 2048 -499 0 2048 -10 0 122 123 -487 0 2048 -10 0 124 125 -487 0 2048 -10 0 124 125 -487 0 2048 -10 0 124 125 -487 0 2048 -2 0 106 107 108 -5 0 124 125 -449 0 2057 2060 2061 2070 2066 2059 -32 0 2049 0 24 109 110 111 -3 0 25 0 124 125 24 -448 0 2057 2065 2066 2060 2061 2059 -494 0 2057 2060 2070 2065 2066 2059 -992 0 2057 2060 2061 2065 2066 2060 2061 2065 2066 2059 -53 0 24 -4 0 25 -8 0 24 -422 0 2057 2065 2070 2060 2061 2065 2066 2060 2061 2059 -488 0 25 0 2057 2060 2061 2065 2066 2060 2061 2070 2066 2059 25 0 24 -103 0 122 123 -352 0 122 123 -124 0 106 107 108 -10 0 122 123 -5 0 124 125 -352 0 124 125 -114 0 25 -2 0 24 -2 0 25 -3 0 109 110 111 24 -9 0 124 125 -5 0 124 125 -352 0 124 125 -137 0 124 125 -5 0 124 125 -352 0 124 125 -9 0 106 107 108 -4 0 25 -120 0 124 125 -5 0 124 125 -352 0 124 125 0 25 -2 0 24 -3 0 24 109 110 111 -125 0 124 125 -5 0 124 125 -346 0 24 -142 0 25 0 124 125 24 -3 0 24 124 125 25 -265 0 122 123 -71 0 24 -419 0 122 123 -5 0 124 125 -64 0 25 -426 0 124 125 -5 0 124 125 -56 0 24 -430 0 106 107 108 0 124 125 -5 0 124 125 -48 0 25 0 24 -433 0 25 -2 0 109 110 111 0 124 125 0 24 -3 0 124 125 -2 0 25 -2 0 24 -3759 0 130 -499 0 129 -499 0 129 -499 0 129 -499 0 129 -499 0 129 -18 0 122 123 -479 0 129 -18 0 124 125 -475 0 106 107 108 0 129 -18 0 124 125 -475 0 109 110 111 24 129 -4 0 25 -2 0 24 -10 0 124 125 0 24 -2502 0 24 0 -2 25 -2005 0 106 107 108 -495 0 24 0 109 110 111 -2503 0 25 -3 0 24 -1504 0 122 123 -498 0 124 125 -496 0 24 0 124 125 -2004 0 106 107 108 -495 0 25 0 109 110 111 -161 0)
    )
    (tilemap
      (solid #f)
      (z-pos 100)
      (width 500)
      (height 100)
      (tiles -33283 0 130 -499 0 129 -499 0 129 -499 0 129 -499 0 129 -499 0 129 -499 0 129 -499 0 129 -499 0 129 -12716 0)
    )
    (tilemap
      (solid #t)
      (z-pos 0)
      (width 500)
      (height 100)
      (tiles -2100 0 7 -4 8 9 -471 0 7 -18 8 9 -3 0 13 -4 14 15 -5 0 7 -4 8 9 -4 0 211 -447 0 -4 83 -4 0 13 -18 14 15 -3 0 16 -4 17 18 -5 0 13 -4 14 15 -4 0 212 -455 0 16 -18 17 18 -14 0 16 -4 17 18 -4 0 212 7 -4 8 9 -493 0 213 13 -4 14 15 -439 0 7 -6 8 9 -27 0 -2 83 -18 0 16 -4 17 18 -7 0 211 -431 0 13 -6 14 15 -60 0 212 -431 0 16 -6 17 18 -13 0 211 -6 0 211 -15 0 7 -4 8 9 -18 0 212 7 -4 8 9 -446 0 212 -6 0 212 -4 0 7 -4 8 9 -5 0 13 -4 14 15 -7 0 -2 83 -9 0 213 13 -4 14 15 -10 0 78 105 -423 0 211 -6 0 211 -3 0 212 7 -4 8 9 212 -4 0 13 -4 14 15 -5 0 16 -4 17 18 -19 0 16 -4 17 18 -435 0 212 -6 0 212 -3 0 213 13 -4 14 15 213 -4 0 16 -4 17 18 -471 0 212 7 -4 8 9 212 -4 0 16 -4 17 18 -6 0 -4 83 -17 0 7 -4 8 9 -22 0 7 -4 8 9 -421 0 213 13 -4 14 15 213 -5 0 -4 83 -28 0 13 -4 14 15 -22 0 13 -4 14 15 -422 0 16 -4 17 18 -38 0 16 -4 17 18 -22 0 10 -2 19 -2 11 12 -443 0 7 -6 8 9 -43 0 16 -4 17 18 -432 0 7 -6 8 9 -3 0 13 -6 14 15 -3 0 7 -6 8 9 -470 0 13 -6 14 15 -3 0 16 -6 17 18 -3 0 13 -6 14 15 -46 0 7 -4 8 9 -418 0 16 -6 17 18 -14 0 16 -6 17 18 -46 0 13 -4 14 15 -494 0 10 -2 11 19 11 12 -408 0 7 -4 8 9 -80 0 16 -4 17 18 -408 0 13 -4 14 15 -7 0 -2 83 -20 0 -2 83 -463 0 16 -4 17 18 -516 0 7 -4 8 9 -483 0 7 -4 8 9 -5 0 13 -4 14 15 -5 0 7 -4 8 9 -7 0 -2 83 -463 0 13 -4 14 15 -5 0 16 -4 17 18 -5 0 13 -4 14 15 -472 0 16 -4 17 18 -16 0 16 -4 17 18 -505 0 7 -4 8 9 -494 0 13 -4 14 15 -494 0 16 -4 17 18 -6 0 -2 83 -1496 0 7 -4 8 9 -61 0 83 2947 83 -428 0 202 0 13 -4 14 15 0 202 -490 0 203 0 16 -4 17 18 0 203 -490 0 3059 -8 0 3059 -533 0 83 3161 83 -22 0 -5 83 -18 0 83 0 83 -408 0 2067 -4 2068 2069 -493 0 3161 2072 -4 2073 2074 83 -531 0 7 -15 8 9 -483 0 13 -15 14 15 -8 0 -4 83 -3 0 -4 83 -14 0 -5 83 -405 0 2067 -8 2068 2069 -30 0 10 -10 11 19 -4 11 12 -441 0 -2 83 2072 -8 2073 2074 -2 83 -28 0 10 -2 11 19 -3 11 19 -8 11 12 -483 0 10 -13 11 19 11 12 -5 0 7 -15 8 9 -461 0 10 -8 11 19 -6 11 12 -5 0 13 -15 14 15 -8 0 -4 83 -3 0 -4 83 -398 0 2909 2910 -14 8 9 -27 0 10 19 -2 11 -2 19 -6 11 19 -3 11 12 -5 0 10 -10 11 19 -4 11 12 -408 0 -2 83 -5 0 1826 1829 2911 2912 -14 14 15 -27 0 10 -7 11 19 -7 11 12 -5 0 10 -2 11 19 -3 11 19 -8 11 12 -393 0 78 83 78 83 78 83 78 -13 0 1826 1829 1830 1833 1834 -11 11 19 -3 11 12 -27 0 10 -14 11 19 12 -5 0 10 -13 11 19 11 12 -5 0 7 -15 8 9 -362 0 -2 83 -25 0 1826 1829 1830 1833 1834 -2 11 115 116 11 19 -3 11 19 -7 11 12 -27 0 10 -9 11 19 -5 11 12 -5 0 10 -8 11 19 -6 11 12 -5 0 13 -15 14 15 -8 0 -3 83 -3 0 -3 83 -338 0 -2 83 -28 0 2909 2910 2921 2922 1830 1833 1834 -3 11 19 117 118 19 -11 11 19 12 -27 0 10 -3 11 19 11 19 -2 11 19 -2 11 19 -3 11 12 -5 0 10 19 -2 11 -2 19 -6 11 19 -3 11 12 -5 0 10 -10 11 19 -4 11 12 -348 0 83 -19 0 7 -14 8 2921 2922 2911 2912 2923 2924 1834 -2 11 19 -12 11 19 -5 11 12 -27 0 10 -15 11 12 -5 0 10 -7 11 19 -7 11 12 -5 0 10 -2 11 19 -3 11 19 -8 11 12 -341 0 -2 83 -18 0 7 -2 8 9 -3 0 13 -14 14 2923 2924 1834 -13 11 19 11 19 -2 11 19 -2 11 19 -3 11 12 -27 0 10 -3 11 19 -5 11 19 -2 11 19 -2 11 12 -5 0 10 -14 11 19 12 -5 0 10 -13 11 19 11 12 -5 0 7 -13 8 2913 2914 -313 0 -2 83 -18 0 7 -2 8 9 -3 0 13 -2 14 15 -3 0 10 -20 11 19 -4 11 19 -16 11 12 -27 0 10 -2 11 19 -12 11 12 -5 0 10 -9 11 19 -5 11 12 -5 0 10 -8 11 19 -6 11 12 -5 0 13 -13 14 2915 2916 3139 3140 -324 0 7 -2 8 9 -3 0 13 -2 14 15 -3 0 10 19 11 12 -3 0 10 -3 11 19 -9 11 19 -15 11 19 -6 11 19 -2 11 19 -2 11 12 -27 0 10 -8 11 19 -6 11 12 -5 0 10 -3 11 19 11 19 -2 11 19 -2 11 19 -3 11 12 -5 0 10 19 -2 11 -2 19 -6 11 19 -3 11 12 -5 0 10 -10 11 19 -3 11 1835 3143 3144 1838 -274 0 -5 83 -19 0 -5 83 -13 0 7 -2 8 9 -3 0 13 -2 14 15 -3 0 10 19 11 12 -3 0 10 -2 11 12 -3 0 10 -22 11 19 -19 11 12 -27 0 10 -3 11 19 -11 11 12 -5 0 10 -15 11 12 -5 0 10 -7 11 19 -7 11 12 -5 0 10 -2 11 19 -3 11 19 -9 11 3147 1840 1838 -285 0 -2 83 3161 -2 83 -18 0 7 -2 8 9 -3 0 13 -2 14 15 -3 0 10 -2 11 12 -3 0 10 -2 11 12 -3 0 10 -2 11 12 -3 0 10 -5 11 19 -22 11 19 -6 11 19 -6 11 12 -27 0 10 -8 11 19 -4 11 19 11 12 -5 0 10 -3 11 19 -5 11 19 -2 11 19 -2 11 12 -5 0 10 -14 11 19 12 -5 0 10 -13 11 19 -3 11 1842 1840 1838 -243 0 -22 8 9 -41 0 13 -2 14 15 -3 0 10 11 19 12 -3 0 10 -2 11 12 -3 0 10 -2 11 12 -3 0 10 -2 11 12 -3 0 10 -11 11 19 -14 11 19 -15 11 12 -27 0 10 -2 11 19 -4 11 19 -7 11 12 -5 0 10 -2 11 19 -12 11 12 -5 0 10 -9 11 19 -5 11 12 -5 0 10 -8 11 19 -9 11 1842 1840 1838 -242 0 -22 14 15 -41 0 10 19 11 12 -3 0 10 -2 11 12 -3 0 10 -2 11 12 -3 0 10 -2 11 12 -3 0 10 -2 11 12 -3 0 10 -9 11 19 -25 11 19 -4 11 19 11 12 -27 0 10 -11 11 19 -3 11 12 -5 0 10 -8 11 19 -6 11 12 -5 0 10 -3 11 19 11 19 -2 11 19 -2 11 19 -3 11 12 -5 0 10 19 -2 11 -2 19 -6 11 19 -7 11 1842 1840 1838 -241 0 -21 11 19 12 -5 0 27 -5 28 29 -17 0 27 -5 28 29 -5 0 10 -2 11 12 -3 0 10 -2 11 12 -3 0 10 19 11 12 -3 0 10 -2 11 12 -3 0 10 -2 11 12 -3 0 10 -22 11 19 -8 11 19 -2 11 19 -7 11 12 -27 0 10 -8 11 19 -6 11 12 -5 0 10 -3 11 19 -11 11 12 -5 0 10 -15 11 12 -5 0 10 -7 11 19 -9 11 19 -2 11 1842 1840 1838 -240 0 -3 11 19 -9 11 19 -8 11 12 -17 0 27 -5 28 29 -17 0 10 -2 11 12 -3 0 10 -2 11 12 -3 0 10 -2 11 12 -3 0 10 -2 11 12 -3 0 10 11 19 12 -3 0 10 -5 11 19 -8 11 19 -3 11 19 -19 11 19 -3 11 12 -27 0 10 19 -3 11 19 -10 11 12 -5 0 10 -8 11 19 -4 11 19 11 12 -5 0 10 -3 11 19 -5 11 19 -2 11 19 -2 11 12 -5 0 10 -12 11 19 -8 11 1842 1840 3149 -239 0 -22 11 12 -41 0 10 -2 11 12 -3 0 10 -2 11 12 -3 0 10 -2 11 12 -3 0 10 -2 11 12 -3 0 10 -2 11 12 -3 0 10 11 19 -22 11 19 -10 11 19 -6 11 12 -27 0 10 -7 11 19 -7 11 12 -5 0 10 -2 11 19 -4 11 19 -7 11 12 -5 0 10 -2 11 19 -12 11 12 -5 0 10 -9 11 19 11 19 -2 11 19 -7 11 1842 3151 3152 -238 0 -5 11 19 -16 11 12 -41 0 10 11 19 12 -3 0 10 -2 11 12 -3 0 10 -2 11 12 -3 0 10 11 19 12 -3 0 10 -2 11 12 -3 0 10 -7 11 19 -34 11 12 -27 0 10 -14 11 19 12 -5 0 10 -11 11 19 -3 11 12 -5 0 10 -8 11 19 -6 11 12 -5 0 10 -3 11 19 11 19 -2 11 19 -14 11 3155 3156 2917 2918 2913 2914 -234 0 -11 11 19 -10 11 12 -41 0 10 -2 11 12 -3 0 10 -2 11 12 -3 0 10 -2 11 12 -3 0 10 -2 11 12 -3 0 10 -2 11 12 -3 0 10 -28 11 19 -5 11 19 -7 11 12 -27 0 10 -15 11 12 -5 0 10 -8 11 19 -6 11 12 -5 0 10 -3 11 19 -11 11 12 -5 0 10 -12 11 19 -2 11 19 -8 11 1835 2919 2920 2915 2916 3139 3140 -232 0 -9 11 19 -4 11 115 116 -6 11 12 -41 0 10 -2 11 12 -3 0 10 19 11 12 -3 0 10 -2 11 12 -3 0 10 -2 11 12 -3 0 10 -2 11 12 -3 0 10 -11 11 19 -29 11 19 12 -27 0 10 -5 11 19 -5 11 19 -3 11 12 -5 0 10 19 -3 11 19 -10 11 12 -5 0 10 -8 11 19 -4 11 19 11 12 -5 0 10 -3 11 19 -5 11 19 -13 11 19 -4 11 1835 3143 3144 1838 -231 0 -14 11 117 118 -2 11 19 -3 11 12 -41 0 10 -2 11 12 -3 0 10 -2 11 12 -3 0 10 -2 11 12 -3 0 10 -2 11 12 -3 0 10 11 19 12 -3 0 10 -22 11 -2 19 -4 11 19 -13 11 12 -27 0 10 -11 11 19 -3 11 12 -5 0 10 -7 11 19 -7 11 12 -5 0 10 -2 11 19 -4 11 19 -7 11 12 -5 0 10 -2 11 19 -8 11 19 -6 11 19 -11 11 3147 1840 1838 -230 0 -5 11 19 -8 11 19 -2 11 19 -4 11 12 -41 0 10 -2 11 12 -3 0 10 -2 11 12 -3 0 10 11 19 12 -3 0 10 -2 11 12 -3 0 10 -2 11 12 -3 0 10 -5 11 -2 19 -4 11 19 -7 11 19 -12 11 19 -5 11 19 -3 11 12 -27 0 10 -15 11 12 -5 0 10 -14 11 19 12 -5 0 10 -11 11 19 -3 11 12 -5 0 10 -8 11 19 -8 11 19 -2 11 19 -7 11 19 -2 11 1842 1840 1838 -229 0 11 19 -20 11 12 -41 0 10 -2 11 12 -3 0 10 -2 11 12 -3 0 10 -2 11 12 -3 0 10 -2 11 12 -3 0 10 -2 11 12 -3 0 10 -2 11 19 -12 11 19 -22 11 19 -3 11 12 -27 0 10 -3 11 19 -9 11 19 11 12 -5 0 10 -15 11 12 -5 0 10 -8 11 19 -6 11 12 -5 0 10 -3 11 19 -7 11 19 -11 11 19 -8 11 1842 1840 1838 -228 0 -7 11 19 -10 11 19 -3 11 12 -41 0 10 19 11 12 -3 0 10 -2 11 12 -3 0 10 -2 11 12 -3 0 10 -2 11 12 -3 0 10 -2 11 12 -3 0 10 -20 11 19 -9 11 19 -11 11 12 -27 0 10 -2 11 19 -12 11 12 -5 0 10 -5 11 19 -5 11 19 -3 11 12 -5 0 10 19 -3 11 19 -10 11 12 -5 0 10 -8 11 19 -4 11 19 -4 11 19 -3 11 19 -2 11 19 -7 11 1842 1840 1838 -227 0 -22 11 12 -41 0 10 11 19 12 -3 0 10 -2 11 12 -3 0 10 -2 11 12 -3 0 10 19 11 12 -3 0 10 -2 11 12 -3 0 10 -3 11 19 -9 11 19 -26 11 19 11 12 -27 0 10 -15 11 12 -5 0 10 -11 11 19 -3 11 12 -5 0 10 -7 11 19 -7 11 12 -5 0 10 -2 11 19 -4 11 19 -22 11 19 -3 11 1842 1840 1838 -226 0 -11 11 19 -5 11 19 -4 11 12 -41 0 10 -2 11 12 -3 0 10 -2 11 12 -3 0 10 -2 11 12 -3 0 10 -2 11 12 -3 0 10 -2 11 12 -3 0 10 -22 11 19 -19 11 12 -27 0 10 -3 11 19 -11 11 12 -5 0 10 -15 11 12 -5 0 10 -14 11 19 12 -5 0 10 -11 11 19 -5 11 19 -5 11 19 -2 11 19 -8 11 1842 1840 3149 -225 0 -22 11 12 -41 0 10 -2 11 12 -3 0 10 -2 11 12 -3 0 10 19 11 12 -3 0 10 -2 11 12 -3 0 10 19 11 12 -3 0 10 -5 11 19 -22 11 19 -13 11 12 -27 0 10 -8 11 19 -6 11 12 -5 0 10 -3 11 19 -9 11 19 11 12 -5 0 10 -15 11 12 -5 0 10 -8 11 19 -23 11 19 -3 11 1842 3151 3152 -224 0 -5 11 -2 19 -4 11 19 -10 11 12 -41 0 10 -2 11 12 -3 0 10 -2 11 12 -3 0 10 -2 11 12 -3 0 10 -2 11 12 -3 0 10 -2 11 12 -3 0 10 -11 11 19 -14 11 19 -15 11 12 -27 0 10 -2 11 19 -4 11 19 -4 11 19 -2 11 12 -5 0 10 -2 11 19 -12 11 12 -5 0 10 -5 11 19 -5 11 19 -3 11 12 -5 0 10 19 -3 11 19 -18 11 19 -3 11 19 -9 11 3155 3156 2917 2918 -26 8 9 -195 0 -2 11 19 -12 11 19 -5 11 19 12 -41 0 10 -2 11 12 -3 0 10 -2 11 12 -3 0 10 -2 11 12 -3 0 10 11 19 12 -3 0 10 -2 11 12 -3 0 10 -9 11 19 -25 11 19 -6 11 12 -27 0 10 -15 11 12 -5 0 10 -15 11 12 -5 0 10 -11 11 19 -3 11 12 -5 0 10 -7 11 19 -10 11 19 -7 11 19 -2 11 19 -8 11 1835 2919 2920 -26 14 15 -195 0 -21 11 19 12 -41 0 10 -2 11 12 -3 0 10 11 19 12 -3 0 10 -2 11 12 -3 0 10 -2 11 12 -3 0 10 -2 11 12 -3 0 10 -22 11 19 -8 11 19 -2 11 19 -4 11 19 -2 11 12 -27 0 10 -8 11 19 -6 11 12 -5 0 10 -3 11 19 -11 11 12 -5 0 10 -15 11 12 -5 0 10 -13 11 -2 19 -2 11 19 -2 11 19 -16 11 19 -9 11 19 -9 11 19 -7 11 19 11 12 -195 0 -3 11 19 -9 11 19 -8 11 12 -41 0 10 19 11 12 -3 0 10 -2 11 12 -3 0 10 11 19 12 -3 0 10 -2 11 12 -3 0 10 11 19 12 -3 0 10 -5 11 19 -8 11 19 -3 11 19 -23 11 12 -27 0 10 19 -3 11 19 -10 11 12 -5 0 10 -8 11 19 -6 11 12 -5 0 10 -3 11 19 -9 11 19 11 12 -5 0 10 -8 11 19 -15 11 19 -2 11 19 -4 11 19 -9 11 19 -9 11 19 -3 11 115 116 -2 11 19 -6 11 12 -195 0 -22 11 12 -41 0 10 -2 11 12 -3 0 10 -2 11 12 -3 0 10 -2 11 12 -3 0 10 19 11 12 -3 0 10 -2 11 12 -3 0 10 11 19 -22 11 19 -10 11 19 -6 11 12 -27 0 10 -7 11 19 -7 11 12 -5 0 10 -2 11 19 -4 11 19 -4 11 19 -2 11 12 -5 0 10 -2 11 19 -12 11 12 -5 0 10 -5 11 19 11 19 -2 11 19 -7 11 19 -2 11 19 -9 11 19 -2 11 19 -7 11 19 11 19 -8 11 -2 19 11 117 118 11 19 -2 11 19 -4 11 12 -195 0 -5 11 19 -16 11 12 -41 0 10 -2 11 12 -3 0 10 -2 11 12 -3 0 10 -2 11 12 -3 0 10 -2 11 12 -3 0 10 -2 11 12 -3 0 10 -7 11 19 -34 11 12 -27 0 10 -15 11 12 -5 0 10 -15 11 12 -5 0 10 -15 11 12 -5 0 10 -24 11 19 11 19 -10 11 19 -10 11 19 -18 11 21 -6 8 9 -188 0 -11 11 19 -10 11 12 -41 0 10 -2 11 12 -3 0 10 -2 11 12 -3 0 10 19 11 12 -3 0 10 -2 11 12 -3 0 10 -2 11 12 -3 0 10 -28 11 19 -5 11 19 -7 11 12 -27 0 10 -14 11 19 12 -5 0 10 -8 11 19 -6 11 12 -5 0 10 -3 11 19 -11 11 12 -5 0 10 -8 11 19 -2 11 19 -5 11 19 -14 11 19 -3 11 19 -2 11 19 -5 11 19 11 19 -2 11 19 -4 11 19 -4 11 19 -2 11 19 -3 11 20 -6 14 15 -188 0 -9 11 19 -12 11 12 -41 0 10 11 19 12 -3 0 10 19 11 12 -3 0 10 -2 11 12 -3 0 10 11 19 12 -3 0 10 19 11 12 -3 0 10 -11 11 19 -30 11 12 -27 0 10 -5 11 19 -5 11 19 -3 11 12 -5 0 10 19 -3 11 19 -10 11 12 -5 0 10 -8 11 19 -6 11 12 -5 0 10 -3 11 19 -25 11 19 -38 11 19 -5 11 12 -188 0 -18 11 19 -3 11 12 -41 0 16 -2 17 18 -3 0 16 -2 17 18 -3 0 16 -2 17 18 -3 0 16 -2 17 18 -3 0 16 -2 17 18 -3 0 10 -22 11 -2 19 -4 11 19 -12 11 19 12 -27 0 10 -15 11 12 -5 0 10 -7 11 19 -7 11 12 -5 0 10 -2 11 19 -4 11 19 -4 11 19 -2 11 12 -5 0 10 -2 11 19 -4 11 19 -7 11 19 11 19 -4 11 19 11 19 -6 11 19 -5 11 19 -2 11 19 -7 11 19 -2 11 19 -7 11 19 -3 11 19 -10 11 12 -188 0 -5 11 19 -8 11 19 -2 11 19 -4 11 12 -76 0 10 -5 11 -2 19 -4 11 19 -7 11 19 -12 11 19 -5 11 19 -3 11 12 -27 0 10 -11 11 19 -3 11 12 -5 0 10 -15 11 12 -5 0 10 -15 11 12 -5 0 10 -23 11 19 -2 11 19 -35 11 19 -9 11 19 11 12 -188 0 11 19 -20 11 12 -76 0 10 -2 11 19 -12 11 19 -26 11 12 -27 0 10 -15 11 12 -5 0 10 -14 11 19 12 -5 0 10 -8 11 19 -6 11 12 -5 0 10 -3 11 19 -3 11 19 -4 11 19 -3 11 19 -2 11 19 -11 11 19 -4 11 19 -10 11 19 -8 11 19 -2 11 19 -7 11 19 -6 11 21 -6 8 9 -181 0 -7 11 19 -10 11 19 -3 11 12 -76 0 10 -38 11 19 -3 11 12 -27 0 10 -3 11 19 -11 11 12 -5 0 10 -5 11 19 -5 11 19 -3 11 12 -5 0 10 19 -3 11 19 -10 11 12 -5 0 10 -8 11 19 -15 11 19 -2 11 19 -14 11 19 -20 11 19 -2 11 19 -2 11 19 -4 11 20 -6 14 15 -181 0 -22 11 12 -56 0 83 128 -18 0 10 -20 11 19 -9 11 19 -11 11 12 -27 0 10 -2 11 19 -12 11 12 -5 0 10 -15 11 12 -5 0 10 -7 11 19 -7 11 12 -5 0 10 -2 11 19 -4 11 19 -4 11 19 -2 11 19 -13 11 19 -7 11 19 -8 11 -2 19 -8 11 19 -5 11 19 -13 11 19 -4 11 12 -181 0 -11 11 19 -5 11 19 -4 11 12 -76 0 10 -3 11 19 -9 11 19 -28 11 12 -27 0 10 -15 11 12 -5 0 10 -11 11 19 -3 11 12 -5 0 10 -15 11 12 -5 0 10 -20 11 19 -3 11 19 -5 11 19 -5 11 19 -2 11 19 -11 11 19 -5 11 19 -9 11 19 -3 11 19 -9 11 12 -181 0 -22 11 12 -76 0 10 -22 11 19 -19 11 12 -27 0 10 11 19 -11 11 19 11 12 -5 0 10 -15 11 12 -5 0 10 -14 11 19 12 -5 0 10 -8 11 19 -2 11 19 -3 11 19 -7 11 19 -2 11 19 -5 11 19 -10 11 19 -6 11 19 -2 11 19 -5 11 19 -10 11 19 -2 11 19 -7 11 12 -181 0 -5 11 -2 19 -4 11 19 -10 11 12 -55 0 7 -2 8 9 -17 0 10 -5 11 19 -22 11 19 -13 11 12 -27 0 10 -8 11 19 -6 11 12 -5 0 10 -3 11 19 -11 11 12 -5 0 10 -5 11 19 -5 11 19 -3 11 12 -5 0 10 19 -3 11 19 -5 11 19 -3 11 19 -2 11 19 -12 11 19 -6 11 19 -2 11 19 -25 11 19 -11 11 19 -2 11 21 -6 8 9 -174 0 -2 11 19 -12 11 19 -5 11 19 12 -55 0 13 -2 14 15 -17 0 10 -11 11 19 -14 11 19 -13 11 19 11 12 -27 0 10 -7 11 19 -7 11 12 -5 0 10 -2 11 19 -12 11 12 -5 0 10 -15 11 12 -5 0 10 -7 11 19 -16 11 19 -2 11 19 -2 11 19 -13 11 19 -6 11 19 -2 11 19 -2 11 19 -2 11 19 -12 11 19 -7 11 20 -6 14 15 -174 0 -22 11 12 -55 0 10 -2 11 12 -17 0 10 -9 11 19 -25 11 19 -6 11 12 -27 0 10 -3 11 19 -10 11 19 12 -5 0 10 -15 11 12 -5 0 10 -11 11 19 -3 11 12 -5 0 10 -11 11 19 -3 11 19 -2 11 19 -2 11 19 -11 11 19 -2 11 19 -10 11 19 -18 11 19 -5 11 19 -2 11 19 -8 11 19 -3 11 12 -174 0 -21 11 19 12 -55 0 10 11 19 12 -17 0 10 -22 11 19 -8 11 19 -2 11 19 -7 11 12 -27 0 10 -6 11 19 -4 11 19 -3 11 12 -5 0 10 11 19 -11 11 19 11 12 -5 0 10 -15 11 12 -5 0 10 -23 11 19 -8 11 19 -17 11 19 -19 11 19 -8 11 19 -8 11 12 -174 0 -3 11 19 -9 11 19 -8 11 12 -55 0 10 -2 11 12 -17 0 10 -5 11 19 -8 11 19 -2 11 19 -23 11 19 12 -27 0 10 -2 11 19 -12 11 12 -5 0 10 -8 11 19 -6 11 12 -5 0 10 -3 11 19 -11 11 12 -5 0 10 -5 11 19 -2 11 19 -5 11 19 -6 11 19 -14 11 19 -4 11 19 -31 11 19 -2 11 19 11 19 -7 11 19 11 12 -174 0 -22 11 12 -55 0 10 -2 11 12 -17 0 10 -23 11 19 -9 11 19 -4 11 19 -3 11 12 -27 0 10 -9 11 19 -5 11 12 -5 0 10 -7 11 19 -7 11 12 -5 0 10 -2 11 19 -12 11 12 -5 0 10 -7 11 19 -2 11 19 -12 11 19 -4 11 19 -4 11 19 -2 11 19 -3 11 19 -3 11 19 -5 11 19 -4 11 19 -5 11 19 -8 11 19 -10 11 19 -6 11 21 -6 8 9 -167 0 -5 11 19 -16 11 12 -55 0 10 -2 11 12 -17 0 10 -3 11 19 -9 11 19 -28 11 12 -27 0 10 -4 11 19 -10 11 12 -5 0 10 -3 11 19 -10 11 19 12 -5 0 10 -15 11 12 -5 0 10 -14 11 19 -4 11 19 -23 11 19 -2 11 19 -14 11 19 -9 11 -2 19 -7 11 19 -2 11 19 -4 11 20 -6 14 15 -167 0 -11 11 19 -10 11 12 -55 0 10 19 11 12 -17 0 10 -25 11 19 -16 11 12 -27 0 10 19 -2 11 19 -2 11 19 -8 11 12 -5 0 10 -6 11 19 -4 11 19 -3 11 12 -5 0 10 11 19 -11 11 19 11 12 -5 0 10 -8 11 19 -2 11 19 -12 11 19 -4 11 19 -2 11 19 -23 11 19 -9 11 19 -22 11 19 -5 11 12 -167 0 -9 11 19 -12 11 12 -55 0 10 -2 11 12 -17 0 10 -5 11 19 -25 11 19 -3 11 19 -6 11 12 -27 0 10 -11 11 19 -3 11 12 -5 0 10 -2 11 19 -12 11 12 -5 0 10 -8 11 19 -6 11 12 -5 0 10 -3 11 19 -12 11 19 -2 11 19 -8 11 19 -15 11 19 -2 11 19 -7 11 19 -2 11 19 -6 11 19 -2 11 19 -3 11 19 -5 11 19 -2 11 19 -2 11 19 -8 11 19 11 12 -167 0 -18 11 19 -3 11 12 -55 0 10 11 19 12 -17 0 10 -11 11 19 -17 11 19 -12 11 12 -27 0 10 -4 11 19 -2 11 19 -7 11 12 -5 0 10 -9 11 19 -5 11 12 -5 0 10 -7 11 19 -7 11 12 -5 0 10 -2 11 19 -4 11 19 -16 11 19 -7 11 19 -4 11 19 -13 11 19 -31 11 19 -10 11 19 12 -167 0 -5 11 19 -8 11 19 -2 11 19 -4 11 12 -55 0 10 -2 11 12 -17 0 10 -9 11 19 -28 11 19 -3 11 12 -27 0 10 -15 11 12 -5 0 10 -4 11 19 -10 11 12 -5 0 10 -3 11 19 -10 11 19 12 -5 0 10 -15 11 19 -13 11 19 -2 11 19 -10 11 19 -12 11 19 -2 11 19 -6 11 19 -2 11 19 -8 11 19 11 19 -8 11 19 -5 11 21 -6 8 9 -160 0)
    )
  )
)
