(supertux-level
  (version 3)
  (name (_ "Ice Crushers"))
  (author "Sophie \"Vaesea\" Ball")
  (license "CC-BY-SA 4.0 International")
  (target-time 88)
  (allow-item-pocket "inherit")
  (icon "")
  (icon-locked "")
  (statistics
    (enable-coins #t)
    (enable-secrets #t)
  )
  (sector
    (name "main")
    (ambient-light
      (color 0.5 0.5 0.5)
    )
    (background
      (color 1 1 1)
      (speed 0.5)
      (image-top "/images/background/cave2.jpg")
      (image "/images/background/cave2.jpg")
      (image-bottom "/images/background/cave2.jpg")
    )
    (bouncingsnowball
      (z-pos 50)
      (direction "left")
      (x 896)
      (y 2912)
      (glinting #f)
    )
    (camera
      (name "Camera")
      (mode "normal")
    )
    (candle
      (z-pos -99)
      (x 768)
      (y 2944)
    )
    (candle
      (z-pos -99)
      (x 608)
      (y 2944)
    )
    (candle
      (z-pos -99)
      (x 1504)
      (y 2400)
    )
    (candle
      (z-pos -99)
      (x 2304)
      (y 2400)
    )
    (candle
      (z-pos -99)
      (x 2432)
      (y 2400)
    )
    (candle
      (z-pos -99)
      (x 2912)
      (y 3008)
    )
    (candle
      (z-pos -99)
      (x 2944)
      (y 3008)
    )
    (candle
      (z-pos -99)
      (x 1280)
      (y 1856)
    )
    (candle
      (z-pos -99)
      (x 1376)
      (y 1856)
    )
    (candle
      (z-pos -99)
      (x 1536)
      (y 1856)
    )
    (candle
      (z-pos -99)
      (x 1120)
      (y 1856)
    )
    (candle
      (z-pos -99)
      (x 1024)
      (y 1856)
    )
    (candle
      (z-pos -99)
      (x 1568)
      (y 1184)
    )
    (candle
      (z-pos -99)
      (x 1760)
      (y 1184)
    )
    (candle
      (z-pos -99)
      (x 2816)
      (y 544)
    )
    (candle
      (z-pos -99)
      (x 1376)
      (y 672)
    )
    (candle
      (z-pos -99)
      (x 3936)
      (y 2976)
    )
    (candle
      (z-pos -99)
      (x 4000)
      (y 2976)
    )
    (candle
      (z-pos -99)
      (x 4576)
      (y 2624)
    )
    (candle
      (z-pos -99)
      (x 4704)
      (y 2624)
    )
    (candle
      (z-pos -99)
      (x 5152)
      (y 2272)
    )
    (candle
      (z-pos -99)
      (x 5024)
      (y 2272)
    )
    (candle
      (z-pos -99)
      (x 5632)
      (y 1920)
    )
    (candle
      (z-pos -99)
      (x 6368)
      (y 1568)
    )
    (candle
      (z-pos -99)
      (x 6464)
      (y 1568)
    )
    (crusher
      (z-pos 50)
      (x 1056)
      (y 2592)
    )
    (crusher
      (type "ice-krosh")
      (z-pos 50)
      (x 1728)
      (y 2112)
    )
    (crusher
      (type "ice-krosh")
      (z-pos 50)
      (x 2016)
      (y 2112)
    )
    (crusher
      (z-pos 50)
      (x 2528)
      (y 2112)
    )
    (crusher
      (z-pos 50)
      (x 2912)
      (y 2720)
    )
    (crusher
      (type "ice-krosh")
      (z-pos 50)
      (x 1440)
      (y 1440)
    )
    (crusher
      (type "ice-krosh")
      (z-pos 50)
      (x 1120)
      (y 1440)
    )
    (crusher
      (type "ice-krosh")
      (z-pos 50)
      (x 896)
      (y 1440)
    )
    (crusher
      (z-pos 50)
      (x 1984)
      (y 928)
    )
    (crusher
      (z-pos 50)
      (x 3040)
      (y 576)
    )
    (crusher
      (type "ice-krosh")
      (z-pos 50)
      (x 2464)
      (y 288)
    )
    (crusher
      (type "ice-krosh")
      (z-pos 50)
      (x 2144)
      (y 288)
    )
    (crusher
      (type "ice-krosh")
      (z-pos 50)
      (x 1824)
      (y 288)
    )
    (crusher
      (z-pos 50)
      (x 4288)
      (y 2656)
    )
    (crusher
      (z-pos 50)
      (x 4928)
      (y 2304)
    )
    (crusher
      (z-pos 50)
      (x 5568)
      (y 1952)
    )
    (crusher
      (z-pos 50)
      (x 6208)
      (y 1600)
    )
    (door
      (z-pos -99)
      (sector "main")
      (locked #f)
      (spawnpoint "two")
      (x 1256)
      (y 608)
    )
    (door
      (z-pos -99)
      (sector "main")
      (locked #f)
      (spawnpoint "back")
      (x 3832)
      (y 2912)
    )
    (firefly
      (z-pos 0)
      (x 1056)
      (y 1280)
    )
    (flyingsnowball
      (z-pos 50)
      (x 2464)
      (y 864)
      (glinting #f)
    )
    (flyingsnowball
      (z-pos 50)
      (x 2624)
      (y 800)
      (glinting #f)
    )
    (haywire
      (z-pos 50)
      (direction "left")
      (x 6208)
      (y 1920)
      (glinting #f)
    )
    (jumpy
      (z-pos 50)
      (x 2240)
      (y 864)
      (glinting #f)
    )
    (jumpy
      (z-pos 50)
      (x 1888)
      (y 1824)
      (glinting #f)
    )
    (jumpy
      (z-pos 50)
      (x 2368)
      (y 1824)
      (glinting #f)
    )
    (jumpy
      (z-pos 50)
      (x 1920)
      (y 2400)
      (glinting #f)
    )
    (jumpy
      (z-pos 50)
      (x 5344)
      (y 2240)
      (glinting #f)
    )
    (mrbomb
      (z-pos 50)
      (direction "left")
      (x 4928)
      (y 2624)
      (glinting #f)
    )
    (mrbomb
      (z-pos 50)
      (direction "left")
      (x 4768)
      (y 2624)
      (glinting #f)
    )
    (music
      (file "/music/antarctic/cave.music")
    )
    (sequencetrigger
      (sequence "endsequence")
      (width 32)
      (height 288)
      (x 6560)
      (y 1312)
    )
    (smartball
      (z-pos 50)
      (direction "left")
      (x 2976)
      (y 544)
      (glinting #f)
    )
    (smartball
      (z-pos 50)
      (direction "left")
      (x 2560)
      (y 2400)
      (glinting #f)
    )
    (smartblock
      (z-pos 50)
      (direction "left")
      (x 2528)
      (y 1856)
      (glinting #f)
    )
    (smartblock
      (z-pos 50)
      (direction "left")
      (x 1568)
      (y 1856)
      (glinting #f)
    )
    (smartblock
      (z-pos 50)
      (direction "left")
      (x 6048)
      (y 1920)
      (glinting #f)
    )
    (spawnpoint
      (name "main")
      (x 64)
      (y 2912)
    )
    (spawnpoint
      (name "back")
      (x 1264)
      (y 640)
    )
    (spawnpoint
      (name "two")
      (x 3840)
      (y 2944)
    )
    (tilemap
      (solid #f)
      (z-pos -100)
      (width 250)
      (height 100)
      (tiles -3037 0 -5 2180 2182 -244 0 -2 2180 2181 2179 2182 2194 -244 0 2180 2188 2189 2182 2194 -245 0 2180 2196 2182 2194 -246 0 2180 2182 2194 -18 0 1628 1629 -8 0 1628 1629 -8 0 1628 1629 -6 0 2185 -4 2199 2186 -195 0 2182 2194 -19 0 1630 1631 -8 0 1630 1631 -8 0 1630 1631 -5 0 2185 2200 2180 2181 2188 2189 2198 2186 -477 0 2184 -15 2180 2182 -233 0 2193 2184 2181 2196 2189 2180 2181 2196 2189 2180 2181 2196 2189 2180 2181 2182 2194 -234 0 2193 2184 2179 2196 2188 2189 2179 2196 2188 2189 2179 2196 2188 2182 2194 -236 0 2193 2183 2184 2197 2187 2195 2179 2197 2187 2195 2182 2183 2194 -239 0 2193 2184 2197 2179 2195 2187 2197 2182 2194 -242 0 2193 -5 2183 2194 -763 0 1628 1629 -248 0 1630 1631 -449 0 -5 2180 2182 -29 0 2185 -2 2199 2186 -210 0 2181 2196 2189 2180 2181 2182 2194 -27 0 2185 2199 2200 2179 2197 2198 2199 2186 -207 0 2188 2189 2179 2196 2188 2182 2194 -27 0 2185 2200 2197 2179 2195 2187 2197 2179 2198 2186 -205 0 2179 2197 2187 2195 2182 2183 2194 -27 0 2185 2200 2180 2181 2196 2189 2180 2181 2196 2189 2198 2186 -203 0 2187 2195 2187 2197 2182 2194 -244 0 -4 2183 2194 -1015 0 1628 1629 -248 0 1630 1631 -150 0 2184 -15 2180 2182 -3 0 2184 -15 2180 -204 0 130 -9 0 2193 2184 2181 2196 2189 2180 2181 2196 2189 2180 2181 2196 2189 2180 2181 2182 2194 -3 0 2193 2184 2180 2181 2196 2189 2180 2181 2196 2189 2180 2181 2196 2189 2180 2181 -204 0 129 -10 0 2193 2184 2179 2196 2188 2189 2179 2196 2188 2189 2179 2196 2188 2182 2194 -5 0 2193 2184 2189 2179 2196 2188 2189 2179 2196 2188 2189 2179 2196 2188 2189 -204 0 129 -11 0 2193 2183 2184 2197 2187 2195 2179 2197 2187 2195 2182 2183 2194 -7 0 2192 2187 2195 2179 2197 2187 2195 2179 2197 2187 2195 2179 2197 2187 -204 0 129 -13 0 2193 2184 2197 2179 2195 2187 2197 2182 2194 -9 0 2192 2197 2179 2195 2187 2197 2179 2195 2187 2197 2179 2195 2187 2197 -204 0 129 -14 0 2193 -5 2183 2194 -10 0 2192 2181 2196 2189 2180 2181 2196 2189 2180 2181 2196 2189 2180 2181 -204 0 129 -31 0 2192 2189 2179 2196 2188 2189 2179 2196 2188 2189 2179 2196 2188 2189 -204 0 129 -31 0 2192 2187 2195 2179 2197 2187 2195 2179 2197 2187 2195 2179 2197 2187 -50 0 2184 -15 2180 2182 -137 0 129 -30 0 2185 2200 2197 2179 2195 2187 2197 2179 2195 2187 2197 2179 2195 2187 2197 -50 0 2193 2184 2181 2196 2189 2180 2181 2196 2189 2180 2181 2196 2189 2180 2181 2182 2194 -137 0 129 -29 0 2185 2200 2180 2181 2196 2189 2180 2181 2196 2189 2180 2181 2196 2189 2180 2181 -51 0 2193 2184 2179 2196 2188 2189 2179 2196 2188 2189 2179 2196 2188 2182 2194 -169 0 -15 2180 -52 0 2193 2183 2184 2197 2187 2195 2179 2197 2187 2195 2182 2183 2194 -239 0 2193 2184 2197 2179 2195 2187 2197 2182 2194 -242 0 2193 -5 2183 2194 -511 0 2185 -2 2199 2186 -244 0 2185 2199 2200 2179 2197 2198 2199 2186 -204 0 1628 1629 -6 0 1628 1629 -6 0 1628 1629 -19 0 2185 2200 2197 2179 2195 2187 2197 2179 2198 2186 -203 0 1630 1631 -4 32 -2 0 1630 1631 -2 0 -4 32 1630 1631 -18 0 2185 2200 2180 2181 2196 2189 2180 2181 2196 2189 2198 2186 -239 0 -10 2180 -698 0 -4 32 -814 0 2185 2199 -247 0 2185 2200 2180 -246 0 2185 2200 2181 2180 -244 0 2185 2199 2200 2188 2189 2180 -243 0 2185 2200 2195 2179 2197 2187 2180 -242 0 2199 2200 2197 2179 2195 2187 2197 2180 -242 0 -2 2180 2181 2196 2189 2180 2181 2180 -242 0 2180 2188 2189 2179 2196 2188 2189 2180 -242 0 2180 2197 2187 2195 2179 2197 2187 2180 -242 0 2193 2184 2197 -5 2180 -178 0 2198 2186 -27 0 1628 1629 -7 0 1628 1629 -25 0 2193 -2 2183 -182 0 2180 2198 2186 -26 0 1630 1631 -7 0 1630 1631 -210 0 2180 2197 2190 -45 0 -4 2180 2190 -197 0 2180 2187 2198 2186 -13 0 2185 -30 0 -2 2180 2181 2196 2190 -197 0 -2 2180 2181 2198 2186 -11 0 2185 2200 2180 -29 0 2180 2188 2189 2182 2194 -197 0 2180 2188 2189 2179 2198 2186 -10 0 2200 -2 2180 -29 0 2180 2197 2187 2190 -198 0 -5 2180 -43 0 2180 2187 2197 2190 -246 0 -2 2180 2181 2198 2186 -171 0 -23 2180 2182 -50 0 2180 2188 2189 2179 2190 -171 0 2180 2181 2196 2189 2197 2187 2195 2179 2197 2187 2195 2179 2197 2187 2195 2179 2197 2187 2195 2179 2197 2187 2182 2194 -50 0 -4 2180 -172 0 2188 2189 2179 2196 2187 2197 2179 2195 2187 2197 2179 2195 2187 2197 2179 2195 2187 2197 2179 2195 2187 2182 2194 -227 0 2197 2187 2195 2179 2180 2181 2196 2189 2180 2181 2196 2189 2180 2181 2196 2189 2180 2181 2196 2189 2180 2190 -62 0 -6 2180 2190 -159 0 2187 2197 2179 2195 2188 2189 2179 2196 2188 2189 2179 2196 2188 2189 2179 2196 2188 2189 2179 2196 2182 2194 -7 0 33 32 34 -52 0 2180 2195 2179 2197 2187 2182 2194 -159 0 2197 2187 2195 2179 2197 2187 2195 2179 2197 2187 2195 2179 2197 2187 2195 2179 2197 2187 2195 2179 2190 -60 0 2192 -3 2180 2179 2195 2187 2197 2190 -160 0 2187 2197 2179 2195 2187 2197 2179 2195 2187 2197 2179 2195 2187 2197 2179 2195 2187 2197 2179 2195 2198 2186 -59 0 2193 2184 2180 2181 2196 2189 2180 2181 2190 -160 0 2180 2181 2196 2189 2180 2181 2196 2189 2180 2181 2196 2189 2180 2181 2196 2189 2180 2181 2196 2189 2180 2190 -11 0 1628 1629 -47 0 2192 2188 2189 2179 2196 2188 2189 2190 -160 0 2188 2189 2179 2196 2188 2189 2179 2196 2188 2189 2179 2196 2188 2189 2179 2196 2188 2189 2179 2196 2188 2198 2186 -10 0 1630 1631 -47 0 2192 2197 2187 2195 2179 2197 2187 2190 -160 0 2197 2187 2195 2179 2197 2187 2195 2179 2197 2187 2195 2179 2197 2187 2195 2179 2197 2187 2195 2179 2197 2187 2198 2186 -58 0 2192 2187 2197 2179 2195 2187 2197 2198 2186 -159 0 -23 2180 -58 0 2185 2200 2180 2181 2196 2189 2180 2181 2196 2198 2186 -240 0 -4 2180 2196 2188 2189 2179 2196 2198 2186 -242 0 -7 2180 -1158 0)
    )
    (tilemap
      (solid #f)
      (z-pos 100)
      (width 250)
      (height 100)
      (tiles -10456 0 130 -249 0 129 -249 0 129 -249 0 129 -249 0 129 -249 0 129 -249 0 129 -249 0 129 -249 0 129 -12543 0)
    )
    (tilemap
      (solid #t)
      (z-pos 0)
      (width 250)
      (height 100)
      (tiles -2057 36 -4 41 -2 36 -2 41 -2 36 -4 41 -2 36 -2 41 -2 36 -4 41 -225 36 43 -4 0 38 43 -2 0 38 43 -4 0 38 43 -2 0 38 43 -4 0 38 -224 36 43 -4 0 38 43 -2 0 38 43 -4 0 38 43 -2 0 38 43 -4 0 38 -224 36 43 -4 0 38 43 -2 0 38 43 -4 0 38 43 -2 0 38 43 -4 0 38 -206 36 -18 41 42 -4 0 40 42 -2 0 40 42 -4 0 40 42 -2 0 40 42 -4 0 40 -15 41 -190 36 43 -59 0 38 -189 36 43 -59 0 38 -189 36 43 -25 0 33 34 -8 0 33 34 -22 0 38 -189 36 43 -25 0 35 39 -8 0 35 39 -22 0 38 -189 36 43 -18 0 33 -4 44 -2 32 38 43 -2 32 -4 44 -2 32 38 43 -2 32 -4 44 -13 32 34 -2 0 38 -189 36 43 -18 0 35 -6 37 -2 36 -8 37 -2 36 -19 37 39 -2 0 38 -189 36 43 -18 0 38 -3 36 -34 41 42 -2 0 38 -189 36 43 -18 0 38 -2 36 43 -37 0 38 -189 36 43 -18 32 38 -2 36 43 -37 0 38 -190 36 -18 37 -3 36 43 -37 0 38 -211 36 43 -37 0 38 -211 36 43 -37 0 38 -211 36 43 -37 0 38 -211 36 43 -37 0 38 -211 36 43 -37 0 38 -211 36 43 32 34 -2 0 33 -6 32 34 -18 0 33 -6 32 38 -212 36 37 39 -2 0 35 -6 37 39 34 -17 0 35 -6 37 -200 36 -14 41 42 -2 0 40 -2 41 -5 36 39 34 -16 0 38 -205 36 42 -20 0 38 -5 36 39 34 -15 0 38 -204 36 42 -21 0 38 -6 36 39 34 -14 0 38 -203 36 42 -6 0 44 0 44 -13 0 38 -7 36 39 -14 32 38 -201 36 41 42 -6 0 44 -3 0 44 -12 0 38 -8 36 -14 37 -199 36 -2 41 42 -25 0 38 -217 36 -3 41 42 -28 0 38 -210 36 -6 41 42 -32 0 38 -209 36 43 -20 0 -2 48 -5 0 -2 48 -10 0 38 -209 36 43 -19 0 50 49 48 -5 0 48 50 49 -9 0 38 -209 36 43 -14 0 33 -3 32 48 51 52 48 -5 2178 48 51 52 48 -8 32 38 -126 36 -56 41 -27 36 43 -4 0 33 -9 32 35 -24 37 -126 36 43 -56 0 -27 36 43 -4 0 35 -9 37 -151 36 43 -56 0 -27 36 43 -4 0 38 -160 36 43 -56 0 -27 36 43 -4 0 38 -2 36 -4 41 -6 36 -4 41 -144 36 43 -56 0 -27 36 43 -4 0 38 36 43 -4 0 38 -4 36 43 -4 0 38 -143 36 43 -56 0 -27 36 43 -4 0 38 36 43 -4 0 38 -4 36 43 -4 0 38 -143 36 43 -56 0 -27 36 43 -4 0 38 36 43 -4 0 38 -4 36 43 -4 0 38 -143 36 43 -56 0 -27 36 43 -4 0 40 41 42 -4 0 40 -4 41 42 -4 0 40 -32 41 -111 36 43 -56 0 -27 36 43 -54 0 40 -110 36 43 -2 0 33 -53 32 -27 36 43 -55 0 40 -3 41 -106 36 43 -2 0 35 -53 37 -27 36 43 -59 0 40 -3 41 -83 36 -19 41 42 -2 0 38 -80 36 43 -63 0 40 -81 36 43 -22 0 38 -80 36 43 -64 0 40 -80 36 43 -22 0 38 -80 36 43 -65 0 40 -3 41 -76 36 43 -22 0 38 -80 36 43 -13 0 -2 83 -54 0 38 -75 36 43 -22 0 38 -80 36 43 -69 0 38 -75 36 43 -22 0 38 -80 36 43 -69 0 38 -75 36 43 -2 83 -20 0 38 -80 36 43 -4 0 33 -2 32 -4 44 -6 32 -4 44 32 34 -5 0 33 -5 32 34 -5 0 33 -11 32 34 -16 0 38 -75 36 43 -22 0 38 -80 36 43 -4 0 35 -17 37 39 -5 0 35 -5 37 39 -5 0 35 -11 37 39 34 -15 0 38 -75 36 43 -22 0 38 -80 36 43 -4 0 38 -17 36 43 -5 2178 38 -5 36 43 -5 2178 38 -12 36 39 34 -14 0 38 -75 36 43 -2 0 33 -19 32 38 -80 36 43 -4 0 38 -18 36 -5 37 -7 36 -5 37 -14 36 39 34 -13 0 38 -75 36 43 -2 0 35 -19 37 -81 36 43 -4 44 38 -50 36 39 34 -12 0 38 -56 36 -19 41 42 -2 0 38 -101 36 -4 37 -52 36 39 34 -11 0 38 -55 36 43 -22 0 38 -158 36 39 -11 0 38 -55 36 43 -22 0 38 -127 36 -4 41 -5 36 -4 41 -12 36 -2 41 -4 36 43 34 -10 0 38 -55 36 43 -22 0 38 -126 36 43 -4 0 38 -3 36 43 -4 0 38 -10 36 43 -2 0 38 -4 36 39 -9 0 104 38 -55 36 43 -22 0 38 -126 36 43 -4 0 38 -3 36 43 -4 0 38 36 -9 41 42 -2 0 40 -4 36 43 34 -9 0 38 -55 36 43 -3 0 -5 44 -14 0 38 -126 36 43 -4 0 38 -3 36 43 -4 0 38 43 -13 0 38 -4 36 39 34 -8 0 38 -55 36 43 -3 0 27 -3 28 29 -14 0 38 -122 36 -4 41 42 -4 0 40 -3 41 42 -4 0 40 42 -13 0 38 -5 36 39 32 34 -6 0 38 -55 36 43 -22 0 38 -117 36 -4 41 42 -33 0 38 -6 36 37 39 -4 0 -2 83 38 -55 36 43 -22 0 38 -115 36 41 42 -38 0 38 -7 36 43 -6 0 38 -55 36 43 -2 0 33 -19 32 38 -113 36 41 42 -31 0 -3 77 -6 0 38 -7 36 43 -6 0 38 -55 36 43 -2 0 35 -19 37 -112 36 41 42 -42 0 38 -7 36 43 -2 0 33 -3 32 38 -40 36 -15 41 42 -2 0 38 -120 36 -10 41 42 -44 0 38 -7 36 43 -2 0 35 -3 37 -40 36 42 -18 0 38 -119 36 43 -17 0 33 -5 32 34 -19 0 33 -7 32 34 -2 0 33 38 -7 36 43 -2 0 38 -42 36 42 -19 0 38 -119 36 43 -17 0 35 -5 37 39 -3 32 -4 44 -5 32 -4 44 -3 32 35 -7 37 39 -2 77 35 -8 36 43 -2 0 38 -41 36 43 -20 0 38 -119 36 43 -17 0 38 -6 36 -19 37 -5 36 -3 41 42 -2 0 38 -8 36 43 -2 0 38 -41 36 43 -20 0 38 -119 36 43 -17 0 38 -29 36 43 -6 0 38 -8 36 43 -2 0 38 -40 36 41 42 -20 0 38 -119 36 43 -17 0 38 -29 36 43 -6 0 38 -8 36 43 -2 0 38 -39 36 43 -9 0 -5 83 -8 0 38 -119 36 43 -5 32 34 -2 0 33 -8 32 38 -29 36 43 102 83 -4 0 38 -8 36 43 -2 0 38 -39 36 43 -22 0 38 -120 36 -5 37 39 -2 0 35 -8 37 -30 36 43 -6 0 38 -8 36 43 -2 0 38 -39 36 43 -22 0 38 -120 36 -5 41 42 -2 0 40 -2 41 -37 36 -6 0 38 -8 36 43 -2 0 38 -39 36 43 -2 0 33 -19 32 38 -93 36 -26 41 42 -11 0 38 -36 36 -3 32 34 -2 0 38 -8 36 43 -2 0 38 -39 36 43 -2 0 35 -19 37 -94 36 -38 0 38 -36 36 -3 37 39 -2 0 38 -8 36 43 -2 0 38 -24 36 -15 41 42 -2 0 38 -113 36 -38 0 38 -39 36 43 -2 0 38 -8 36 43 -2 0 38 -23 36 43 -18 0 38 -113 36 -38 0 38 -39 36 43 -2 0 38 -3 36 -5 41 42 -2 0 38 -23 36 43 -18 0 38 -113 36 -29 0 -3 44 -4 0 33 32 38 -39 36 43 -2 0 38 -2 36 43 -8 0 38 -23 36 43 -18 0 38 -113 36 -11 0 33 -3 32 34 -13 0 119 121 120 -4 0 119 121 -40 36 43 -2 0 40 -2 41 42 -8 0 38 -23 36 43 -18 0 38 -113 36 -9 0 -2 83 119 -3 121 120 102 83 -20 0 38 -39 36 43 -14 0 38 -23 36 43 -18 0 38 -113 36 -38 0 38 -39 36 43 -14 0 38 -23 36 43 -5 0 83 102 83 -10 0 38 -113 36 -27 0 33 -10 32 38 -39 36 43 -14 0 38 -23 36 43 -18 0 38 -113 36 -27 32 35 -10 37 -40 36 43 -14 0 38 -23 36 43 -18 0 38 -113 36 -27 37 -51 36 43 -6 32 34 -7 0 38 -23 36 43 -18 32 38 -192 36 -6 37 39 -7 32 38 -24 36 -18 37 -200 36 -7 37 -1157 36)
    )
    (tilemap
      (solid #f)
      (z-pos -99)
      (width 250)
      (height 100)
      (tiles -4083 0 106 107 108 -221 0 -4 32 -6 0 -4 32 -6 0 -4 32 -2 0 109 110 111 -709 0 106 107 108 -247 0 109 110 111 -1544 0 106 107 108 -247 0 109 110 111 -983 0 106 107 108 -247 0 109 110 111 -1483 0 106 107 108 -218 0 106 107 108 -26 0 109 110 111 -218 0 109 110 111 -1911 0 106 107 108 -17 0 106 107 108 -16 0 106 107 108 -8 0 106 -199 0 109 110 111 -17 0 109 110 111 -16 0 109 110 111 -8 0 109 -1806 0 106 107 108 -14 0 106 107 108 -230 0 109 110 111 -14 0 109 110 111 -360 0 106 107 108 -247 0 109 110 111 -90 0 106 107 108 -247 0 109 110 111 -2128 0 106 107 108 -247 0 109 110 111 -181 0 106 107 108 -247 0 109 110 111 -462 0 106 107 108 -242 0 -4 32 0 109 110 111 0 -4 32 -711 0 106 107 108 -247 0 109 110 111 -369 0 106 107 108 -247 0 109 110 111 -1882 0 106 107 108 -218 0 106 107 108 -26 0 109 110 111 -218 0 109 110 111 -114 0 106 107 108 -212 0 106 107 108 -32 0 109 110 111 -212 0 109 110 111 -1409 0)
    )
    (torch
      (sprite "/images/objects/torch/torch3.sprite")
      (z-pos 0)
      (x 6784)
      (y 1504)
    )
    (trampoline
      (type "stationary")
      (z-pos 50)
      (x 2928)
      (y 2688)
    )
  )
)
