(supertux-level
  (version 3)
  (name (_ "Intro"))
  (author "Sophie \"Vaesea\" Ball")
  (license "CC-BY-SA 4.0 International")
  (allow-item-pocket "inherit")
  (icon "")
  (icon-locked "")
  (statistics
    (enable-coins #t)
    (enable-secrets #t)
  )
  (sector
    (name "main")
    (init-script "Text.set_text(\"Somewhere in a very cold place named Icy Island...\");
Tux.set_bonus(\"grow\");
Letter.set_visible(false);
Nolok.set_action(\"stand-left\");
Tux.deactivate();
Tux.set_dir(true);
Text.set_font(\"normal\");
Text.fade_in(1);
wait(3);
Text.fade_out(1);
wait(1);
Tux.walk(320);")
    (ambient-light
      (color 1 1 1)
    )
    (background
      (scroll-offset-x 928)
      (scroll-offset-y 704)
      (color 1 1 1)
      (speed 0.5)
      (image-top "/images/background/semi_arctic.jpg")
      (image "/images/background/semi_arctic.jpg")
      (image-bottom "/images/background/semi_arctic.jpg")
    )
    (camera
      (name "Camera")
      (mode "normal")
    )
    (decal
      (z-pos 50)
      (sprite "/images/engine/menu/logo.png")
      (x 1568)
      (y 512)
    )
    (music
      (file "/music/misc/intro.music")
    )
    (particles-snow
    )
    (scriptedobject
      (z-pos 50)
      (name "Penny")
      (sprite "/images/creatures/penny/penny.sprite")
      (x 3744)
      (y 896)
    )
    (scriptedobject
      (z-pos -50)
      (physic-enabled #f)
      (solid #f)
      (name "Tree")
      (sprite "/images/tiles/doodads/iceshrub.sprite")
      (x 3904)
      (y 832)
    )
    (scriptedobject
      (z-pos -100)
      (name "Nolok")
      (sprite "/images/creatures/nolok/nolok.sprite")
      (x 3948)
      (y 896)
    )
    (scriptedobject
      (z-pos 50)
      (physic-enabled #f)
      (solid #f)
      (name "Fish")
      (sprite "/images/objects/eat-me/eat-me.sprite")
      (x 3648)
      (y 920)
    )
    (scriptedobject
      (z-pos 50)
      (physic-enabled #f)
      (solid #f)
      (name "Letter")
      (sprite "/images/objects/letter/letter-small.sprite")
      (x 3968)
      (y 896)
    )
    (scripttrigger
      (oneshot #t)
      (script "Tux.walk(0);
wait(1);
Text.set_text(\"There were two penguins named Tux and Penny.\");
Text.set_font(\"normal\");
Text.fade_in(1);
wait(3);
Text.fade_out(1);
wait(1.5);
Text.set_text(\"They were having a picnic, when suddenly...\");
Text.fade_in(1);
wait(3);
Text.fade_out(1);
wait(1.5);
Nolok.set_action(\"walk-left\");
Nolok.set_velocity(-320, -256);
wait(0.1);
Tux.walk(-140);
Tux.do_jump(-256);
wait(0.2);
Effect.fade_out(0.1);
wait(0.1);
Tux.walk(0);
Penny.set_solid(false);
Penny.set_visible(false);
Nolok.set_solid(false);
Nolok.set_visible(false);
Letter.set_visible(true);
Fish.set_visible(false);
wait(2);
Effect.fade_in(1);
wait(1.5);
Text.set_text(\"Tux and Penny were attacked by Nolok, and Nolok had put a letter on the tree!\");
Text.fade_in(1);
wait(4);
Text.fade_out(1);
wait(1.5);
Tux.walk(320);")
      (button #f)
      (width 32)
      (height 32)
      (x 3616)
      (y 928)
    )
    (scripttrigger
      (oneshot #t)
      (script "Tux.walk(0);
wait(0.5);
Text.set_text(\"When Tux read the letter, he was shocked! He didn't know who this strange Nolok guy was until now!\");
Text.set_font(\"normal\");
Text.fade_in(1);
wait(4);
Text.fade_out(1);
wait(1.5);
Tux.walk(320);
Text.set_text(\"Tux had to find Nolok and save Penny...\");
Text.fade_in(1);
wait(3);
Text.fade_out(1);
wait(1.5);
Effect.fade_out(2);
wait(3);
Level.finish(true);")
      (button #f)
      (width 32)
      (height 128)
      (x 3984)
      (y 928)
    )
    (spawnpoint
      (name "main")
      (x 64)
      (y 896)
    )
    (tilemap
      (solid #f)
      (z-pos -100)
      (width 200)
      (height 35)
      (tiles -2801 0 85 86 87 88 -63 0 85 86 87 88 -81 0 85 86 87 88 -42 0 85 0 89 90 91 92 -38 0 85 86 87 88 -21 0 89 90 91 92 -25 0 85 86 87 88 -23 0 85 86 87 88 -25 0 89 90 91 92 -23 0 85 86 87 88 -15 0 89 -43 0 89 90 91 92 -50 0 89 90 91 92 -23 0 89 90 91 92 -52 0 89 90 91 92 -1458 0 1321 1322 1323 1324 -167 0 122 123 -27 0 1325 1326 1327 1328 -30 0 122 123 -5 0 122 123 -70 0 122 123 -52 0 122 123 -2 0 124 125 -2 0 122 123 -23 0 1329 1330 1331 1332 -26 0 122 123 -2 0 124 125 -5 0 124 125 -2 0 122 123 -56 0 122 123 -8 0 124 125 -8 0 122 123 -19 0 1321 1322 1323 1324 -19 0 124 125 -2 0 124 125 -2 0 124 125 -23 0 1333 1334 1335 1336 -26 0 124 125 -2 0 124 125 -5 0 124 125 -2 0 124 125 -13 0 122 123 -31 0 122 123 -8 0 124 125 -8 0 124 125 -8 0 124 125 -8 0 122 123 -9 0 1325 1326 1327 1328 -10 0 106 107 108 -6 0 124 125 -2 0 124 125 -2 0 124 125 -11 0 106 107 108 -35 0 106 107 108 0 124 125 -2 0 124 125 -5 0 124 125 -2 0 124 125 -13 0 124 125 106 107 108 -28 0 124 125 -8 0 124 125 106 107 108 -5 0 124 125 -8 0 124 125 -8 0 124 125 -9 0 1329 1330 1331 1332 -4 0 106 107 108 -3 0 109 110 111 24 0 25 -3 0 124 125 0 24 124 125 -2 0 124 125 24 25 -9 0 109 110 111 0 24 -16 0 25 0 24 -14 0 109 110 111 0 124 125 -2 0 124 125 0 25 -2 0 24 124 125 -2 0 124 125 -2 0 24 -7 0 25 -2 0 124 125 109 110 111 -4 0 24 -8 0 25 -7 0 24 -6 0 124 125 0 24 0 25 -4 0 124 125 109 110 111 0 24 -3 0 124 125 0 24 -3 0 25 -2 0 124 125 0 24 -6 0 124 125 -3 0 24 -2 0 25 -2 0 1333 1334 1335 1336 0 24 -2 0 109 110 111 -2 0 25 -1000 0)
    )
    (tilemap
      (solid #f)
      (z-pos 100)
      (width 200)
      (height 35)
      (tiles -7000 0)
    )
    (tilemap
      (solid #t)
      (z-pos 0)
      (width 200)
      (height 35)
      (tiles -5442 0 2909 2910 2913 2914 -13 0 2909 2910 2913 2914 -161 0 2909 2910 2913 2914 -10 0 2909 2910 2921 2922 2911 2912 2915 2916 2917 2918 2913 2914 -5 0 2909 2910 2921 2922 2911 2912 2915 2916 2917 2918 2913 2914 -27 0 2909 2910 2913 2914 -102 0 -22 8 2921 2922 2911 2912 2915 2916 2917 2918 -6 8 2921 2922 2911 2912 2923 2924 1834 -2 11 1835 2919 2920 2915 2916 2917 2918 8 2921 2922 2911 2912 2923 2924 1834 -2 11 1835 2919 2920 2915 2916 2917 2918 -23 8 2921 2922 2911 2912 2915 2916 2917 2918 -100 8 -22 14 2923 2924 1834 -2 11 1835 2919 2920 -6 14 2923 2924 1834 -10 11 1835 2919 2920 14 2923 2924 1834 -10 11 1835 2919 2920 -23 14 2923 2924 1834 -2 11 1835 2919 2920 -100 14 -800 11)
    )
  )
)
