(supertux-level
  (version 3)
  (name (_ "Picnic With Penny"))
  (author "SuperTux Team")
  (license "GPL 2+ / CC-by-sa 3.0")
  (allow-item-pocket "inherit")
  (icon "")
  (icon-locked "")
  (statistics
    (enable-coins #t)
    (enable-secrets #t)
  )
  (sector
    (name "main")
    (init-script "import(\"levels/world1/intro.nut\");
trigger_state(\"start\");
")
    (ambient-light
      (color 1 1 1)
    )
    (camera
      (name "Camera")
      (mode "normal")
    )
    (gradient
      (top_color 0 0.85 1)
      (bottom_color 0 0.6 1)
    )
    (music
      (file "music/intro.ogg")
    )
    (particles-snow
    )
    (scriptedobject
      (z-pos 10)
      (visible #f)
      (solid #f)
      (name "LOGO")
      (sprite "/images/engine/menu/logo.png")
      (x 1568)
      (y 1024)
    )
    (scriptedobject
      (z-pos 50)
      (name "RADIO")
      (sprite "images/objects/radio/radio.sprite")
      (x 3404)
      (y 1302)
    )
    (scriptedobject
      (z-pos 50)
      (physic-enabled #f)
      (solid #f)
      (name "BUSH")
      (sprite "images/tiles/doodads/iceshrub.sprite")
      (x 3607)
      (y 1220)
    )
    (scriptedobject
      (z-pos 50)
      (name "NOLOK")
      (sprite "images/creatures/nolok/nolok.sprite")
      (x 3631)
      (y 1276)
    )
    (scriptedobject
      (z-pos 50)
      (name "PENNY")
      (sprite "images/creatures/penny/penny.sprite")
      (x 3489)
      (y 1280)
    )
    (scriptedobject
      (z-pos -100)
      (visible #f)
      (physic-enabled #f)
      (solid #f)
      (name "SIGN")
      (sprite "images/tiles/signs/right.sprite")
      (x 3200)
      (y 1280)
    )
    (scripttrigger
      (script "trigger_state(\"rap_scene\");")
      (button #f)
      (width 32)
      (height 520)
      (x 3380)
      (y 832)
    )
    (scripttrigger
      (script "trigger_state(\"end_level\");
")
      (button #f)
      (width 32)
      (height 380)
      (x 5760)
      (y 960)
    )
    (scripttrigger
      (script "trigger_state(\"logo_in\");
")
      (button #f)
      (width 32)
      (height 540)
      (x 1152)
      (y 800)
    )
    (scripttrigger
      (script "trigger_state(\"intro_text\");
")
      (button #f)
      (width 32)
      (height 540)
      (x 2528)
      (y 800)
    )
    (spawnpoint
      (name "main")
      (x 480)
      (y 1280)
    )
    (tilemap
      (solid #f)
      (z-pos -100)
      (width 200)
      (height 50)
      (tiles -7710 0 -5 1278 -58 0 1321 1322 1323 1324 -32 0 122 209 123 -24 0 122 209 123 -9 0 122 209 123 -16 0 122 209 123 -4 0 122 209 123 -18 0 122 209 123 -12 0 -4 1278 -45 0 122 209 123 -11 0 1325 1326 1327 1328 -17 0 122 209 123 -12 0 124 210 125 -5 0 141 142 -6 0 122 209 123 -8 0 124 210 125 -3 0 106 107 108 -3 0 124 210 125 -16 0 124 210 125 -4 0 124 210 125 -18 0 124 210 125 -12 0 -4 1278 -9 0 122 209 123 -16 0 106 107 108 -14 0 124 210 125 -11 0 1329 1330 1331 1332 -17 0 124 210 125 -12 0 1345 1346 1344 -5 0 143 144 -6 0 124 210 125 -2 0 24 0 25 -3 0 1345 1346 1344 -3 0 109 110 111 25 -2 0 1345 1346 1344 -9 0 25 -4 0 24 0 1345 1346 1344 -4 0 1345 1346 1344 -2 0 24 -2 0 25 -12 0 1345 1346 1344 -2 0 -4 8 -3 0 -6 1278 -4 8 -3 0 25 -2 0 124 210 125 -8 0 24 0 24 -5 0 109 110 111 -9 0 25 0 24 -2 0 1345 1346 1344 -7 0 25 -2 0 8 1333 1334 1335 1336 0 25 -11 0 -3 8 0 1345 1346 1344 -28 0 1345 1346 1344 -95 0 1345 1346 1344 -1474 0)
    )
    (tilemap
      (solid #t)
      (z-pos 0)
      (width 200)
      (height 50)
      (tiles -260 0 85 86 87 88 -180 0 85 86 87 88 -12 0 89 90 91 92 -97 0 85 86 87 88 -54 0 85 86 87 88 -21 0 89 90 91 92 -47 0 85 86 87 88 -46 0 85 86 87 88 -12 0 89 90 91 92 -54 0 89 90 91 92 -58 0 85 86 87 88 -10 0 89 90 91 92 -21 0 85 86 87 88 -21 0 89 90 91 92 -47 0 85 86 87 88 0 85 86 87 88 -76 0 89 90 91 92 -35 0 89 90 91 92 -58 0 85 86 87 88 -10 0 89 90 91 92 0 89 90 91 92 -30 0 85 86 87 88 -27 0 85 86 87 88 -32 0 85 86 87 88 -76 0 89 90 91 92 -49 0 89 90 91 92 -27 0 89 90 91 92 -32 0 89 90 91 92 -30 0 85 86 87 88 -27 0 85 86 87 88 -46 0 85 86 87 88 -32 0 85 86 87 88 -79 0 89 90 91 92 -27 0 89 90 91 92 -46 0 89 90 91 92 -32 0 89 90 91 92 -97 0 85 86 87 88 -46 0 85 86 87 88 -80 0 85 86 87 88 -62 0 89 90 91 92 -46 0 89 90 91 92 -66 0 85 86 87 88 -10 0 89 90 91 92 -53 0 85 86 87 88 -40 0 85 86 87 88 -81 0 89 90 91 92 -34 0 85 86 87 88 -13 0 85 86 87 88 -12 0 89 90 91 92 -26 0 85 86 87 88 -10 0 89 90 91 92 -119 0 89 90 91 92 -13 0 89 90 91 92 -42 0 89 90 91 92 -5421 0 -190 8 -2 0 -8 8 -200 14 -1400 11)
    )
    (tilemap
      (solid #f)
      (z-pos 100)
      (width 200)
      (height 50)
      (tiles -8021 0 106 107 108 -32 0 106 107 108 -105 0 106 107 108 -54 0 109 110 111 -32 0 109 110 111 -105 0 109 110 111 -54 0 -3 14 -32 0 -3 14 -105 0 -3 14 -433 0 -200 201 -800 200)
    )
  )
)
