(supertux-level
  (version 3)
  (name (_ "Jumping And Bouncing"))
  (author "Sophie \"Vaesea\" Ball")
  (license "CC-BY-SA 4.0 International")
  (target-time 68)
  (allow-item-pocket "inherit")
  (icon "")
  (icon-locked "")
  (statistics
    (enable-coins #t)
    (enable-secrets #t)
  )
  (sector
    (name "main")
    (ambient-light
      (color 1 1 1)
    )
    (background
      (color 1 1 1)
      (speed 0.5)
      (speed-y 0)
      (image-top "/images/background/icecliffs/icecliffs-top.png")
      (image "/images/background/icecliffs/icecliffs-middle.png")
      (image-bottom "/images/background/icecliffs/icecliffs-bottom.png")
    )
    (bonusblock
      (z-pos 51)
      (count 5)
      (sprite "/images/objects/bonus_block/purpleblock.sprite")
      (x 8928)
      (y 896)
    )
    (bonusblock
      (z-pos 51)
      (count 3)
      (sprite "/images/objects/bonus_block/orangeblock.sprite")
      (x 12512)
      (y 1664)
    )
    (bonusblock
      (z-pos 51)
      (count 3)
      (sprite "/images/objects/bonus_block/orangeblock.sprite")
      (x 15456)
      (y 1824)
    )
    (bouncingsnowball
      (z-pos 50)
      (direction "left")
      (x 4800)
      (y 1856)
      (glinting #f)
    )
    (bouncingsnowball
      (z-pos 50)
      (direction "left")
      (x 6592)
      (y 1824)
      (glinting #f)
    )
    (bouncingsnowball
      (z-pos 50)
      (direction "left")
      (x 3360)
      (y 1824)
      (glinting #f)
    )
    (bouncingsnowball
      (z-pos 50)
      (direction "left")
      (x 3616)
      (y 1792)
      (glinting #f)
    )
    (bouncingsnowball
      (z-pos 50)
      (direction "left")
      (x 7744)
      (y 1824)
      (glinting #f)
    )
    (bouncingsnowball
      (z-pos 50)
      (direction "left")
      (x 9696)
      (y 960)
      (glinting #f)
    )
    (bouncingsnowball
      (z-pos 50)
      (direction "left")
      (x 9952)
      (y 928)
      (glinting #f)
    )
    (bouncingsnowball
      (z-pos 50)
      (direction "left")
      (x 14016)
      (y 1632)
      (glinting #f)
    )
    (bouncingsnowball
      (z-pos 50)
      (direction "left")
      (x 15360)
      (y 1792)
      (glinting #f)
    )
    (bouncingsnowball
      (z-pos 50)
      (direction "left")
      (x 15168)
      (y 1792)
      (glinting #f)
    )
    (bouncingsnowball
      (z-pos 50)
      (direction "left")
      (x 16672)
      (y 1856)
      (glinting #f)
    )
    (camera
      (name "Camera")
      (mode "normal")
    )
    (captainsnowball
      (z-pos 50)
      (direction "left")
      (x 6176)
      (y 1600)
      (glinting #f)
    )
    (captainsnowball
      (z-pos 50)
      (direction "left")
      (x 5504)
      (y 1600)
      (glinting #f)
    )
    (climbable
      (width 32)
      (height 320)
      (x 10784)
      (y 864)
    )
    (climbable
      (width 32)
      (height 416)
      (x 9440)
      (y 512)
    )
    (decal
      (z-pos -100)
      (sprite "/images/decal/snow/exitbg.png")
      (x 17280)
      (y 1504)
    )
    (decal
      (z-pos 100)
      (sprite "/images/decal/snow/exitfg.png")
      (x 17376)
      (y 1504)
    )
    (firefly
      (z-pos 0)
      (x 12608)
      (y 1728)
    )
    (fish-jumping
      (z-pos 50)
      (x 7232)
      (y 1728)
      (glinting #f)
    )
    (fish-jumping
      (z-pos 50)
      (x 9856)
      (y 1472)
      (glinting #f)
    )
    (fish-jumping
      (z-pos 50)
      (x 14144)
      (y 1504)
      (glinting #f)
    )
    (flyingsnowball
      (z-pos 50)
      (x 6336)
      (y 1552)
      (glinting #f)
    )
    (flyingsnowball
      (z-pos 50)
      (x 6656)
      (y 1424)
      (glinting #f)
    )
    (flyingsnowball
      (z-pos 50)
      (x 7104)
      (y 1568)
      (glinting #f)
    )
    (flyingsnowball
      (z-pos 50)
      (x 7360)
      (y 1504)
      (glinting #f)
    )
    (flyingsnowball
      (z-pos 50)
      (x 6848)
      (y 1664)
      (glinting #f)
    )
    (jumpy
      (z-pos 50)
      (x 1920)
      (y 1760)
      (glinting #f)
    )
    (jumpy
      (z-pos 50)
      (x 2368)
      (y 1792)
      (glinting #f)
    )
    (jumpy
      (z-pos 50)
      (x 4160)
      (y 1760)
      (glinting #f)
    )
    (jumpy
      (z-pos 50)
      (x 3680)
      (y 1760)
      (glinting #f)
    )
    (jumpy
      (z-pos 50)
      (x 6496)
      (y 1440)
      (glinting #f)
    )
    (jumpy
      (z-pos 50)
      (x 6912)
      (y 1312)
      (glinting #f)
    )
    (jumpy
      (z-pos 50)
      (x 7968)
      (y 1760)
      (glinting #f)
    )
    (jumpy
      (z-pos 50)
      (x 8352)
      (y 1760)
      (glinting #f)
    )
    (jumpy
      (z-pos 50)
      (x 8128)
      (y 1440)
      (glinting #f)
    )
    (jumpy
      (z-pos 50)
      (x 8832)
      (y 960)
      (glinting #f)
    )
    (jumpy
      (z-pos 50)
      (x 10576)
      (y 864)
      (glinting #f)
    )
    (jumpy
      (z-pos 50)
      (x 15872)
      (y 1888)
      (glinting #f)
    )
    (jumpy
      (z-pos 50)
      (x 16288)
      (y 1856)
      (glinting #f)
    )
    (jumpy
      (z-pos 50)
      (x 10304)
      (y 736)
      (glinting #f)
    )
    (jumpy
      (z-pos 50)
      (x 688)
      (y 1664)
      (glinting #f)
    )
    (mriceblock
      (z-pos 50)
      (direction "left")
      (x 2816)
      (y 1856)
      (glinting #f)
    )
    (mriceblock
      (z-pos 50)
      (direction "left")
      (x 2304)
      (y 1824)
      (glinting #f)
    )
    (mriceblock
      (z-pos 50)
      (direction "left")
      (x 4672)
      (y 1856)
      (glinting #f)
    )
    (mriceblock
      (z-pos 50)
      (direction "left")
      (x 7872)
      (y 1024)
      (glinting #f)
    )
    (mriceblock
      (z-pos 50)
      (direction "left")
      (x 9888)
      (y 576)
      (glinting #f)
    )
    (mriceblock
      (z-pos 50)
      (direction "left")
      (x 13344)
      (y 1824)
      (glinting #f)
    )
    (mriceblock
      (z-pos 50)
      (direction "left")
      (x 14912)
      (y 1728)
      (glinting #f)
    )
    (mriceblock
      (z-pos 50)
      (direction "left")
      (x 14656)
      (y 1664)
      (glinting #f)
    )
    (music
      (file "/music/antarctic/voc-daytime.music")
    )
    (particles-snow
    )
    (path
      (name "gen17666807402974227721120")
      (path
        (mode "oneshot")
        (adapt_speed #f)
        (node
          (x 7232)
          (y 1056)
        )
      )
    )
    (path
      (name "gen17666807842974227722560")
      (path
        (mode "oneshot")
        (adapt_speed #f)
        (node
          (x 7488)
          (y 1056)
        )
      )
    )
    (path
      (name "gen17666808142974227718528")
      (path
        (mode "oneshot")
        (adapt_speed #f)
        (node
          (x 7744)
          (y 1056)
        )
      )
    )
    (platform
      (z-pos 50)
      (handle
        (scale_x 0)
        (scale_y 0)
        (offset_x 0)
        (offset_y 0)
      )
      (running #f)
      (path-ref "gen17666807402974227721120")
      (sprite "/images/objects/platforms/icefloe.sprite")
    )
    (platform
      (z-pos 50)
      (handle
        (scale_x 0)
        (scale_y 0)
        (offset_x 0)
        (offset_y 0)
      )
      (running #f)
      (path-ref "gen17666807842974227722560")
      (sprite "/images/objects/platforms/icefloe.sprite")
    )
    (platform
      (z-pos 50)
      (handle
        (scale_x 0)
        (scale_y 0)
        (offset_x 0)
        (offset_y 0)
      )
      (running #f)
      (path-ref "gen17666808142974227718528")
      (sprite "/images/objects/platforms/icefloe.sprite")
    )
    (sequencetrigger
      (sequence "endsequence")
      (width 32)
      (height 1696)
      (x 17024)
      (y 0)
    )
    (sequencetrigger
      (sequence "stoptux")
      (width 32)
      (height 1056)
      (x 17568)
      (y 736)
    )
    (smartball
      (z-pos 50)
      (direction "left")
      (x 5088)
      (y 1728)
      (glinting #f)
    )
    (smartball
      (z-pos 50)
      (direction "left")
      (x 5760)
      (y 1728)
      (glinting #f)
    )
    (smartball
      (z-pos 50)
      (direction "left")
      (x 5568)
      (y 1600)
      (glinting #f)
    )
    (smartball
      (z-pos 50)
      (direction "left")
      (x 6240)
      (y 1600)
      (glinting #f)
    )
    (smartball
      (z-pos 50)
      (direction "left")
      (x 10496)
      (y 928)
      (glinting #f)
    )
    (smartball
      (z-pos 50)
      (direction "left")
      (x 11072)
      (y 960)
      (glinting #f)
    )
    (smartball
      (z-pos 50)
      (direction "left")
      (x 9760)
      (y 576)
      (glinting #f)
    )
    (smartball
      (z-pos 50)
      (direction "left")
      (x 9952)
      (y 608)
      (glinting #f)
    )
    (smartblock
      (z-pos 50)
      (direction "left")
      (x 1696)
      (y 1664)
      (glinting #f)
    )
    (snowball
      (z-pos 50)
      (direction "left")
      (x 1472)
      (y 1792)
      (glinting #f)
    )
    (snowball
      (z-pos 50)
      (direction "left")
      (x 1632)
      (y 1792)
      (glinting #f)
    )
    (snowball
      (z-pos 50)
      (direction "left")
      (x 5472)
      (y 1856)
      (glinting #f)
    )
    (snowball
      (z-pos 50)
      (direction "left")
      (x 7808)
      (y 1024)
      (glinting #f)
    )
    (snowball
      (z-pos 50)
      (direction "left")
      (x 6464)
      (y 1856)
      (glinting #f)
    )
    (snowball
      (z-pos 50)
      (direction "left")
      (x 10240)
      (y 960)
      (glinting #f)
    )
    (snowball
      (z-pos 50)
      (direction "left")
      (x 10912)
      (y 1152)
      (glinting #f)
    )
    (snowball
      (z-pos 50)
      (direction "left")
      (x 9824)
      (y 576)
      (glinting #f)
    )
    (snowball
      (z-pos 50)
      (direction "left")
      (x 8608)
      (y 1824)
      (glinting #f)
    )
    (snowball
      (z-pos 50)
      (direction "left")
      (x 9312)
      (y 1568)
      (glinting #f)
    )
    (snowball
      (z-pos 50)
      (direction "left")
      (x 13152)
      (y 1856)
      (glinting #f)
    )
    (snowball
      (z-pos 50)
      (direction "left")
      (x 14784)
      (y 1696)
      (glinting #f)
    )
    (snowball
      (z-pos 50)
      (direction "left")
      (x 16448)
      (y 1856)
      (glinting #f)
    )
    (snowball
      (z-pos 50)
      (direction "left")
      (x 16096)
      (y 1888)
      (glinting #f)
    )
    (spawnpoint
      (name "main")
      (x 64)
      (y 1856)
    )
    (spiky
      (z-pos 50)
      (direction "left")
      (x 11552)
      (y 1120)
      (glinting #f)
    )
    (stalactite
      (glinting #f)
      (z-pos -1)
      (x 6976)
      (y 1696)
    )
    (stalactite
      (glinting #f)
      (z-pos -1)
      (x 7712)
      (y 1600)
    )
    (stalactite
      (glinting #f)
      (z-pos -1)
      (x 7584)
      (y 1600)
    )
    (stalactite
      (glinting #f)
      (z-pos -1)
      (x 7552)
      (y 1600)
    )
    (stalactite
      (glinting #f)
      (z-pos -1)
      (x 7488)
      (y 1600)
    )
    (stalactite
      (glinting #f)
      (z-pos -1)
      (x 8160)
      (y 1568)
    )
    (stalactite
      (glinting #f)
      (z-pos -1)
      (x 8128)
      (y 1568)
    )
    (stalactite
      (glinting #f)
      (z-pos -1)
      (x 8096)
      (y 1568)
    )
    (stalactite
      (glinting #f)
      (z-pos -1)
      (x 8704)
      (y 1184)
    )
    (stalactite
      (glinting #f)
      (z-pos -1)
      (x 8736)
      (y 1184)
    )
    (stalactite
      (glinting #f)
      (z-pos -1)
      (x 8928)
      (y 1120)
    )
    (stalactite
      (glinting #f)
      (z-pos -1)
      (x 8960)
      (y 1120)
    )
    (stalactite
      (glinting #f)
      (z-pos -1)
      (x 8480)
      (y 1504)
    )
    (stalactite
      (glinting #f)
      (z-pos -1)
      (x 8576)
      (y 1504)
    )
    (stalactite
      (glinting #f)
      (z-pos -1)
      (x 8736)
      (y 1504)
    )
    (stalactite
      (glinting #f)
      (z-pos -1)
      (x 8704)
      (y 1504)
    )
    (stalactite
      (glinting #f)
      (z-pos -1)
      (x 8672)
      (y 1504)
    )
    (stalactite
      (glinting #f)
      (z-pos -1)
      (x 8960)
      (y 1408)
    )
    (stalactite
      (glinting #f)
      (z-pos -1)
      (x 6240)
      (y 1664)
    )
    (stalactite
      (glinting #f)
      (z-pos -1)
      (x 6144)
      (y 1664)
    )
    (stalactite
      (glinting #f)
      (z-pos -1)
      (x 6080)
      (y 1664)
    )
    (stalactite
      (glinting #f)
      (z-pos -1)
      (x 6048)
      (y 1664)
    )
    (stalactite
      (glinting #f)
      (z-pos -1)
      (x 9216)
      (y 1088)
    )
    (stalactite
      (glinting #f)
      (z-pos -1)
      (x 9248)
      (y 1088)
    )
    (stalactite
      (glinting #f)
      (z-pos -1)
      (x 9280)
      (y 1088)
    )
    (stalactite
      (glinting #f)
      (z-pos -1)
      (x 9472)
      (y 1024)
    )
    (stalactite
      (glinting #f)
      (z-pos -1)
      (x 9504)
      (y 1024)
    )
    (stalactite
      (glinting #f)
      (z-pos -1)
      (x 10208)
      (y 832)
    )
    (stalactite
      (glinting #f)
      (z-pos -1)
      (x 10240)
      (y 832)
    )
    (stalactite
      (glinting #f)
      (z-pos -1)
      (x 10144)
      (y 1024)
    )
    (stalactite
      (glinting #f)
      (z-pos -1)
      (x 10400)
      (y 1024)
    )
    (stalactite
      (glinting #f)
      (z-pos -1)
      (x 10880)
      (y 1024)
    )
    (stalactite
      (glinting #f)
      (z-pos -1)
      (x 10912)
      (y 1024)
    )
    (tilemap
      (solid #f)
      (z-pos -100)
      (width 550)
      (height 65)
      (tiles -7449 0 122 123 -548 0 124 125 -548 0 124 125 -544 0 2047 -3 0 124 125 -544 0 2048 -3 0 124 125 -4 0 106 107 108 -537 0 2048 0 25 0 124 125 24 0 25 0 109 110 111 -537 0 2048 -549 0 2048 -549 0 2048 -549 0 2048 -549 0 2048 122 123 -547 0 2048 124 125 -23 0 24 25 -21 0 122 123 -497 0 122 123 2048 124 125 -46 0 124 125 -497 0 124 125 2048 124 125 -18 0 122 123 -26 0 124 125 -497 0 124 125 2048 124 125 -18 0 124 125 -19 0 2047 -6 0 124 125 -497 0 124 125 2049 124 125 -10 0 106 107 108 -2 0 25 -2 0 124 125 -5 0 106 107 108 -11 0 2048 -6 0 124 125 -503 0 106 107 108 -4 0 25 24 109 110 111 -5 0 124 125 -5 0 109 110 111 24 25 -9 0 2048 -6 0 124 125 -479 0 106 107 108 -10 0 25 -10 0 109 110 111 0 25 -12 0 124 125 -16 0 25 -2 0 2048 0 25 -3 0 24 124 125 -440 0 106 107 108 -17 0 25 -15 0 25 -2 0 109 110 111 -2 0 25 -56 0 2048 -448 0 109 110 111 -98 0 2048 -549 0 2048 -549 0 2048 -20 0 106 107 108 -522 0 106 107 108 0 2048 -19 0 24 109 110 111 0 25 -520 0 109 110 111 0 2049 0 24 25 24 -423 0 122 123 -108 0 24 -43 0 24 -395 0 124 125 -91 0 106 107 108 -6 0 25 -447 0 124 125 -2 0 122 123 -44 0 122 123 -34 0 25 -6 0 109 110 111 -454 0 124 125 -2 0 124 125 -44 0 124 125 -498 0 124 125 -2 0 124 125 -44 0 124 125 -23 0 106 107 108 -468 0 25 -2 0 24 124 125 25 0 124 125 -44 0 124 125 -12 0 25 -7 0 25 -2 0 109 110 111 24 -521 0 124 125 -548 0 124 125 -264 0 130 -208 0 122 123 -10 0 106 107 108 -60 0 124 125 0 25 0 24 -260 0 129 -208 0 124 125 -9 0 24 109 110 111 25 -46 0 24 -4 0 25 24 -190 0 122 123 -80 0 129 -191 0 122 123 -15 0 124 125 -50 0 25 24 -202 0 122 123 0 124 125 -80 0 129 -191 0 124 125 -15 0 124 125 -42 0 24 25 -59 0 106 107 108 -148 0 124 125 0 124 125 -80 0 129 -188 0 106 107 108 124 125 -10 0 106 107 108 -2 0 124 125 -34 0 24 -63 0 25 24 -3 0 109 110 111 0 24 25 -94 0 122 123 -49 0 124 125 0 124 125 -80 0 129 -2 0 122 123 -172 0 122 123 -5 0 25 -2 0 24 0 109 110 111 124 125 -4 0 122 123 -4 0 109 110 111 0 24 124 125 25 -202 0 124 125 0 122 123 -46 0 124 125 0 124 125 -80 0 129 -2 0 124 125 -147 0 122 123 -23 0 124 125 -19 0 124 125 -37 0 25 -176 0 124 125 0 124 125 -35 0 24 25 -9 0 124 125 0 124 125 -80 0 129 -2 0 124 125 0 106 107 108 -55 0 122 123 -2 0 202 -4 0 202 -64 0 122 123 -12 0 124 125 -23 0 124 125 -19 0 124 125 -214 0 124 125 0 124 125 -11 0 122 123 -36 0 124 125 24 -3 0 25 -4 0 106 107 108 -6 0 122 123 -58 0 25 0 129 -2 0 124 125 24 109 110 111 -28 0 7 -6 8 9 -19 0 124 125 -19 0 122 123 -30 0 122 123 -19 0 124 125 -4 0 122 123 -6 0 124 125 -23 0 124 125 -19 0 124 125 -89 0 122 123 -7 0 25 -115 0 124 125 0 124 125 -11 0 124 125 -47 0 109 110 111 -6 0 124 125 -96 0 7 -8 0 9 -18 0 124 125 -19 0 124 125 0 122 123 -27 0 124 125 -12 0 122 123 -5 0 124 125 -4 0 124 125 -6 0 124 125 -23 0 124 125 -19 0 124 125 -20 0 122 123 -6 0 24 -60 0 124 125 -115 0 106 107 108 -5 0 124 125 0 124 125 -11 0 124 125 -2 0 122 123 -4 0 106 107 108 -45 0 124 125 -95 0 7 -10 0 9 -13 0 106 107 108 0 124 125 -19 0 124 125 0 124 125 -27 0 124 125 -12 0 124 125 -5 0 124 125 -4 0 124 125 -6 0 124 125 -8 0 122 123 -56 0 124 125 -67 0 124 125 -115 0 109 110 111 0 25 24 -2 0 124 125 0 124 125 -11 0 124 125 -2 0 124 125 -3 0 24 109 110 111 0 25 24 -42 0 124 125 -82 0 122 123 -10 0 7 -12 0 9 -12 0 109 110 111 0 124 125 24 -8 0 25 -2 0 24 -6 0 124 125 0 124 125 -27 0 124 125 -12 0 124 125 -5 0 124 125 106 107 108 0 124 125 -6 0 124 125 -8 0 124 125 -56 0 124 125 -37 0 106 107 108 -6 0 24 -17 0 106 107 108 124 125 -139 0 124 125 -2 0 124 125 -58 0 25 -2 0 24 -74 0 124 125 -9 0 7 -14 0 9 -7 0 25 -27 0 24 124 125 0 124 125 -2 0 24 -24 0 124 125 0 106 107 108 -6 0 24 0 124 125 -3 0 24 0 124 125 109 110 111 0 124 125 0 25 -4 0 124 125 -2 0 24 -5 0 124 125 106 107 108 -49 0 106 107 108 0 124 125 -16 0 106 107 108 -18 0 109 110 111 0 25 -12 0 25 -7 0 24 25 109 110 111 124 125 -139 0 124 125 -2 0 124 125 -75 0 122 123 -59 0 124 125 0 106 107 108 -4 0 7 -18 0 24 -45 0 25 -3 0 24 -13 0 24 0 124 125 0 109 110 111 0 25 -37 0 124 125 109 110 111 25 -2 0 24 -15 0 24 0 25 -21 0 25 -3 0 24 0 109 110 111 0 124 125 0 25 -8 0 24 -2 0 25 -2 0 109 110 111 -8 0 25 -4 0 24 -169 0 24 -2 0 25 -2 0 124 125 -2 0 124 125 -75 0 124 125 -6 0 106 107 108 -14 0 24 0 25 -31 0 25 0 124 125 0 109 110 111 0 24 -481 0 124 125 -6 0 109 110 111 -2 0 24 -2 0 25 -526 0 24 0 25 -4 0 124 125 -3 0 25 -2252 0)
    )
    (tilemap
      (solid #f)
      (z-pos 100)
      (width 550)
      (height 65)
      (tiles -24733 0 130 -549 0 129 -549 0 129 -549 0 129 -549 0 129 -549 0 129 -549 0 129 -549 0 129 -549 0 129 -6616 0)
    )
    (tilemap
      (solid #t)
      (z-pos 0)
      (width 550)
      (height 65)
      (tiles -292 0 10 -34 11 19 -15 11 12 -498 0 10 -3 11 19 -46 11 12 -498 0 10 -45 11 19 -4 11 12 -498 0 10 -50 11 12 -498 0 10 -28 11 19 -12 11 19 -8 11 12 -498 0 10 -20 11 19 -29 11 12 -498 0 10 -50 11 12 -498 0 10 -50 11 12 -498 0 10 -12 11 19 -11 11 115 116 -24 11 12 -498 0 10 -24 11 117 118 -8 11 19 -15 11 12 -498 0 10 -50 11 12 -498 0 3053 -16 17 2925 2926 -5 11 19 -23 11 19 -2 11 12 -498 0 206 -17 0 2928 2925 2926 -30 11 12 -498 0 206 -19 0 2928 2925 2926 -20 11 19 -7 11 12 -498 0 206 -21 0 2928 2925 2926 -7 11 19 -18 11 12 -498 0 206 -5 0 -2 83 102 -2 83 -13 0 2928 2925 2926 -24 11 12 -498 0 206 -25 0 2928 2925 2926 -22 11 12 -498 0 206 -27 0 2928 -22 17 18 -498 0 3052 8 9 0 7 -12 8 1827 -532 0 3056 14 15 0 13 -12 14 1831 1832 1827 -530 0 16 17 18 0 16 -10 17 2925 2926 1835 1836 1831 1832 1827 -544 0 2928 2925 2926 1835 1836 1831 1832 1827 -544 0 2928 2925 2926 1835 1836 1831 1832 1827 -544 0 2928 2925 2926 1835 1836 1831 1832 1827 -544 0 2928 2925 2926 1835 1836 1831 1832 -2 8 9 -542 0 2928 2925 2926 1835 1836 -2 14 15 -544 0 2928 -4 17 18 -13 0 44 -548 0 44 0 44 -4 0 78 2948 78 -476 0 -2 83 -6 0 83 -11 0 2909 2910 -3 8 9 -15 0 7 9 -15 0 7 9 -454 0 78 83 2948 78 -50 0 1826 1829 2911 2912 -3 14 15 -7 0 7 -7 8 114 15 -7 0 7 -7 8 114 15 -481 0 7 8 9 -21 0 7 2921 2922 1830 1833 1834 -2 11 19 11 21 -7 8 114 -7 14 23 21 -7 8 114 -7 14 23 21 -4 8 9 0 7 -8 8 1827 -457 0 7 8 9 -5 0 13 14 15 -5 0 7 -9 8 9 -5 0 13 2923 2924 1834 -6 11 20 -7 14 23 -2 11 19 -5 11 20 -7 14 23 -7 11 19 20 -4 14 15 0 13 -8 14 1831 1832 1827 -455 0 13 14 15 -5 0 16 17 18 -5 0 13 -9 14 15 -5 0 10 -2 11 19 -2 11 2929 2930 -41 17 18 0 16 -6 17 2925 2926 1835 1836 1831 1832 1827 -453 0 16 17 18 -13 0 10 -7 11 19 11 12 -5 0 10 -3 11 2929 2930 2931 -39 0 -3 83 -10 0 2928 2925 2926 1835 1836 1831 1832 1827 -467 0 10 19 -8 11 12 -5 0 16 -3 17 2931 -56 0 2928 2925 2926 1835 1836 1831 1832 1827 -465 0 10 11 19 -3 11 2929 2930 -2 17 18 -68 0 2928 2925 2926 1835 1836 1831 1832 -6 8 9 -457 0 10 -3 11 2929 2930 2931 -54 0 7 -9 8 9 -9 0 2928 2925 2926 1835 1836 -6 14 15 -457 0 16 -3 17 2931 -48 0 7 8 9 -5 0 13 -9 14 15 -11 0 2928 -8 17 18 -5 0 7 2913 2914 -494 0 7 8 9 -5 0 13 14 15 -5 0 16 -9 17 18 -26 0 13 2915 2916 3139 3140 -465 0 102 -9 0 2909 2910 8 9 -5 0 7 8 9 -5 0 13 14 15 -5 0 16 17 18 -42 0 10 11 1835 3143 3144 1838 -472 0 1826 1829 2911 2912 14 15 -5 0 13 14 15 -5 0 16 17 18 -50 0 10 -3 11 3147 1840 1838 -469 0 1826 1829 1830 1833 1834 2929 2930 18 0 44 -3 0 16 17 18 -58 0 10 11 19 -2 11 1842 1840 1838 -383 0 7 -10 8 9 -44 0 -2 78 105 -2 78 -6 0 2909 2910 8 9 -5 0 7 -6 8 2921 2922 1830 1833 1834 2929 2930 2931 -3 0 44 -64 0 10 -5 11 1842 1840 1838 -382 0 13 -10 14 15 -53 0 1826 1829 2911 2912 14 15 -5 0 13 -6 14 2923 2924 1834 2929 2930 2931 -5 0 44 -64 0 10 -6 11 1842 1840 1844 -381 0 16 -10 17 18 -20 0 -2 83 -29 0 1826 1829 1830 1833 1834 2929 2930 18 -5 0 16 -9 17 2931 -7 0 44 -64 0 10 -7 11 1842 1846 -435 0 7 -6 8 2921 2922 1830 1833 1834 2929 2930 2931 -25 0 44 -64 0 10 -8 11 1848 1844 -73 0 -3 83 -294 0 7 -5 8 9 -43 0 -9 44 -5 0 13 -6 14 2923 2924 1834 2929 2930 2931 -92 0 10 -8 11 1850 1846 -337 0 -5 83 -16 0 -5 83 -7 0 13 -5 14 15 -34 0 7 -2 8 9 -5 0 13 -7 14 15 -5 0 16 -9 17 2931 -94 0 10 -4 11 19 -4 11 1848 1844 -13 0 44 -41 0 -2 44 -312 0 16 -5 17 18 -26 0 7 -7 8 114 -2 14 15 -5 0 10 11 19 -5 11 12 -110 0 10 -9 11 1850 1846 -12 0 44 0 44 -39 0 44 -2 0 44 -161 0 78 83 102 78 -171 0 7 8 9 -5 0 13 -7 14 23 11 19 12 -5 0 16 -7 17 18 -29 0 2909 2910 -14 8 9 -64 0 10 -10 11 1848 1844 -70 0 -5 83 -229 0 -2 83 -25 0 7 -11 8 9 -8 0 7 -11 8 9 -28 0 13 14 15 -5 0 16 -10 17 18 -41 0 3141 3142 2911 2912 -14 14 15 -64 0 10 -10 11 1850 1846 -331 0 13 -11 14 15 -2 0 -4 44 -2 0 13 -11 14 15 -20 0 7 8 9 -5 0 16 17 18 -57 0 3150 3145 3146 1834 -15 11 12 -64 0 10 -11 11 1848 1838 -50 0 2909 2910 -4 8 9 -5 0 7 8 2913 2914 -264 0 16 -11 17 18 -8 0 16 -11 17 18 -20 0 13 14 15 -64 0 3153 3154 3148 -16 11 19 12 -64 0 10 -2 11 19 -8 11 1850 1840 1838 -6 0 78 0 78 -3 0 78 83 78 -32 0 3141 3142 2911 2912 -4 14 15 -5 0 13 14 2915 2916 2917 2918 -7 8 2913 2914 -68 0 7 -21 8 -49 0 27 -4 28 29 -28 0 -2 44 -132 0 16 17 18 -21 0 -3 44 -32 0 2909 2910 -4 8 2921 2922 3157 3158 -7 11 19 -10 11 12 -64 0 10 -12 11 1842 1840 3149 -45 0 3150 3145 3146 1834 -5 11 12 -5 0 10 -2 11 1835 2919 2920 -7 14 2915 2916 2917 2918 2913 2914 -63 0 7 114 -21 14 -82 0 44 -2 0 44 -13 0 -2 44 0 -2 44 -17 0 -4 44 -9 0 -2 83 -2 0 -2 83 -17 0 2909 2910 2913 2914 -17 0 2909 2910 2913 2914 -27 0 7 8 9 -28 0 44 -3 0 44 -29 0 3141 3142 2911 2912 -4 14 2923 2924 1834 -2 11 19 -16 11 12 -64 0 10 -13 11 1842 3151 3152 -43 0 3153 3154 3148 -6 11 19 12 -5 0 10 -13 11 1835 2919 2920 2915 2916 2917 2918 2913 2914 -49 0 -3 44 -6 0 7 114 23 -10 11 19 -10 11 -81 0 44 -4 0 44 -11 0 44 -2 0 44 -2 0 44 -50 0 3141 3142 2911 2912 2915 2916 3139 3140 -13 0 3141 3142 2911 2912 2915 2916 3139 3140 -25 0 13 14 15 -20 0 102 83 -39 0 3150 3145 3146 1834 -16 11 19 -2 11 19 -7 11 12 -64 0 10 -14 11 3155 3156 2917 2918 -12 8 9 -4 0 -3 83 0 -2 44 0 83 102 83 -4 0 7 -7 8 2921 2922 3157 3158 -8 11 12 -5 0 10 -17 11 1835 2919 2920 2915 2916 2917 2918 2913 2914 -44 0 44 -3 0 44 -4 0 7 114 23 -22 11 -39 0 2909 2910 -20 8 2913 2914 -52 0 202 -14 0 202 -23 0 3150 3145 3146 1834 -2 11 1835 3143 3144 3149 -11 0 3150 3145 3146 1834 -2 11 1835 3143 3144 3149 -24 0 16 17 18 -35 0 2909 2910 8 2913 2914 -7 0 2909 2910 8 2913 2914 -8 0 3153 3154 3148 -29 11 12 -64 0 10 -8 11 19 -6 11 1835 2919 2920 -12 14 15 -18 0 13 -7 14 2923 2924 1834 -9 11 12 -5 0 10 -6 11 19 -14 11 1835 2919 2920 2915 2916 2917 2918 -7 8 9 -42 0 7 114 23 -4 11 19 -18 11 -35 0 2909 2910 2921 2922 2911 2912 -20 14 2915 2916 2917 2918 -10 8 2913 2914 -31 0 2909 2910 -5 8 204 -14 8 204 -8 8 2913 2914 -12 0 3153 3154 3148 -3 11 19 -2 11 3147 3151 3152 -9 0 3153 3154 3148 -3 11 19 -2 11 3147 3151 3152 -52 0 2909 2910 -5 8 2921 2922 2911 2912 14 2915 2916 2917 2918 -3 8 2921 2922 2911 2912 14 2915 2916 2917 2918 -4 8 2921 2922 3157 3158 -30 11 12 -64 0 10 -30 11 21 2913 2914 -14 0 2909 2910 22 -19 11 12 -5 0 10 -25 11 1835 2919 2920 -7 14 15 83 0 83 -38 0 7 114 23 -21 11 19 -2 11 -31 0 2909 2910 2921 2922 2911 2912 2923 2924 1834 -18 11 19 -3 11 1835 2919 2920 -10 14 2915 2916 2917 2918 -10 8 9 -5 0 7 -10 8 2921 2922 2911 2912 -5 14 214 -14 14 214 -8 14 2915 2916 2917 2918 -8 8 2921 2922 3157 3158 -8 11 3155 3156 2917 2918 -5 8 2921 2922 3157 3158 -8 11 3155 3156 2917 2918 -35 8 9 -5 0 7 -6 8 2921 2922 2911 2912 -5 14 2923 2924 1834 -3 11 1835 2919 2920 -3 14 2923 2924 1834 -3 11 1835 2919 2920 -4 14 2923 2924 1834 -16 11 19 -14 11 12 -64 0 10 -27 11 19 -2 11 20 2915 2916 2917 2918 -10 8 2921 2922 2911 2912 23 -7 11 19 -11 11 12 -5 0 10 -35 11 12 -30 0 2909 2910 -9 8 114 23 -25 11 -19 8 9 -4 0 7 -4 8 2921 2922 2911 2912 2923 2924 1834 -40 11 1835 2919 2920 -10 14 15 -5 0 13 -10 14 2923 2924 1834 -30 11 19 1835 2919 2920 -8 14 2923 2924 1834 -10 11 1835 2919 2920 -5 14 2923 2924 1834 -10 11 1835 2919 2920 -35 14 15 -5 0 13 -6 14 2923 2924 1834 -23 11 19 -17 11 19 -13 11 115 116 11 19 -6 11 12 -64 0 10 -12 11 19 -19 11 1835 2919 2920 -10 14 2923 2924 1834 -21 11 12 -5 0 10 -22 11 19 115 116 -4 11 19 -5 11 12 -17 0 2909 2910 -9 8 2921 2922 2911 2912 -9 14 23 -17 11 115 116 -7 11 -19 14 15 -4 0 13 -4 14 2923 2924 1834 -4 11 19 -52 11 12 -5 0 10 -31 11 19 -95 11 12 -5 0 10 -32 11 19 -31 11 117 118 -8 11 12 -64 0 10 -49 11 19 -19 11 12 -5 0 10 -18 11 19 -4 11 117 118 -10 11 21 -15 8 2921 2922 2911 2912 -9 14 2923 2924 1834 -13 11 19 -14 11 117 118 -7 11 115 116 19 -16 11 12 -4 0 10 -27 11 19 -26 11 19 -9 11 12 -5 0 10 -2 11 19 -55 11 19 -53 11 115 116 -6 11 19 -6 11 12 -5 0 10 -6 11 19 -16 11 19 -16 11 19 -28 11 19 -4 11 12 -64 0 10 -69 11 12 -5 0 10 -25 11 19 -9 11 20 -15 14 2923 2924 1834 -13 11 19 -36 11 117 118 -14 11 19 -2 11 12 -4 0 10 -2 11 19 -16 11 19 -44 11 12 -5 0 10 -6 11 115 116 -8 11 19 -21 11 19 -36 11 19 -17 11 19 -9 11 -2 19 -7 11 117 118 -13 11 12 -5 0 10 -74 11 12 -64 0 10 -37 11 19 -31 11 12 -5 0 10 -39 11 19 -17 11 19 -65 11 12 -4 0 10 -41 11 19 -19 11 19 -2 11 12 -5 0 10 -6 11 117 118 -116 11 19 -2 11 12 -5 0 10 -11 11 19 -46 11 19 -15 11 12 -64 0 10 -69 11 12 -5 0 10 -113 11 19 -9 11 12 -4 0 10 -64 11 12 -5 0 10 -84 11 19 -42 11 12 -5 0 10 -74 11 12 -64 0 10 -69 11 12 -5 0 10 -104 11)
    )
    (tilemap
      (solid #t)
      (z-pos -1)
      (width 550)
      (height 65)
      (tiles -25550 0 7 -7 8 9 -2795 0 2019 2140 2141 2142 2019 2140 2141 2142 2019 2140 2141 2142 2019 2140 2141 2142 2019 2140 2141 2142 2019 2140 2141 2142 2019 2140 2141 2142 2019 2140 2141 2142 2019 2140 2141 2142 2019 2140 2141 2142 2019 2140 2141 2142 2019 2140 2141 2142 2019 2140 2141 2142 2019 2140 2141 2142 2019 2140 2141 2142 2019 2140 2141 2142 2019 2140 -484 0 -66 2020 -484 0 -66 2020 -69 0 2019 2140 2141 2142 2019 2140 2141 -122 0 50 49 -4 28 50 49 -278 0 -66 2020 -69 0 -7 2020 -121 0 48 51 52 -4 0 51 52 48 -277 0 -66 2020 -69 0 -7 2020 -120 0 50 49 50 49 -4 0 50 49 50 49 -276 0 -66 2020 -69 0 -7 2020 -119 0 48 51 52 51 52 -4 0 51 52 51 52 48 -275 0 -66 2020 -69 0 -7 2020 -118 0 50 49 50 49 50 49 -4 0 50 49 50 49 50 49 -274 0 -66 2020 -69 0 -7 2020 -117 0 48 51 52 51 52 51 52 -4 0 51 52 51 52 51 52 -274 0 -66 2020 -69 0 -7 2020 -193 0 2019 2140 2141 2142 2019 2140 2141 -127 0 2019 2140 2141 2142 2019 2140 2141 -74 0 -66 2020 -69 0 -7 2020 -123 0 2019 2140 2141 2142 2019 2140 -64 0 -7 2020 -127 0 -7 2020 -74 0 -66 2020 -69 0 -7 2020 -123 0 -6 2020 -64 0 -7 2020 -127 0 -7 2020 -74 0 -66 2020 -69 0 -7 2020 -123 0 -6 2020 -64 0 -7 2020 -127 0 -7 2020 -74 0 -66 2020 -69 0 -7 2020 -123 0 -6 2020 -64 0 -7 2020 -127 0 -7 2020 -74 0 -66 2020 -69 0 -7 2020 -104 0)
    )
    (trampoline
      (type "stationary")
      (z-pos 50)
      (x 7040)
      (y 1344)
    )
    (trampoline
      (type "stationary")
      (z-pos 50)
      (x 9728)
      (y 1568)
    )
  )
)
