(supertux-level
  (version 3)
  (name (_ "Light At The End"))
  (author "Sophie \"Vaesea\" Ball")
  (license "CC-BY-SA 4.0 International")
  (target-time 86)
  (allow-item-pocket "inherit")
  (icon "")
  (icon-locked "")
  (statistics
    (enable-coins #t)
    (enable-secrets #t)
  )
  (sector
    (name "main")
    (ambient-light
      (color 0.5 0.5 0.5)
    )
    (background
      (scroll-offset-x 11904)
      (scroll-offset-y 544)
      (color 1 1 1)
      (speed 0.5)
      (image-top "/images/background/cave2.jpg")
      (image "/images/background/cave2.jpg")
      (image-bottom "/images/background/cave2.jpg")
    )
    (bonusblock
      (z-pos 51)
      (count 5)
      (sprite "/images/objects/bonus_block/purpleblock.sprite")
      (x 8896)
      (y 224)
    )
    (bouncingsnowball
      (z-pos 50)
      (direction "left")
      (x 1472)
      (y 512)
      (glinting #f)
    )
    (bouncingsnowball
      (z-pos 50)
      (direction "left")
      (x 2080)
      (y 736)
      (glinting #f)
    )
    (bouncingsnowball
      (z-pos 50)
      (direction "left")
      (x 12448)
      (y 832)
      (glinting #f)
    )
    (bouncingsnowball
      (z-pos 50)
      (direction "left")
      (x 12352)
      (y 832)
      (glinting #f)
    )
    (bouncingsnowball
      (z-pos 50)
      (direction "left")
      (x 13472)
      (y 832)
      (glinting #f)
    )
    (bouncingsnowball
      (z-pos 50)
      (direction "left")
      (x 13376)
      (y 832)
      (glinting #f)
    )
    (camera
      (name "Camera")
      (mode "normal")
    )
    (crusher
      (z-pos 50)
      (x 9024)
      (y 352)
    )
    (crusher
      (z-pos 50)
      (x 12416)
      (y 480)
    )
    (crusher
      (z-pos 50)
      (x 13440)
      (y 480)
    )
    (door
      (z-pos -99)
      (locked #f)
      (x 15904)
      (y 704)
    )
    (firefly
      (z-pos 0)
      (x 11616)
      (y 608)
    )
    (gradient
      (top_color 0 0 0)
      (bottom_color 0 0 0)
      (z-pos -301)
    )
    (jumpy
      (z-pos 50)
      (x 1216)
      (y 480)
      (glinting #f)
    )
    (jumpy
      (z-pos 50)
      (x 4224)
      (y 704)
      (glinting #f)
    )
    (jumpy
      (z-pos 50)
      (x 4416)
      (y 800)
      (glinting #f)
    )
    (jumpy
      (z-pos 50)
      (x 4608)
      (y 800)
      (glinting #f)
    )
    (jumpy
      (z-pos 50)
      (x 3664)
      (y 928)
      (glinting #f)
    )
    (jumpy
      (z-pos 50)
      (x 5920)
      (y 512)
      (glinting #f)
    )
    (jumpy
      (z-pos 50)
      (x 9888)
      (y 736)
      (glinting #f)
    )
    (jumpy
      (z-pos 50)
      (x 11104)
      (y 736)
      (glinting #f)
    )
    (jumpy
      (z-pos 50)
      (x 14352)
      (y 800)
      (glinting #f)
    )
    (jumpy
      (z-pos 50)
      (x 11776)
      (y 608)
      (glinting #f)
    )
    (mrbomb
      (z-pos 50)
      (direction "left")
      (x 3904)
      (y 608)
      (glinting #f)
    )
    (mriceblock
      (z-pos 50)
      (direction "left")
      (x 2560)
      (y 736)
      (glinting #f)
    )
    (mriceblock
      (z-pos 50)
      (direction "left")
      (x 6592)
      (y 864)
      (glinting #f)
    )
    (mriceblock
      (z-pos 50)
      (direction "left")
      (x 6880)
      (y 864)
      (glinting #f)
    )
    (mriceblock
      (z-pos 50)
      (direction "left")
      (x 7200)
      (y 864)
      (glinting #f)
    )
    (mriceblock
      (z-pos 50)
      (direction "left")
      (x 7552)
      (y 864)
      (glinting #f)
    )
    (mriceblock
      (z-pos 50)
      (direction "left")
      (x 7936)
      (y 864)
      (glinting #f)
    )
    (music
      (file "/music/antarctic/arcticdarkness.music")
    )
    (path
      (name "gen17673891272890620760000")
      (path
        (mode "pingpong")
        (adapt_speed #f)
        (node
          (x 4704)
          (y 864)
          (time 4)
        )
        (node
          (x 4704)
          (y 608)
          (time 4)
        )
      )
    )
    (platform
      (z-pos 50)
      (handle
        (scale_x 0)
        (scale_y 0)
        (offset_x 0)
        (offset_y 0)
      )
      (running #f)
      (name "platform")
      (path-ref "gen17673891272890620760000")
    )
    (secretarea
      (fade-tilemap "secret")
      (width 224)
      (height 160)
      (x 2336)
      (y 864)
    )
    (sequencetrigger
      (sequence "endsequence")
      (width 32)
      (height 128)
      (x 15200)
      (y 672)
    )
    (sequencetrigger
      (sequence "stoptux")
      (width 32)
      (height 32)
      (x 15936)
      (y 768)
    )
    (smartball
      (z-pos 50)
      (direction "left")
      (x 5408)
      (y 832)
      (glinting #f)
    )
    (smartball
      (z-pos 50)
      (direction "left")
      (x 6688)
      (y 736)
      (glinting #f)
    )
    (smartball
      (z-pos 50)
      (direction "left")
      (x 7072)
      (y 672)
      (glinting #f)
    )
    (smartball
      (z-pos 50)
      (direction "left")
      (x 7712)
      (y 576)
      (glinting #f)
    )
    (smartblock
      (z-pos 50)
      (direction "left")
      (x 3072)
      (y 608)
      (glinting #f)
    )
    (smartblock
      (z-pos 50)
      (direction "left")
      (x 2912)
      (y 608)
      (glinting #f)
    )
    (snowball
      (z-pos 50)
      (direction "left")
      (x 800)
      (y 896)
      (glinting #f)
    )
    (snowball
      (z-pos 50)
      (direction "left")
      (x 864)
      (y 864)
      (glinting #f)
    )
    (snowball
      (z-pos 50)
      (direction "left")
      (x 5312)
      (y 832)
      (glinting #f)
    )
    (spawnpoint
      (name "main")
      (x 64)
      (y 864)
    )
    (spiky
      (z-pos 50)
      (direction "left")
      (x 6752)
      (y 864)
      (glinting #f)
    )
    (spiky
      (z-pos 50)
      (direction "left")
      (x 7040)
      (y 864)
      (glinting #f)
    )
    (spiky
      (z-pos 50)
      (direction "left")
      (x 7360)
      (y 864)
      (glinting #f)
    )
    (spiky
      (z-pos 50)
      (direction "left")
      (x 7744)
      (y 864)
      (glinting #f)
    )
    (spiky
      (z-pos 50)
      (direction "left")
      (x 9088)
      (y 672)
      (glinting #f)
    )
    (spiky
      (z-pos 50)
      (direction "left")
      (x 8928)
      (y 672)
      (glinting #f)
    )
    (spiky
      (z-pos 50)
      (direction "left")
      (x 8768)
      (y 672)
      (glinting #f)
    )
    (switch
      (z-pos 1)
      (script "platform.start_moving();")
      (sprite "/images/objects/switch/right.sprite")
      (x 3584)
      (y 864)
    )
    (tilemap
      (solid #f)
      (z-pos -100)
      (width 500)
      (height 35)
      (tiles -4787 0 106 107 108 -497 0 109 110 111 -1593 0 106 107 108 -361 0 106 107 108 -133 0 109 110 111 -29 0 -3 32 -123 0 106 107 108 -203 0 109 110 111 -291 0 109 110 111 -693 0 106 107 108 -346 0 106 107 108 -148 0 109 110 111 -346 0 109 110 111 -277 0 106 107 108 -349 0 106 107 108 -48 0 106 107 108 -94 0 109 110 111 -349 0 109 110 111 -8 0 -5 32 -35 0 109 110 111 -9 0 -4 32 -189 0 130 -87 0 106 107 108 -63 0 106 107 108 -343 0 129 -87 0 109 110 111 -63 0 109 110 111 -175 0 106 107 108 -34 0 106 107 108 -128 0 129 -8 0 106 107 108 -320 0 109 110 111 -8 0 -4 32 -22 0 109 110 111 -128 0 129 -8 0 109 110 111 -178 0 106 107 108 -244 0 106 107 108 -23 0 106 107 108 -18 0 106 107 108 -203 0 109 110 111 -30 0 106 107 108 -23 0 106 107 108 -15 0 106 107 108 -134 0 -6 32 -27 0 109 110 111 -23 0 109 110 111 -18 0 109 110 111 -43 0 106 107 108 -190 0 109 110 111 -23 0 109 110 111 -15 0 109 110 111 -260 0 109 110 111 -607 0 106 107 108 -497 0 109 110 111 -456 0 -7 32 -1920 0)
    )
    (tilemap
      (solid #f)
      (z-pos 100)
      (width 500)
      (height 35)
      (tiles -10976 0 130 -499 0 129 -499 0 129 -499 0 129 -5023 0)
    )
    (tilemap
      (solid #t)
      (z-pos 0)
      (width 500)
      (height 35)
      (tiles -2238 36 -30 41 -469 36 42 -30 0 40 -9 36 -19 41 -439 36 42 -32 0 40 -7 36 43 -19 0 40 -85 36 -9 41 -23 36 -9 41 -310 36 41 42 -34 0 40 -6 36 43 -20 0 40 -83 36 43 -9 0 40 -21 36 43 -9 0 40 -308 36 42 -37 0 40 -5 36 43 -21 0 40 -82 36 43 -10 0 40 -20 36 43 -10 0 40 -101 36 -31 41 -172 36 -2 41 42 -39 0 40 -4 36 43 -22 0 40 -81 36 43 -11 0 40 -19 36 43 -11 0 40 -99 36 42 -31 0 40 -68 36 -50 41 -51 36 41 42 -43 0 40 -3 36 43 -3 32 34 -2 0 33 -5 32 34 -10 0 40 -55 36 -13 41 -12 36 43 -12 0 40 -18 36 43 -12 0 40 -97 36 42 -33 0 40 -21 36 -45 41 42 -50 0 40 -49 41 42 -24 0 33 -5 32 34 -15 0 40 -3 36 -3 37 39 -2 0 35 -5 37 39 34 -10 0 40 -53 36 42 -13 0 38 -11 36 43 83 2948 83 -10 0 40 -17 36 43 -13 0 40 -95 36 42 -35 0 40 -19 41 42 -165 0 -3 83 -3 0 35 -5 37 39 -16 0 40 -5 41 42 -2 0 40 41 -5 36 39 34 -10 0 40 -51 36 42 -14 0 40 41 -10 36 43 -14 0 40 -16 36 43 44 -13 0 40 -93 36 42 -228 0 38 -5 36 43 32 34 -25 0 38 -5 36 39 34 -10 0 40 -49 36 42 -17 0 38 -9 36 43 -15 0 40 -15 36 43 -2 44 -13 0 40 -91 36 42 -229 0 38 -6 36 37 39 -25 0 38 -6 36 39 34 -10 0 40 -19 36 -29 41 -18 0 40 41 -8 36 43 -4 32 34 -2 0 33 34 -7 0 40 -14 36 43 -3 44 32 34 -2 0 33 34 -7 0 40 -89 36 42 -216 0 -3 83 -3 0 33 -5 32 34 0 38 -7 36 43 32 34 -23 0 38 -7 36 39 34 -10 0 40 -17 41 42 -49 0 38 -8 36 -4 37 39 -2 0 35 39 34 -7 0 40 -14 36 -4 37 39 -2 0 35 39 34 -7 0 40 -87 36 42 -8 0 33 -17 32 34 -65 0 -3 83 -3 0 -3 83 -58 0 44 -31 0 -3 83 -29 0 119 -5 121 120 0 38 -8 36 37 39 -23 0 38 -8 36 39 34 -77 0 40 -12 41 42 -2 0 40 36 39 34 -7 0 40 -7 36 -10 41 42 -2 0 40 36 39 34 -7 0 40 -7 36 -10 41 -68 36 42 -7 0 44 0 35 -17 37 39 34 -133 0 33 -5 32 34 -63 0 38 -9 36 43 32 34 -21 0 38 -9 36 39 34 -64 0 83 102 83 -26 0 38 36 39 34 -7 0 40 -5 36 42 -14 0 38 36 39 34 -7 0 40 -5 36 42 -10 0 40 -18 41 -30 36 -18 41 42 -8 0 44 0 38 -18 36 39 34 -101 0 1741 -30 0 35 -5 37 39 -41 0 -3 83 -3 0 33 -5 32 34 -9 0 38 -10 36 37 39 -20 0 104 38 -10 36 39 34 -92 0 38 -2 36 39 34 -7 0 40 -3 41 42 -15 0 38 -2 36 39 34 -7 0 40 -3 41 42 -30 0 40 -29 36 -27 0 44 0 38 -19 36 39 34 -17 0 44 0 44 -14 0 33 -11 32 34 -13 0 33 -11 32 34 -27 0 1740 -24 0 44 -5 0 38 -5 36 43 32 34 -19 0 33 -5 32 34 -19 0 119 -5 121 120 -9 0 38 -11 36 43 32 34 -19 0 38 -11 36 39 34 -91 0 38 -3 36 39 34 -26 0 38 -3 36 39 34 -42 0 40 -28 36 -27 0 44 0 38 -20 36 39 34 -3 0 83 102 83 -9 0 44 -3 0 44 -12 0 33 35 -11 37 39 -3 83 -9 0 33 35 -11 37 39 -27 0 1739 -26 0 1741 -3 0 38 -6 36 37 39 -19 0 119 -5 121 120 -35 0 38 -12 36 37 39 -19 0 38 -12 36 39 34 -56 0 33 -11 32 34 -21 0 38 -4 36 39 34 -25 0 38 -4 36 39 34 -42 0 40 -27 41 -27 0 44 0 38 -21 36 39 34 -30 0 33 35 -12 36 43 -11 0 33 35 36 -7 41 -4 36 43 -27 0 1739 -26 0 1740 -3 0 38 -7 36 43 32 34 -23 0 33 -5 32 34 -5 0 33 -5 44 34 -17 0 38 -13 36 43 -14 32 -4 44 32 38 -13 36 39 34 -54 0 33 35 -11 37 39 -21 0 38 -5 36 39 34 -24 0 38 -5 36 39 34 -96 0 44 0 38 -22 36 39 34 -28 0 33 35 -13 36 43 -10 0 33 35 36 43 -7 0 40 -3 36 43 -27 0 1739 -20 0 44 -5 0 1739 -3 0 38 -8 36 37 39 -23 0 119 -5 121 120 -5 0 119 -5 121 120 -17 0 38 -14 36 -19 37 -15 36 39 34 -52 0 33 35 -12 36 43 32 34 -19 0 38 -6 36 39 34 -23 0 38 -6 36 39 34 -10 0 44 0 44 -8 0 44 0 44 -8 0 44 0 44 -62 0 38 -23 36 39 -12 32 34 -5 0 33 -9 32 35 -14 36 43 -10 32 35 -2 36 43 -8 0 40 -2 36 43 -9 32 34 -17 0 1739 102 83 -20 0 1741 -3 0 1739 -3 0 38 -9 36 43 32 34 -9 0 33 -5 32 34 -41 0 38 -49 36 39 34 -50 0 33 35 -14 36 37 39 -6 0 -6 83 -7 0 38 -7 36 39 34 -22 0 38 -7 36 39 34 -8 0 44 -3 0 44 -6 0 44 -3 0 44 -2 0 -2 83 -2 0 44 -3 0 44 -12 0 33 32 34 -3 0 33 -2 32 34 -3 0 33 32 34 -33 0 38 -24 36 -12 37 39 -5 0 35 -9 37 -16 36 -10 37 -3 36 43 -9 0 40 -2 36 -9 37 39 -17 0 1739 -22 0 1740 -3 0 1739 -3 0 38 -10 36 37 39 -5 0 83 -3 0 119 -5 121 120 -41 0 38 -50 36 39 -6 32 34 -5 0 33 -4 44 34 -5 0 33 34 -5 0 33 34 -5 0 33 -12 32 35 -16 36 43 32 34 -17 0 38 -8 36 39 34 -21 0 38 -8 36 39 34 -38 0 33 -7 32 35 37 39 -3 32 35 -2 37 39 -3 32 35 37 39 -4 32 -8 0 -5 83 -3 0 -5 83 -8 0 38 -36 36 43 -5 0 38 -38 36 43 -10 0 40 -5 41 -5 36 43 -17 0 1739 -22 0 1739 -3 0 1739 -3 0 38 -11 36 43 32 34 -55 0 38 -51 36 -6 37 39 -5 0 35 -4 37 39 -5 0 35 39 -5 0 35 39 -5 0 35 -12 37 -18 36 37 39 -17 0 38 -9 36 39 34 -20 0 38 -9 36 39 34 -37 0 35 -7 37 -3 36 -3 37 -4 36 -3 37 -3 36 -4 37 -29 0 38 -36 36 43 -5 0 40 -7 41 -31 36 43 -16 0 40 -4 36 43 -5 32 34 -3 0 33 -7 32 1739 -18 32 34 -3 0 1739 -3 0 1739 -3 0 38 -12 36 37 39 -55 0 38 -57 36 43 -5 0 38 -4 36 43 -5 0 38 43 -5 0 38 43 -5 0 38 -31 36 43 -4 32 -6 44 -7 32 38 -10 36 39 -20 32 38 -10 36 39 -5 32 34 -5 0 33 -4 32 34 -5 0 33 -4 32 34 -5 0 33 34 -2 0 38 -27 36 -29 0 38 -36 36 43 32 34 -4 0 -3 83 128 -3 83 38 -30 36 43 -17 0 40 -4 36 -5 121 120 -3 0 35 -7 37 36 -18 37 39 -3 0 1739 -3 0 1739 -3 0 38 -13 36 43 -55 32 38 -57 36 43 -5 0 38 -4 36 43 -5 0 38 43 -5 0 38 43 -5 0 38 -32 36 -17 37 -12 36 -20 37 -12 36 -5 37 39 -5 0 35 -4 37 39 -5 0 35 -4 37 39 -5 0 35 39 -2 0 38 -27 36 -29 32 38 -37 36 121 120 -11 0 38 -30 36 43 -18 0 40 -2 41 42 -9 0 38 -26 36 43 -3 0 1739 -3 0 1739 -3 0 38 -14 36 -55 37 -58 36 43 -5 0 38 -4 36 43 -5 0 38 43 -5 0 38 43 -5 0 38 -98 36 43 -5 0 38 -4 36 43 -5 0 38 -4 36 43 -5 0 38 43 -2 0 38 -27 36 -29 37 -37 36 43 -13 0 38 -30 36 43 -31 0 38 -26 36 43 -3 0 1739 -3 0 1739 -3 0 38 -127 36 43 -5 0 38 -4 36 43 -5 0 38 43 -5 0 38 43 -5 0 38 -98 36 43 -5 0 38 -4 36 43 -5 0 38 -4 36 43 -5 0 38 43 -2 0 38 -93 36 43 -13 0 38 -30 36 43 -5 32 34 -3 0 33 32 34 -2 0 33 -16 32 38 -26 36 43 -3 0 1739 -3 0 1739 -3 0 38 -127 36 43 -5 0 38 -4 36 43 -5 0 38 43 -5 0 38 43 -5 0 38 -98 36 43 -5 0 38 -4 36 43 -5 0 38 -4 36 43 -5 0 38 43 -2 0 38 -93 36 43 -5 0 33 -7 44 38 -31 36 -5 37 39 -3 0 35 37 39 -2 0 35 -16 37 -27 36 43 -3 0 1739 -3 0 1739 -3 0 38 -127 36 43 -5 0 38 -4 36 43 -5 0 38 43 -5 0 38 43 -5 0 38 -98 36 43 -5 0 38 -4 36 43 -5 0 38 -4 36 43 -5 0 38 43 -2 0 38 -93 36 43 -5 0 35 -7 37 -37 36 43 -3 0 38 36 43 -2 0 38 -43 36 43 -3 0 1739 -3 0 1739 -3 0 38 -127 36 43 -5 0 38 -4 36 43 -5 0 38 43 -5 0 38 43 -5 0 38 -98 36 43 -5 0 38 -4 36 43 -5 0 38 -4 36 43 -5 0 38 43 -2 0 38 -93 36 43 -5 0 38 -44 36 43 -3 0 38 36 43 -2 0 38 -43 36 43 -3 0 1739 -3 0 1739 -3 0 38 -127 36 43 -5 0 38 -4 36 43 -5 0 38 43 -5 0 38 43 -5 0 38 -98 36 43 -5 0 38 -4 36 43 -5 0 38 -4 36 43 -5 0 38 43 -2 0 38 -93 36 43 -5 0 38 -44 36 43 -3 0 38 36 43 -2 0 38 -43 36 43 -3 0 1739 -3 0 1739 -3 0 38 -127 36 43 -5 0 38 -4 36 43 -5 0 38 43 -5 0 38 43 -5 0 38 -98 36 43 -5 0 38 -4 36 43 -5 0 38 -4 36 43 -5 0 38 43 -2 0 38 -27 36)
    )
    (tilemap
      (solid #f)
      (z-pos 99)
      (name "secret")
      (width 500)
      (height 35)
      (tiles -13072 0 38 -8 36 -491 0 38 -8 36 -491 0 38 -8 36 -491 0 38 -8 36 -491 0 38 -8 36 -491 0 38 -8 36 -491 0 38 -8 36 -1419 0)
    )
    (torch
      (z-pos 0)
      (x 704)
      (y 832)
    )
    (torch
      (z-pos 0)
      (x 3712)
      (y 896)
    )
    (torch
      (z-pos 0)
      (x 5408)
      (y 768)
    )
    (torch
      (z-pos 0)
      (x 7616)
      (y 800)
    )
    (torch
      (sprite "/images/objects/torch/torch2.sprite")
      (z-pos 0)
      (x 7296)
      (y 608)
    )
    (torch
      (sprite "/images/objects/torch/torch3.sprite")
      (z-pos 0)
      (x 9120)
      (y 256)
    )
    (torch
      (sprite "/images/objects/torch/torch3.sprite")
      (z-pos 0)
      (x 8960)
      (y 256)
    )
    (torch
      (z-pos 0)
      (x 12032)
      (y 768)
    )
    (torch
      (z-pos 0)
      (x 14080)
      (y 768)
    )
    (torch
      (sprite "/images/objects/torch/torch3.sprite")
      (z-pos 0)
      (x 15712)
      (y 704)
    )
    (trampoline
      (type "stationary")
      (z-pos 50)
      (x 864)
      (y 896)
    )
  )
)
