(supertux-level
  (version 3)
  (name (_ "Night Mountain"))
  (author "Sophie \"Vaesea\" Ball")
  (license "CC-BY-SA 4.0 International")
  (target-time 57)
  (allow-item-pocket "inherit")
  (icon "")
  (icon-locked "")
  (statistics
    (enable-coins #t)
    (enable-secrets #t)
  )
  (sector
    (name "main")
    (ambient-light
      (color 0.5 0.5 0.5)
    )
    (background
      (color 1 1 1)
      (speed 0.25)
      (image-top "/images/background/nightsky_top.png")
      (image "/images/background/nightsky_top.png")
      (image-bottom "/images/background/nightsky_top.png")
    )
    (background
      (scroll-offset-x 864)
      (scroll-offset-y 2784)
      (color 1 1 1)
      (speed 1.5)
      (image-top "/images/background/fog.png")
      (image "/images/background/fog.png")
      (image-bottom "/images/background/fog.png")
      (z-pos 300)
    )
    (bouncingsnowball
      (z-pos 50)
      (direction "left")
      (x 4608)
      (y 2208)
      (glinting #f)
    )
    (bouncingsnowball
      (z-pos 50)
      (direction "left")
      (x 4544)
      (y 2240)
      (glinting #f)
    )
    (camera
      (name "Camera")
      (mode "normal")
    )
    (candle
      (z-pos -99)
      (x 8800)
      (y 960)
    )
    (candle
      (z-pos -99)
      (x 9344)
      (y 960)
    )
    (firefly
      (z-pos 0)
      (x 6528)
      (y 1632)
    )
    (jumpy
      (z-pos 50)
      (x 1152)
      (y 2752)
      (glinting #f)
    )
    (jumpy
      (z-pos 50)
      (x 1760)
      (y 2656)
      (glinting #f)
    )
    (jumpy
      (z-pos 50)
      (x 3424)
      (y 2496)
      (glinting #f)
    )
    (jumpy
      (z-pos 50)
      (x 2752)
      (y 2496)
      (glinting #f)
    )
    (jumpy
      (z-pos 50)
      (x 5792)
      (y 1888)
      (glinting #f)
    )
    (jumpy
      (z-pos 50)
      (x 7984)
      (y 1696)
      (glinting #f)
    )
    (jumpy
      (z-pos 50)
      (x 8144)
      (y 1696)
      (glinting #f)
    )
    (jumpy
      (z-pos 50)
      (x 12832)
      (y 288)
      (glinting #f)
    )
    (mrbomb
      (z-pos 50)
      (direction "left")
      (x 9312)
      (y 960)
      (glinting #f)
    )
    (mrbomb
      (z-pos 50)
      (direction "left")
      (x 9088)
      (y 960)
      (glinting #f)
    )
    (music
      (file "/music/antarctic/voc-night.music")
    )
    (particles-clouds
    )
    (particles-snow
    )
    (secretarea
      (width 160)
      (height 736)
      (x 8896)
      (y 0)
    )
    (sequencetrigger
      (sequence "endsequence")
      (width 32)
      (height 384)
      (x 13632)
      (y 0)
    )
    (short_fuse
      (z-pos 50)
      (direction "left")
      (x 9280)
      (y 960)
      (glinting #f)
    )
    (short_fuse
      (z-pos 50)
      (direction "left")
      (x 9216)
      (y 960)
      (glinting #f)
    )
    (short_fuse
      (z-pos 50)
      (direction "left")
      (x 9152)
      (y 960)
      (glinting #f)
    )
    (smartball
      (z-pos 50)
      (direction "left")
      (x 960)
      (y 2880)
      (glinting #f)
    )
    (smartball
      (z-pos 50)
      (direction "left")
      (x 2816)
      (y 2656)
      (glinting #f)
    )
    (smartball
      (z-pos 50)
      (direction "left")
      (x 3392)
      (y 2656)
      (glinting #f)
    )
    (smartball
      (z-pos 50)
      (direction "left")
      (x 5536)
      (y 2016)
      (glinting #f)
    )
    (smartball
      (z-pos 50)
      (direction "left")
      (x 7360)
      (y 1728)
      (glinting #f)
    )
    (smartball
      (z-pos 50)
      (direction "left")
      (x 8256)
      (y 1728)
      (glinting #f)
    )
    (smartball
      (z-pos 50)
      (direction "left")
      (x 10368)
      (y 768)
      (glinting #f)
    )
    (smartball
      (z-pos 50)
      (direction "left")
      (x 13056)
      (y 320)
      (glinting #f)
    )
    (smartball
      (z-pos 50)
      (direction "left")
      (x 12608)
      (y 320)
      (glinting #f)
    )
    (smartball
      (z-pos 50)
      (direction "left")
      (x 11808)
      (y 576)
      (glinting #f)
    )
    (smartball
      (z-pos 50)
      (direction "left")
      (x 11648)
      (y 576)
      (glinting #f)
    )
    (smartblock
      (z-pos 50)
      (direction "left")
      (x 2304)
      (y 2688)
      (glinting #f)
    )
    (smartblock
      (z-pos 50)
      (direction "left")
      (x 640)
      (y 2912)
      (glinting #f)
    )
    (snowball
      (z-pos 50)
      (direction "left")
      (x 1664)
      (y 2784)
      (glinting #f)
    )
    (snowball
      (z-pos 50)
      (direction "left")
      (x 1056)
      (y 2880)
      (glinting #f)
    )
    (snowball
      (z-pos 50)
      (direction "left")
      (x 3008)
      (y 2656)
      (glinting #f)
    )
    (snowball
      (z-pos 50)
      (direction "left")
      (x 3200)
      (y 2656)
      (glinting #f)
    )
    (snowball
      (z-pos 50)
      (direction "left")
      (x 4384)
      (y 2400)
      (glinting #f)
    )
    (snowball
      (z-pos 50)
      (direction "left")
      (x 4448)
      (y 2336)
      (glinting #f)
    )
    (snowball
      (z-pos 50)
      (direction "left")
      (x 12928)
      (y 320)
      (glinting #f)
    )
    (snowball
      (z-pos 50)
      (direction "left")
      (x 12736)
      (y 320)
      (glinting #f)
    )
    (spawnpoint
      (name "main")
      (x 64)
      (y 2912)
    )
    (tilemap
      (solid #f)
      (z-pos -100)
      (width 600)
      (height 100)
      (tiles -2225 0 130 -599 0 129 -569 0 122 123 -28 0 129 -569 0 124 125 -10 0 122 123 -16 0 129 -569 0 124 125 -4 0 122 123 -4 0 124 125 -16 0 129 -569 0 124 125 -4 0 124 125 -4 0 124 125 -16 0 129 -4 0 122 123 -5 0 1321 1322 1323 1324 -554 0 124 125 -4 0 124 125 -4 0 124 125 -7 0 122 123 -7 0 129 -4 0 124 125 -5 0 1325 1326 1327 1328 -5 0 122 123 -547 0 124 125 -2 0 25 0 124 125 -2 0 24 0 124 125 -7 0 124 125 106 107 108 -4 0 129 -4 0 124 125 -5 0 1329 1330 1331 1332 -5 0 124 125 0 106 107 108 -564 0 124 125 109 110 111 0 25 -2 0 129 -4 0 124 125 -2 0 25 -2 0 1333 1334 1335 1336 -2 0 24 -2 0 124 125 0 109 110 111 -1107 0 122 123 -94 0 122 123 -502 0 124 125 0 122 123 -14 0 24 -76 0 124 125 -497 0 122 123 -3 0 124 125 0 124 125 -91 0 124 125 -497 0 124 125 -3 0 124 125 0 124 125 -91 0 124 125 0 25 -495 0 124 125 -3 0 124 125 0 124 125 0 106 107 108 -584 0 25 0 124 125 0 24 0 124 125 0 124 125 0 109 110 111 -98 0 122 123 -593 0 1321 1322 1323 1324 0 124 125 -474 0 24 -118 0 1325 1326 1327 1328 0 124 125 -593 0 1329 1330 1331 1332 0 124 125 -410 0 24 -2 0 25 -49 0 25 0 24 -127 0 1333 1334 1335 1336 0 124 125 -451 0 106 107 108 -597 0 109 110 111 0 24 -556 0 122 123 -593 0 122 123 -3 0 124 125 -28 0 25 -564 0 124 125 -3 0 124 125 -6 0 122 123 -585 0 124 125 -3 0 124 125 -6 0 124 125 -10 0 -2 25 -573 0 124 125 -3 0 124 125 106 107 108 -3 0 124 125 -585 0 124 125 0 25 0 124 125 109 110 111 0 24 0 124 125 25 -779 0 25 -7593 0 24 25 -2390 0 2057 2060 2059 -597 0 2057 2061 2059 -592 0 2057 2060 2059 -2 0 2057 2065 2059 -592 0 2057 2061 2059 -2 0 2057 2066 2059 -587 0 2057 2060 2059 -2 0 2057 2065 2059 -2 0 2057 2060 2059 -539 0 106 107 108 -26 0 106 107 108 -16 0 2057 2061 2059 -2 0 2057 2066 2059 -2 0 2057 2061 2059 -539 0 109 110 111 -3 0 25 -4 0 24 -8 0 24 -7 0 24 109 110 111 -7 0 24 25 -7 0 2057 2065 2059 25 0 2057 2060 2059 25 0 2057 2065 2059 -1730 0 24 -1789 0 24 -2 0 25 -1787 0 25 -1182 0 122 123 -6 0 106 107 108 -589 0 124 125 -6 0 109 110 111 -589 0 124 125 -598 0 124 125 -592 0 24 -2 0 25 -2 0 124 125 -2942 0 106 107 108 -593 0 25 -3 0 109 110 111 24 -2355 0 122 123 -27 0 24 25 -15 0 122 123 -2 0 24 25 -14 0 106 107 108 -531 0 124 125 -36 0 122 123 -6 0 124 125 -18 0 109 110 111 0 24 -529 0 124 125 -36 0 124 125 -6 0 124 125 -552 0 124 125 -22 0 106 107 108 -11 0 124 125 -6 0 124 125 -541 0 122 123 -9 0 124 125 -21 0 24 109 110 111 25 -7 0 24 -2 0 124 125 -2 0 25 -3 0 124 125 0 24 -7 0 25 -528 0 122 123 0 124 125 -9 0 124 125 -2 0 24 -2 0 25 -6 0 24 -571 0 124 125 0 124 125 -595 0 124 125 0 124 125 -593 0 24 0 124 125 0 124 125 25 -3 0 24 -1154 0 122 123 -23 0 106 107 108 -572 0 124 125 -16 0 24 0 25 -4 0 109 110 111 -572 0 124 125 -4 0 24 -2 0 25 -587 0 25 -2 0 124 125 24 -4791 0)
    )
    (tilemap
      (solid #f)
      (z-pos 100)
      (width 600)
      (height 100)
      (tiles -2227 0 130 -599 0 129 -599 0 129 -599 0 129 -599 0 129 -599 0 129 -599 0 129 -599 0 129 -599 0 129 -52972 0)
    )
    (tilemap
      (solid #t)
      (z-pos 0)
      (width 600)
      (height 100)
      (tiles -4595 0 -3 83 0 -5 44 0 -3 83 -581 0 7 9 -598 0 13 15 -594 0 7 9 -2 0 16 18 -2 0 7 -15 8 9 -575 0 13 15 -6 0 13 -15 14 15 -5 0 7 -37 8 9 -527 0 7 9 -2 0 16 18 -6 0 16 -5 17 31 19 -2 11 30 -5 17 18 -5 0 13 -37 14 15 -527 0 13 15 -16 0 16 31 11 30 18 -11 0 10 -6 11 19 -8 11 19 -10 11 19 -10 11 12 -498 0 -2 44 -5 0 -2 44 -5 0 -2 44 -9 0 7 9 -2 0 16 18 -17 0 10 11 12 -12 0 10 -37 11 12 -497 0 44 -2 0 44 0 83 0 44 -2 0 44 0 83 0 44 -2 0 44 -8 0 13 15 -21 0 10 11 12 -12 0 10 -3 11 19 -4 11 19 -3 11 19 -4 11 19 -2 11 115 116 11 19 -4 11 19 -8 11 12 -519 0 7 9 -2 0 16 18 -21 0 10 11 12 -12 0 10 -8 11 19 -11 11 117 118 -15 11 21 -6 8 9 -512 0 13 15 -25 0 10 11 12 -12 0 10 -18 11 19 -18 11 20 -6 14 15 -488 0 7 -20 8 9 -2 0 16 18 -25 0 10 11 12 -12 0 10 -5 11 19 -4 11 19 -23 11 19 -8 11 19 12 -419 0 128 -68 0 13 -20 14 15 -29 0 10 19 12 -12 0 10 -20 11 19 -23 11 12 -479 0 7 8 9 -6 0 10 -3 11 19 -8 11 19 -6 11 19 12 -29 0 10 11 12 -12 0 10 -3 11 19 -3 11 19 -23 11 19 -4 11 19 -7 11 12 -416 0 -7 44 -56 0 13 14 15 -6 0 16 -20 17 18 -29 0 10 11 12 -12 0 10 -17 11 19 -21 11 19 -4 11 12 -416 0 7 -5 8 9 -47 0 7 8 9 -6 0 10 11 12 -57 0 10 11 12 -12 0 10 -13 11 19 -15 11 19 -3 11 19 -10 11 21 -6 8 9 -409 0 13 -5 14 15 -47 0 13 14 15 -6 0 16 17 18 -57 0 10 11 12 -12 0 10 -5 11 19 -17 11 19 -20 11 20 -6 14 15 -409 0 16 -5 17 18 -34 0 7 -5 8 9 -6 0 10 11 12 -66 0 10 11 12 -12 0 10 -41 11 19 -4 11 19 -4 11 12 -450 0 13 -5 14 15 -6 0 16 17 18 -66 0 10 11 12 -12 0 10 -31 11 19 -19 11 12 -441 0 7 8 9 -6 0 10 -2 11 19 -2 11 12 -75 0 10 11 12 -12 0 10 -16 11 19 -21 11 19 -4 11 19 -7 11 12 -441 0 13 14 15 -6 0 16 -5 17 18 -75 0 10 11 12 -12 0 10 -8 11 19 -17 11 19 -2 11 19 -19 11 19 11 12 -432 0 7 8 9 -6 0 10 11 12 -88 0 10 11 12 -12 0 10 -18 11 19 -21 11 19 -10 11 12 -432 0 13 14 15 -6 0 16 17 18 -88 0 10 11 12 -12 0 10 -34 11 19 -16 11 12 -406 0 7 -18 8 9 -6 0 10 11 12 -97 0 10 11 12 -12 0 10 -46 11 19 -4 11 12 -405 0 7 114 -18 14 15 -6 0 16 17 18 -97 0 10 11 12 -12 0 10 -38 11 19 -12 11 21 -6 8 9 -398 0 13 23 -5 11 19 -12 11 12 -106 0 10 11 12 -12 0 10 -51 11 20 -6 14 15 -398 0 10 -19 11 12 -106 0 10 11 12 -12 0 10 -15 11 19 -32 11 19 -8 11 19 12 -398 0 10 -4 11 115 116 -11 11 19 11 12 -106 0 10 19 12 -12 0 10 -25 11 19 -27 11 19 -4 11 12 -397 0 7 22 -4 11 117 118 -13 11 12 -106 0 10 11 12 -12 0 10 -3 11 19 -37 11 19 -3 11 19 -4 11 19 -7 11 12 -397 0 13 23 -10 11 19 -8 11 12 -106 0 10 11 12 -12 0 10 -7 11 19 -50 11 12 -397 0 10 -20 11 12 -106 0 10 11 12 -12 0 10 -17 11 19 -29 11 19 -8 11 19 11 12 -397 0 10 -2 11 19 -17 11 12 -106 0 10 11 12 -12 0 10 -5 11 19 -21 11 19 -5 11 19 -24 11 12 -396 0 7 22 -20 11 12 -106 0 10 11 12 -12 0 10 -53 11 19 -4 11 21 -6 8 9 -388 0 7 114 23 -20 11 12 -106 0 10 11 12 -12 0 10 -31 11 19 -13 11 19 -12 11 20 -6 14 15 -387 0 7 114 23 -17 11 19 -3 11 12 -106 0 10 11 12 -12 0 10 -9 11 19 -46 11 19 -5 11 19 -2 11 12 -321 0 44 0 44 -62 0 7 114 23 -22 11 12 -106 0 10 11 12 -12 0 10 -19 11 19 -9 11 19 -35 11 12 -320 0 44 0 44 0 44 -60 0 7 114 23 -12 11 19 -10 11 12 -106 0 10 11 12 -12 0 10 -35 11 19 -17 11 19 -4 11 19 -6 11 12 -381 0 7 -3 8 114 23 11 19 -6 11 19 -15 11 12 -106 0 10 11 12 -12 0 10 -40 11 19 -7 11 19 -16 11 12 -381 0 13 -3 14 23 -25 11 12 -106 0 10 11 12 -12 0 10 -55 11 19 -8 11 19 12 -374 0 2067 2068 2069 -4 0 16 -29 17 18 -106 0 10 11 12 -12 0 10 -7 11 19 -30 11 19 -26 11 12 -320 0 -2 83 128 -2 83 -49 0 2072 2073 2074 -141 0 10 11 12 -12 0 10 -17 11 19 -43 11 19 -3 11 12 -369 0 2067 2068 2069 -146 0 10 11 12 -12 0 10 -33 11 19 -19 11 19 -11 11 21 -6 8 9 -362 0 2072 2073 2074 -146 0 10 11 12 -12 0 10 -42 11 19 -22 11 20 -6 14 15 -357 0 2067 2068 2069 -151 0 10 11 12 -12 0 10 -63 11 19 -4 11 19 -3 11 12 -310 0 83 103 83 -5 0 83 3161 83 -36 0 2072 2073 2074 -151 0 10 11 12 -12 0 10 -72 11 12 -511 0 10 19 12 -12 0 10 -14 11 19 -41 11 19 -3 11 19 -4 11 19 -6 11 12 -511 0 10 11 12 -12 0 10 -24 11 19 -22 11 19 -24 11 12 -308 0 7 -13 8 9 -5 0 7 8 9 -5 0 7 -5 8 9 -5 0 7 8 9 -5 0 7 -13 8 9 -140 0 10 11 12 -12 0 10 -40 11 19 -21 11 19 -8 11 19 12 -308 0 13 -13 14 15 -5 0 13 14 15 -5 0 13 -5 14 15 -5 0 13 14 15 -5 0 13 -13 14 15 -140 0 10 11 12 -12 0 10 -4 11 19 -6 11 19 -33 11 19 -26 11 12 -308 0 10 2929 2930 -2 17 2925 2926 19 2929 2930 -2 17 2925 2926 12 -5 0 10 11 12 -5 0 10 -4 11 19 12 -5 0 10 11 12 -5 0 10 2929 2930 -2 17 2925 2926 11 2929 2930 -2 17 2925 2926 12 -140 0 10 11 12 -12 0 10 -21 11 19 -46 11 19 -3 11 12 -300 0 7 8 9 -5 0 16 2931 -4 0 2928 17 2931 -4 0 2928 18 -5 0 16 17 18 -5 0 16 -5 17 18 -5 0 16 17 18 -5 0 16 2931 -4 0 2928 17 2931 -4 0 2928 18 -140 0 10 11 12 -12 0 10 -37 11 19 -22 11 19 -11 11 12 -300 0 13 14 15 -208 0 10 11 12 -12 0 10 -6 11 19 -42 11 19 -22 11 12 -300 0 10 11 12 -208 0 10 11 12 -12 0 10 -72 11 12 -290 0 7 -3 8 9 -5 0 16 17 18 -208 0 10 11 12 -12 0 10 -32 11 19 -38 11 19 12 -260 0 -3 44 -27 0 13 -3 14 15 -216 0 10 11 12 -12 0 10 -55 11 19 -7 11 19 -8 11 12 -259 0 44 -3 0 44 -26 0 10 11 19 11 12 -216 0 10 11 12 -12 0 10 -30 11 19 -41 11 12 -280 0 7 -3 8 9 -5 0 16 -3 17 18 -216 0 10 11 12 -12 0 10 -44 11 19 -2 11 19 -5 11 19 -18 11 12 -280 0 13 -3 14 15 -226 0 10 11 12 -12 0 10 -2 11 19 -10 11 19 -58 11 12 -280 0 10 -3 11 12 -226 0 10 11 12 -12 0 10 -23 11 19 -48 11 12 -259 0 -5 83 -8 0 7 8 9 -5 0 16 -3 17 18 -226 0 10 19 12 -12 0 10 -39 11 19 -17 11 19 -14 11 12 -272 0 13 14 15 -236 0 10 11 12 -12 0 10 -70 11 19 11 12 -272 0 10 19 12 -236 0 10 11 12 -12 0 10 -27 11 19 -44 11 12 -255 0 2909 2910 -9 8 9 -5 0 16 17 18 -236 0 10 11 12 -12 0 10 -72 11 12 -253 0 3141 3142 2911 2912 -9 14 15 -244 0 10 11 12 -12 0 10 -15 11 19 -46 11 19 -9 11 12 -205 0 -6 44 -41 0 1837 3145 3146 1834 11 19 -6 11 19 11 12 -244 0 10 11 12 -12 0 10 -9 11 19 -15 11 19 -29 11 19 -16 11 12 -205 0 78 -2 83 3161 83 78 -40 0 1837 1839 3148 2929 2930 -10 17 18 -244 0 10 11 12 -12 0 10 -4 11 19 -14 11 19 -31 11 19 -8 11 19 -11 11 12 -250 0 1837 1839 1841 2935 2931 -256 0 10 11 12 -12 0 10 -35 11 19 -36 11 12 -249 0 3150 1839 1841 2935 2936 -257 0 10 11 12 -12 0 10 -72 11 12 -203 0 7 -8 8 9 -35 0 3153 3154 1841 2935 2936 -258 0 10 11 12 -12 0 10 -6 11 19 -39 11 19 -17 11 19 -5 11 19 11 12 -203 0 13 -8 14 15 -33 0 1826 1829 3157 3158 2935 2936 -259 0 10 11 12 -12 0 10 -3 11 19 -68 11 12 -203 0 16 -8 17 18 -31 0 1826 1829 1830 1833 1834 2935 2936 -260 0 10 11 12 -12 0 10 -32 11 19 -39 11 12 -242 0 1826 1829 1830 1833 1834 2929 2930 2936 -261 0 10 11 12 -12 0 10 -72 11 12 -195 0 7 -3 8 9 -16 0 7 -3 8 9 -19 0 1826 1829 1830 1833 1834 2929 2930 2931 -263 0 10 11 12 -12 0 10 -5 11 19 -24 11 19 -11 11 19 -29 11 12 -195 0 13 -3 14 15 -16 0 13 -3 14 15 -11 0 7 -5 8 2921 2922 1830 1833 1834 2929 2930 2931 -265 0 10 11 12 -12 0 10 -59 11 19 -2 11 19 -4 11 19 -4 11 12 -195 0 16 -3 17 18 -16 0 16 -3 17 18 -11 0 13 -5 14 2923 2924 1834 2929 2930 2931 -267 0 10 11 12 -12 0 10 -31 11 19 -40 11 12 -232 0 10 -2 11 19 -3 11 2929 2930 2931 -269 0 10 19 12 -12 0 10 -16 11 19 -55 11 12 -190 0 7 -34 8 9 -6 0 16 -6 17 2931 -271 0 10 11 12 -12 0 10 -26 11 19 -2 11 19 -9 11 19 -14 11 19 -17 11 12 -165 0 7 -18 8 9 -5 0 13 -34 14 15 -285 0 10 11 12 -12 0 10 -72 11 12 -165 0 13 -18 14 15 -5 0 10 -9 11 19 -10 11 19 -5 11 19 -4 11 19 -2 11 12 -285 0 10 11 12 -12 0 10 -12 11 19 -59 11 12 -138 0 -2 44 -25 0 10 -18 11 12 -5 0 10 -13 11 19 -11 11 2929 2930 -7 17 18 -285 0 10 11 12 -12 0 10 -22 11 19 -4 11 19 -41 11 19 -2 11 12 -137 0 44 -2 0 44 -5 0 7 -18 8 22 -2 11 19 -3 11 19 -11 11 12 -5 0 10 -2 11 115 116 19 -11 11 2929 2930 -7 17 2931 -294 0 10 11 12 -12 0 10 -38 11 19 -33 11 12 -127 0 -2 83 -17 0 13 -18 14 23 -16 11 19 11 12 -5 0 10 -2 11 117 118 -7 11 2929 2930 -3 17 2931 -303 0 10 11 12 -12 0 10 -49 11 19 -22 11 12 -146 0 10 -4 11 19 -16 11 19 -15 11 12 -5 0 10 -7 11 2929 2930 -2 17 2931 -308 0 10 11 12 -12 0 10 -3 11 19 -5 11 19 -56 11 19 -5 11 12 -133 0 7 -12 8 22 -26 11 19 -10 11 12 -5 0 10 -6 11 2935 2931 -312 0 10 11 12 -12 0 10 -19 11 19 -50 11 19 11 12 -123 0 7 -9 8 114 -12 14 23 -15 11 19 -21 11 12 -5 0 10 11 19 -3 11 2935 2936 -313 0 10 11 12 -12 0 10 -35 11 19 -36 11 12 -111 0 -12 8 114 -9 14 23 -4 11 19 -11 11 19 -33 11 12 -5 0 10 -4 11 2935 2936 -314 0 10 19 12 -12 0 10 -5 11 19 -40 11 19 -14 11 19 -10 11 12 -111 0 -12 14 23 -32 11 19 -27 11 12 -5 0 10 -3 11 2935 2936 -315 0 10 11 12 -12 0 10 -72 11 12 -111 0 116 -10 11 19 -12 11 19 -6 11 19 -32 11 19 -8 11 12 -5 0 10 -2 11 2935 2936 -316 0 10 11 12 -12 0 10 -31 11 19 -40 11 12 -111 0 118 -2 11 19 -46 11 19 -15 11 19 -6 11 12 -5 0 10 11 2935 2936 -317 0 10 11 12 -12 0 10 -16 11 19 -52 11 19 -2 11 12 -111 0 -18 11 19 -54 11 12 -5 0 10 2940 2936 -318 0 10 19 12 -12 0 10 -26 11 19 -2 11 19 -15 11 19 -11 11 19 -14 11 12 -111 0 -73 11 12 -5 0 10 2941 -319 0 10 11 12 -12 0 10 -8 11 19 -33 11 19 -29 11 12 -111 0 -73 17 18 -5 0 16 2942 -319 0 10 11 12 -12 0 10 -18 11 19 -49 11 19 -3 11 12 -511 0 10 19 12 -12 0 10 -34 11 19 -36 11 19 12 -111 0)
    )
    (torch
      (z-pos 0)
      (x 320)
      (y 2880)
    )
    (torch
      (z-pos 0)
      (x 3648)
      (y 2592)
    )
    (torch
      (z-pos 0)
      (x 6752)
      (y 1664)
    )
    (torch
      (z-pos 0)
      (x 9056)
      (y 640)
    )
    (torch
      (sprite "/images/objects/torch/torch2.sprite")
      (z-pos 0)
      (x 8864)
      (y 640)
    )
    (torch
      (sprite "/images/objects/torch/torch2.sprite")
      (z-pos 0)
      (x 13280)
      (y 288)
    )
    (torch
      (z-pos 0)
      (x 14464)
      (y 288)
    )
  )
)
