(supertux-level
  (version 3)
  (name (_ "Platforms In The Icy River"))
  (author "AnatolyStev (Original), Vaesea (Remake)")
  (license "CC-BY-SA 4.0 International")
  (target-time 62)
  (allow-item-pocket "inherit")
  (icon "")
  (icon-locked "")
  (statistics
    (enable-coins #t)
    (enable-secrets #t)
  )
  (sector
    (name "main")
    (ambient-light
      (color 1 1 1)
    )
    (background
      (color 1 1 1)
      (speed 0.5)
      (image "images/background/arctis2.png")
    )
    (bonusblock
      (z-pos 51)
      (count 5)
      (sprite "/images/objects/bonus_block/purpleblock.sprite")
      (x 5024)
      (y 864)
    )
    (bonusblock
      (z-pos 51)
      (count 3)
      (sprite "/images/objects/bonus_block/orangeblock.sprite")
      (x 4992)
      (y 544)
    )
    (camera
      (name "Camera")
      (mode "normal")
    )
    (decal
      (z-pos -100)
      (sprite "/images/decal/snow/exitbg.png")
      (x 15680)
      (y 672)
    )
    (decal
      (z-pos 100)
      (sprite "/images/decal/snow/exitfg.png")
      (x 15776)
      (y 672)
    )
    (firefly
      (z-pos 0)
      (x 9408)
      (y 832)
    )
    (fish-jumping
      (z-pos 50)
      (x 7552)
      (y 736)
      (glinting #f)
    )
    (fish-jumping
      (z-pos 50)
      (x 7136)
      (y 736)
      (glinting #f)
    )
    (fish-jumping
      (z-pos 50)
      (x 8384)
      (y 736)
      (glinting #f)
    )
    (flyingsnowball
      (z-pos 50)
      (x 2688)
      (y 672)
      (glinting #f)
    )
    (flyingsnowball
      (z-pos 50)
      (x 11680)
      (y 864)
      (glinting #f)
    )
    (jumpy
      (z-pos 50)
      (x 3424)
      (y 864)
      (glinting #f)
    )
    (jumpy
      (z-pos 50)
      (x 3968)
      (y 864)
      (glinting #f)
    )
    (jumpy
      (z-pos 50)
      (x 10832)
      (y 672)
      (glinting #f)
    )
    (jumpy
      (z-pos 50)
      (x 11344)
      (y 736)
      (glinting #f)
    )
    (jumpy
      (z-pos 50)
      (x 11968)
      (y 864)
      (glinting #f)
    )
    (jumpy
      (z-pos 50)
      (x 12832)
      (y 864)
      (glinting #f)
    )
    (mrbomb
      (z-pos 50)
      (direction "left")
      (x 13728)
      (y 768)
      (glinting #f)
    )
    (mriceblock
      (z-pos 50)
      (direction "left")
      (x 7840)
      (y 896)
      (glinting #f)
    )
    (music
      (file "/music/antarctic/airship_remix.music")
    )
    (path
      (name "gen17666524102173696920096")
      (path
        (mode "oneshot")
        (adapt_speed #f)
        (node
          (x 704)
          (y 928)
        )
      )
    )
    (path
      (name "gen17666524752173696917216")
      (path
        (mode "oneshot")
        (adapt_speed #f)
        (node
          (x 1120)
          (y 960)
        )
      )
    )
    (path
      (name "gen17666524792173696919088")
      (path
        (mode "oneshot")
        (adapt_speed #f)
        (node
          (x 1536)
          (y 928)
        )
      )
    )
    (path
      (name "gen17666525392173696919808")
      (path
        (mode "oneshot")
        (adapt_speed #f)
        (node
          (x 1952)
          (y 928)
        )
      )
    )
    (path
      (name "gen17666525422173696914480")
      (path
        (mode "oneshot")
        (adapt_speed #f)
        (node
          (x 2368)
          (y 928)
        )
      )
    )
    (path
      (name "gen17666525732173696914624")
      (path
        (mode "oneshot")
        (adapt_speed #f)
        (node
          (x 2784)
          (y 928)
        )
      )
    )
    (path
      (name "gen17666525972173696916928")
      (path
        (mode "oneshot")
        (adapt_speed #f)
        (node
          (x 3200)
          (y 928)
        )
      )
    )
    (path
      (name "gen17666526002173696922112")
      (path
        (mode "oneshot")
        (adapt_speed #f)
        (node
          (x 3456)
          (y 928)
        )
      )
    )
    (path
      (name "gen17666526012173696920384")
      (path
        (mode "oneshot")
        (adapt_speed #f)
        (node
          (x 3712)
          (y 928)
        )
      )
    )
    (path
      (name "gen17666526022173696916064")
      (path
        (mode "oneshot")
        (adapt_speed #f)
        (node
          (x 3968)
          (y 928)
        )
      )
    )
    (path
      (name "gen17666527302173696940256")
      (path
        (mode "oneshot")
        (adapt_speed #f)
        (node
          (x 3584)
          (y 800)
        )
      )
    )
    (path
      (name "gen17666529452173696940400")
      (path
        (mode "oneshot")
        (adapt_speed #f)
        (node
          (x 4384)
          (y 928)
        )
      )
    )
    (path
      (name "gen17666529872173696934784")
      (path
        (mode "oneshot")
        (adapt_speed #f)
        (node
          (x 4672)
          (y 960)
        )
      )
    )
    (path
      (name "gen17666529972173696940544")
      (path
        (mode "oneshot")
        (adapt_speed #f)
        (node
          (x 4960)
          (y 992)
        )
      )
    )
    (path
      (name "gen17666530082173696935072")
      (path
        (mode "oneshot")
        (adapt_speed #f)
        (node
          (x 5248)
          (y 960)
        )
      )
    )
    (path
      (name "gen17666530152173696937952")
      (path
        (mode "oneshot")
        (adapt_speed #f)
        (node
          (x 5536)
          (y 928)
        )
      )
    )
    (path
      (name "gen17666530322173696940688")
      (path
        (mode "oneshot")
        (adapt_speed #f)
        (node
          (x 4672)
          (y 768)
        )
      )
    )
    (path
      (name "gen17666530352173696933776")
      (path
        (mode "oneshot")
        (adapt_speed #f)
        (node
          (x 4896)
          (y 672)
        )
      )
    )
    (path
      (name "gen17666530442173696933056")
      (path
        (mode "oneshot")
        (adapt_speed #f)
        (node
          (x 5248)
          (y 768)
        )
      )
    )
    (path
      (name "gen17666532602173696936512")
      (path
        (mode "oneshot")
        (adapt_speed #f)
        (node
          (x 5824)
          (y 960)
        )
      )
    )
    (path
      (name "gen17666532682173696940112")
      (path
        (mode "oneshot")
        (adapt_speed #f)
        (node
          (x 6112)
          (y 928)
        )
      )
    )
    (path
      (name "gen17666532882173696940832")
      (path
        (mode "oneshot")
        (adapt_speed #f)
        (node
          (x 6400)
          (y 928)
        )
      )
    )
    (path
      (name "gen17666532972173696936656")
      (path
        (mode "oneshot")
        (adapt_speed #f)
        (node
          (x 6816)
          (y 928)
        )
      )
    )
    (path
      (name "gen17666533442173696938384")
      (path
        (mode "oneshot")
        (adapt_speed #f)
        (node
          (x 7232)
          (y 960)
        )
      )
    )
    (path
      (name "gen17666533482173696933200")
      (path
        (mode "oneshot")
        (adapt_speed #f)
        (node
          (x 7648)
          (y 928)
        )
      )
    )
    (path
      (name "gen17666534652173696938240")
      (path
        (mode "oneshot")
        (adapt_speed #f)
        (node
          (x 8064)
          (y 928)
        )
      )
    )
    (path
      (name "gen17666534952173696938672")
      (path
        (mode "oneshot")
        (adapt_speed #f)
        (node
          (x 8512)
          (y 960)
        )
      )
    )
    (path
      (name "gen17666535032173696941408")
      (path
        (mode "oneshot")
        (adapt_speed #f)
        (node
          (x 8928)
          (y 928)
        )
      )
    )
    (path
      (name "gen17666537312173696948608")
      (path
        (mode "oneshot")
        (adapt_speed #f)
        (node
          (x 10336)
          (y 928)
        )
      )
    )
    (path
      (name "gen17666537362173696948464")
      (path
        (mode "oneshot")
        (adapt_speed #f)
        (node
          (x 10592)
          (y 928)
        )
      )
    )
    (path
      (name "gen17666537372173696946592")
      (path
        (mode "oneshot")
        (adapt_speed #f)
        (node
          (x 10848)
          (y 928)
        )
      )
    )
    (path
      (name "gen17666537382173696944288")
      (path
        (mode "oneshot")
        (adapt_speed #f)
        (node
          (x 11104)
          (y 928)
        )
      )
    )
    (path
      (name "gen17666537402173696945152")
      (path
        (mode "oneshot")
        (adapt_speed #f)
        (node
          (x 11360)
          (y 928)
        )
      )
    )
    (path
      (name "gen17666538962173696949184")
      (path
        (mode "oneshot")
        (adapt_speed #f)
        (node
          (x 11776)
          (y 928)
        )
      )
    )
    (path
      (name "gen17666539032173696945152")
      (path
        (mode "oneshot")
        (adapt_speed #f)
        (node
          (x 12032)
          (y 960)
        )
      )
    )
    (path
      (name "gen17666539042173696942992")
      (path
        (mode "oneshot")
        (adapt_speed #f)
        (node
          (x 12288)
          (y 992)
        )
      )
    )
    (path
      (name "gen17666539062173696949472")
      (path
        (mode "oneshot")
        (adapt_speed #f)
        (node
          (x 12544)
          (y 960)
        )
      )
    )
    (path
      (name "gen17666539082173696946592")
      (path
        (mode "oneshot")
        (adapt_speed #f)
        (node
          (x 12800)
          (y 928)
        )
      )
    )
    (path
      (name "gen17666542632173696953504")
      (path
        (mode "oneshot")
        (adapt_speed #f)
        (node
          (x 14368)
          (y 928)
        )
      )
    )
    (path
      (name "gen17666542672173696957392")
      (path
        (mode "oneshot")
        (adapt_speed #f)
        (node
          (x 14624)
          (y 928)
        )
      )
    )
    (platform
      (z-pos 50)
      (handle
        (scale_x 0)
        (scale_y 0)
        (offset_x 0)
        (offset_y 0)
      )
      (running #f)
      (path-ref "gen17666524102173696920096")
      (sprite "/images/objects/platforms/icefloe.sprite")
    )
    (platform
      (z-pos 50)
      (handle
        (scale_x 0)
        (scale_y 0)
        (offset_x 0)
        (offset_y 0)
      )
      (running #f)
      (path-ref "gen17666524752173696917216")
      (sprite "/images/objects/platforms/icefloe.sprite")
    )
    (platform
      (z-pos 50)
      (handle
        (scale_x 0)
        (scale_y 0)
        (offset_x 0)
        (offset_y 0)
      )
      (running #f)
      (path-ref "gen17666524792173696919088")
      (sprite "/images/objects/platforms/icefloe.sprite")
    )
    (platform
      (z-pos 50)
      (handle
        (scale_x 0)
        (scale_y 0)
        (offset_x 0)
        (offset_y 0)
      )
      (running #f)
      (path-ref "gen17666525392173696919808")
      (sprite "/images/objects/platforms/icefloe.sprite")
    )
    (platform
      (z-pos 50)
      (handle
        (scale_x 0)
        (scale_y 0)
        (offset_x 0)
        (offset_y 0)
      )
      (running #f)
      (path-ref "gen17666525422173696914480")
      (sprite "/images/objects/platforms/icefloe.sprite")
    )
    (platform
      (z-pos 50)
      (handle
        (scale_x 0)
        (scale_y 0)
        (offset_x 0)
        (offset_y 0)
      )
      (running #f)
      (path-ref "gen17666525732173696914624")
      (sprite "/images/objects/platforms/icefloe.sprite")
    )
    (platform
      (z-pos 50)
      (handle
        (scale_x 0)
        (scale_y 0)
        (offset_x 0)
        (offset_y 0)
      )
      (running #f)
      (path-ref "gen17666525972173696916928")
      (sprite "/images/objects/platforms/icefloe.sprite")
    )
    (platform
      (z-pos 50)
      (handle
        (scale_x 0)
        (scale_y 0)
        (offset_x 0)
        (offset_y 0)
      )
      (running #f)
      (path-ref "gen17666526002173696922112")
      (sprite "/images/objects/platforms/icefloe.sprite")
    )
    (platform
      (z-pos 50)
      (handle
        (scale_x 0)
        (scale_y 0)
        (offset_x 0)
        (offset_y 0)
      )
      (running #f)
      (path-ref "gen17666526012173696920384")
      (sprite "/images/objects/platforms/icefloe.sprite")
    )
    (platform
      (z-pos 50)
      (handle
        (scale_x 0)
        (scale_y 0)
        (offset_x 0)
        (offset_y 0)
      )
      (running #f)
      (path-ref "gen17666526022173696916064")
      (sprite "/images/objects/platforms/icefloe.sprite")
    )
    (platform
      (z-pos 50)
      (handle
        (scale_x 0)
        (scale_y 0)
        (offset_x 0)
        (offset_y 0)
      )
      (running #f)
      (path-ref "gen17666527302173696940256")
      (sprite "/images/objects/platforms/icefloe.sprite")
    )
    (platform
      (z-pos 50)
      (handle
        (scale_x 0)
        (scale_y 0)
        (offset_x 0)
        (offset_y 0)
      )
      (running #f)
      (path-ref "gen17666529452173696940400")
      (sprite "/images/objects/platforms/icefloe_small.sprite")
    )
    (platform
      (z-pos 50)
      (handle
        (scale_x 0)
        (scale_y 0)
        (offset_x 0)
        (offset_y 0)
      )
      (running #f)
      (path-ref "gen17666529872173696934784")
      (sprite "/images/objects/platforms/icefloe_small.sprite")
    )
    (platform
      (z-pos 50)
      (handle
        (scale_x 0)
        (scale_y 0)
        (offset_x 0)
        (offset_y 0)
      )
      (running #f)
      (path-ref "gen17666529972173696940544")
      (sprite "/images/objects/platforms/icefloe_small.sprite")
    )
    (platform
      (z-pos 50)
      (handle
        (scale_x 0)
        (scale_y 0)
        (offset_x 0)
        (offset_y 0)
      )
      (running #f)
      (path-ref "gen17666530082173696935072")
      (sprite "/images/objects/platforms/icefloe_small.sprite")
    )
    (platform
      (z-pos 50)
      (handle
        (scale_x 0)
        (scale_y 0)
        (offset_x 0)
        (offset_y 0)
      )
      (running #f)
      (path-ref "gen17666530152173696937952")
      (sprite "/images/objects/platforms/icefloe_small.sprite")
    )
    (platform
      (z-pos 50)
      (handle
        (scale_x 0)
        (scale_y 0)
        (offset_x 0)
        (offset_y 0)
      )
      (running #f)
      (path-ref "gen17666530322173696940688")
      (sprite "/images/objects/platforms/icefloe_small.sprite")
    )
    (platform
      (z-pos 50)
      (handle
        (scale_x 0)
        (scale_y 0)
        (offset_x 0)
        (offset_y 0)
      )
      (running #f)
      (path-ref "gen17666530352173696933776")
      (sprite "/images/objects/platforms/icefloe.sprite")
    )
    (platform
      (z-pos 50)
      (handle
        (scale_x 0)
        (scale_y 0)
        (offset_x 0)
        (offset_y 0)
      )
      (running #f)
      (path-ref "gen17666530442173696933056")
      (sprite "/images/objects/platforms/icefloe_small.sprite")
    )
    (platform
      (z-pos 50)
      (handle
        (scale_x 0)
        (scale_y 0)
        (offset_x 0)
        (offset_y 0)
      )
      (running #f)
      (path-ref "gen17666532602173696936512")
      (sprite "/images/objects/platforms/icefloe_small.sprite")
    )
    (platform
      (z-pos 50)
      (handle
        (scale_x 0)
        (scale_y 0)
        (offset_x 0)
        (offset_y 0)
      )
      (running #f)
      (path-ref "gen17666532682173696940112")
      (sprite "/images/objects/platforms/icefloe_small.sprite")
    )
    (platform
      (z-pos 50)
      (handle
        (scale_x 0)
        (scale_y 0)
        (offset_x 0)
        (offset_y 0)
      )
      (running #f)
      (path-ref "gen17666532882173696940832")
      (sprite "/images/objects/platforms/icefloe.sprite")
    )
    (platform
      (z-pos 50)
      (handle
        (scale_x 0)
        (scale_y 0)
        (offset_x 0)
        (offset_y 0)
      )
      (running #f)
      (path-ref "gen17666532972173696936656")
      (sprite "/images/objects/platforms/icefloe.sprite")
    )
    (platform
      (z-pos 50)
      (handle
        (scale_x 0)
        (scale_y 0)
        (offset_x 0)
        (offset_y 0)
      )
      (running #f)
      (path-ref "gen17666533442173696938384")
      (sprite "/images/objects/platforms/icefloe.sprite")
    )
    (platform
      (z-pos 50)
      (handle
        (scale_x 0)
        (scale_y 0)
        (offset_x 0)
        (offset_y 0)
      )
      (running #f)
      (path-ref "gen17666533482173696933200")
      (sprite "/images/objects/platforms/icefloe.sprite")
    )
    (platform
      (z-pos 50)
      (handle
        (scale_x 0)
        (scale_y 0)
        (offset_x 0)
        (offset_y 0)
      )
      (running #f)
      (path-ref "gen17666534652173696938240")
      (sprite "/images/objects/platforms/icefloe.sprite")
    )
    (platform
      (z-pos 50)
      (handle
        (scale_x 0)
        (scale_y 0)
        (offset_x 0)
        (offset_y 0)
      )
      (running #f)
      (path-ref "gen17666534952173696938672")
      (sprite "/images/objects/platforms/icefloe.sprite")
    )
    (platform
      (z-pos 50)
      (handle
        (scale_x 0)
        (scale_y 0)
        (offset_x 0)
        (offset_y 0)
      )
      (running #f)
      (path-ref "gen17666535032173696941408")
      (sprite "/images/objects/platforms/icefloe.sprite")
    )
    (platform
      (z-pos 50)
      (handle
        (scale_x 0)
        (scale_y 0)
        (offset_x 0)
        (offset_y 0)
      )
      (running #f)
      (path-ref "gen17666537312173696948608")
      (sprite "/images/objects/platforms/icefloe.sprite")
    )
    (platform
      (z-pos 50)
      (handle
        (scale_x 0)
        (scale_y 0)
        (offset_x 0)
        (offset_y 0)
      )
      (running #f)
      (path-ref "gen17666537362173696948464")
      (sprite "/images/objects/platforms/icefloe.sprite")
    )
    (platform
      (z-pos 50)
      (handle
        (scale_x 0)
        (scale_y 0)
        (offset_x 0)
        (offset_y 0)
      )
      (running #f)
      (path-ref "gen17666537372173696946592")
      (sprite "/images/objects/platforms/icefloe.sprite")
    )
    (platform
      (z-pos 50)
      (handle
        (scale_x 0)
        (scale_y 0)
        (offset_x 0)
        (offset_y 0)
      )
      (running #f)
      (path-ref "gen17666537382173696944288")
      (sprite "/images/objects/platforms/icefloe.sprite")
    )
    (platform
      (z-pos 50)
      (handle
        (scale_x 0)
        (scale_y 0)
        (offset_x 0)
        (offset_y 0)
      )
      (running #f)
      (path-ref "gen17666537402173696945152")
      (sprite "/images/objects/platforms/icefloe.sprite")
    )
    (platform
      (z-pos 50)
      (handle
        (scale_x 0)
        (scale_y 0)
        (offset_x 0)
        (offset_y 0)
      )
      (running #f)
      (path-ref "gen17666538962173696949184")
      (sprite "/images/objects/platforms/icefloe.sprite")
    )
    (platform
      (z-pos 50)
      (handle
        (scale_x 0)
        (scale_y 0)
        (offset_x 0)
        (offset_y 0)
      )
      (running #f)
      (path-ref "gen17666539032173696945152")
      (sprite "/images/objects/platforms/icefloe.sprite")
    )
    (platform
      (z-pos 50)
      (handle
        (scale_x 0)
        (scale_y 0)
        (offset_x 0)
        (offset_y 0)
      )
      (running #f)
      (path-ref "gen17666539042173696942992")
      (sprite "/images/objects/platforms/icefloe.sprite")
    )
    (platform
      (z-pos 50)
      (handle
        (scale_x 0)
        (scale_y 0)
        (offset_x 0)
        (offset_y 0)
      )
      (running #f)
      (path-ref "gen17666539062173696949472")
      (sprite "/images/objects/platforms/icefloe.sprite")
    )
    (platform
      (z-pos 50)
      (handle
        (scale_x 0)
        (scale_y 0)
        (offset_x 0)
        (offset_y 0)
      )
      (running #f)
      (path-ref "gen17666539082173696946592")
      (sprite "/images/objects/platforms/icefloe.sprite")
    )
    (platform
      (z-pos 50)
      (handle
        (scale_x 0)
        (scale_y 0)
        (offset_x 0)
        (offset_y 0)
      )
      (running #f)
      (path-ref "gen17666542632173696953504")
      (sprite "/images/objects/platforms/icefloe.sprite")
    )
    (platform
      (z-pos 50)
      (handle
        (scale_x 0)
        (scale_y 0)
        (offset_x 0)
        (offset_y 0)
      )
      (running #f)
      (path-ref "gen17666542672173696957392")
      (sprite "/images/objects/platforms/icefloe.sprite")
    )
    (sequencetrigger
      (sequence "endsequence")
      (width 32)
      (height 864)
      (x 15424)
      (y 0)
    )
    (sequencetrigger
      (sequence "stoptux")
      (width 32)
      (height 768)
      (x 15968)
      (y 160)
    )
    (smartball
      (z-pos 50)
      (direction "left")
      (x 1312)
      (y 928)
      (glinting #f)
    )
    (smartball
      (z-pos 50)
      (direction "left")
      (x 6592)
      (y 896)
      (glinting #f)
    )
    (smartball
      (z-pos 50)
      (direction "left")
      (x 14144)
      (y 896)
      (glinting #f)
    )
    (smartball
      (z-pos 50)
      (direction "left")
      (x 13856)
      (y 896)
      (glinting #f)
    )
    (smartball
      (z-pos 50)
      (direction "left")
      (x 13856)
      (y 640)
      (glinting #f)
    )
    (smartball
      (z-pos 50)
      (direction "left")
      (x 13568)
      (y 640)
      (glinting #f)
    )
    (smartball
      (z-pos 50)
      (direction "left")
      (x 14816)
      (y 896)
      (glinting #f)
    )
    (smartblock
      (z-pos 50)
      (direction "left")
      (x 13728)
      (y 512)
      (glinting #f)
    )
    (snowball
      (z-pos 50)
      (direction "left")
      (x 3904)
      (y 896)
      (glinting #f)
    )
    (snowball
      (z-pos 50)
      (direction "left")
      (x 11168)
      (y 896)
      (glinting #f)
    )
    (snowball
      (z-pos 50)
      (direction "left")
      (x 12512)
      (y 960)
      (glinting #f)
    )
    (spawnpoint
      (name "main")
      (x 64)
      (y 832)
    )
    (tilemap
      (solid #f)
      (z-pos -100)
      (width 500)
      (height 35)
      (tiles -9481 0 130 -499 0 129 -499 0 129 -499 0 129 -496 0 122 123 0 129 -323 0 122 123 -171 0 124 125 0 129 -23 0 122 123 -294 0 122 123 -2 0 124 125 -171 0 124 125 0 129 -23 0 124 125 -294 0 124 125 -2 0 124 125 -171 0 124 125 0 129 -4 0 106 107 108 -16 0 124 125 -5 0 106 107 108 -280 0 106 107 108 -3 0 124 125 -2 0 124 125 -168 0 25 -2 0 124 125 0 129 -2 0 24 0 109 110 111 -11 0 24 0 25 -2 0 124 125 0 24 -3 0 109 110 111 25 -279 0 109 110 111 0 25 0 124 125 -2 0 124 125 24 -5 0 106 107 108 -495 0 25 0 109 110 111 -200 0 2198 2186 -498 0 2197 2198 2186 -497 0 2180 2181 2198 2186 -496 0 2188 2189 2179 2198 2186 -495 0 2196 2180 2181 2179 2198 2186 -494 0 2179 2188 2189 2187 2195 2198 -478 0)
    )
    (tilemap
      (solid #f)
      (z-pos 100)
      (width 500)
      (height 35)
      (tiles -9483 0 130 -499 0 129 -499 0 129 -499 0 129 -499 0 129 -499 0 129 -499 0 129 -499 0 129 -499 0 129 -4016 0)
    )
    (tilemap
      (solid #t)
      (z-pos 0)
      (width 500)
      (height 35)
      (tiles -6928 0 2947 -1728 0 83 -268 0 -5 83 -1683 0 -2 83 2948 83 -304 0 -4 83 -5 0 -4 83 -645 0 50 49 -5 0 50 49 -249 0 50 49 -239 0 48 51 52 -5 0 51 52 48 -204 0 83 -42 0 48 51 52 48 -183 0 78 -2 83 78 -22 0 78 -2 83 78 -24 0 50 49 50 49 -5 0 50 49 50 49 -245 0 50 49 50 49 50 49 -12 0 50 49 -61 0 -5 78 -4 0 -2 78 105 -2 78 -4 0 -5 78 -97 0 78 83 102 78 -36 0 48 51 52 51 52 -5 0 51 52 51 52 48 -136 0 78 -2 83 78 -36 0 78 102 83 78 -63 0 48 51 52 51 52 51 52 48 -10 0 48 51 52 48 -116 0 2909 2910 -41 8 9 -59 0 50 49 50 49 50 49 -5 0 50 49 50 49 50 49 -63 0 83 -135 0 7 -15 8 2913 2914 -24 0 50 49 50 49 50 49 50 49 50 49 -8 0 50 49 50 49 50 49 -28 0 78 102 83 78 -80 0 7 2921 2922 2911 2912 -41 14 15 -58 0 48 51 52 51 52 51 52 -5 0 51 52 51 52 51 52 48 -198 0 13 -15 14 2915 2916 2917 2918 -5 8 9 -15 0 48 51 52 51 52 51 52 51 52 51 52 48 -6 0 48 51 52 51 52 51 52 48 -111 0 13 2923 2924 1834 -23 11 19 -3 11 19 -13 11 19 12 -165 0 -4 44 -106 0 10 -4 11 115 116 -10 11 1835 2919 2920 -5 14 15 -95 0 27 -29 28 29 -26 0 10 -45 11 12 -275 0 10 11 19 -2 11 117 118 -14 11 19 -3 11 12 -95 0 27 -29 28 29 -26 0 10 -8 11 19 -23 11 19 -3 11 115 116 -7 11 12 -275 0 10 -24 11 12 -95 0 -3 211 27 29 -21 0 27 29 -3 211 -26 0 10 -36 11 117 118 -7 11 12 -275 0 10 -7 11 19 -16 11 12 -95 0 -3 212 47 -23 0 47 -3 212 -26 0 10 -6 11 115 116 -32 11 19 -4 11 12 -275 0 10 -12 11 19 -11 11 12 -95 0 -2 212 213 -25 0 213 -2 212 -26 0 10 -6 11 117 118 -7 11 19 -29 11 12 -275 0 10 -24 11 12 -95 0 -2 212 -27 0 -2 212 -26 0 10 -29 11)
    )
    (tilemap
      (solid #f)
      (z-pos -1)
      (width 500)
      (height 35)
      (tiles -14500 0 2019 2140 2141 2142 2019 2140 2141 2142 2019 2140 2141 2142 2019 2140 2141 2142 2019 2140 2141 2142 2019 2140 2141 2142 2019 2140 2141 2142 2019 2140 2141 2142 2019 2140 2141 2142 2019 2140 2141 2142 2019 2140 2141 2142 2019 2140 2141 2142 2019 2140 2141 2142 2019 2140 2141 2142 2019 2140 2141 2142 2019 2140 2141 2142 2019 2140 2141 2142 2019 2140 2141 2142 2019 2140 2141 2142 2019 2140 2141 2142 2019 2140 2141 2142 2019 2140 2141 2142 2019 2140 2141 2142 2019 2140 2141 2142 2019 2140 2141 2142 2019 2140 2141 2142 2019 2140 2141 2142 2019 2140 2141 2142 2019 2140 2141 2142 2019 2140 2141 2142 2019 2140 2141 2142 2019 2140 2141 2142 2019 2140 2141 2142 2019 2140 2141 2142 2019 2140 2141 2142 2019 2140 2141 2142 2019 2140 2141 2142 2019 2140 2141 2142 2019 2140 2141 2142 2019 2140 2141 2142 2019 2140 2141 2142 2019 2140 2141 2142 2019 2140 2141 2142 2019 2140 2141 2142 2019 2140 2141 2142 2019 2140 2141 2142 2019 2140 2141 2142 2019 2140 2141 2142 2019 2140 2141 2142 2019 2140 2141 2142 2019 2140 2141 2142 2019 2140 2141 2142 2019 2140 2141 2142 2019 2140 2141 2142 2019 2140 2141 2142 2019 2140 2141 2142 2019 2140 2141 2142 2019 2140 2141 2142 2019 2140 2141 2142 2019 2140 2141 2142 2019 2140 2141 2142 2019 2140 2141 2142 2019 2140 2141 2142 2019 2140 2141 2142 2019 2140 2141 2142 2019 2140 2141 2142 2019 2140 2141 2142 2019 2140 2141 2142 2019 2140 2141 2142 2019 2140 2141 2142 2019 2140 2141 2142 2019 2140 2141 2142 2019 2140 2141 2142 2019 2140 2141 2142 2019 2140 2141 2142 2019 2140 2141 2142 2019 2140 2141 2142 2019 2140 2141 2142 2019 2140 2141 2142 2019 2140 2141 2142 2019 2140 2141 2142 2019 2140 2141 2142 2019 2140 2141 2142 2019 2140 2141 2142 2019 2140 2141 2142 2019 2140 2141 2142 2019 2140 2141 2142 2019 2140 2141 2142 2019 2140 2141 2142 2019 2140 2141 2142 2019 2140 2141 2142 2019 2140 2141 2142 2019 2140 2141 2142 2019 2140 2141 2142 2019 2140 2141 2142 2019 2140 2141 2142 2019 2140 2141 2142 2019 2140 2141 2142 2019 2140 2141 2142 2019 2140 2141 2142 2019 2140 2141 2142 2019 2140 2141 2142 2019 2140 2141 2142 2019 2140 2141 2142 2019 2140 2141 2142 2019 2140 2141 2142 2019 2140 2141 2142 2019 2140 2141 2142 2019 2140 2141 2142 2019 2140 2141 2142 2019 2140 2141 2142 2019 2140 2141 2142 2019 2140 2141 2142 2019 2140 2141 2142 2019 2140 2141 2142 2019 2140 2141 2142 2019 2140 2141 2142 2019 2140 2141 2142 2019 2140 2141 2142 2019 2140 2141 2142 2019 2140 2141 2142 2019 2140 2141 2142 2019 2140 2141 2142 2019 2140 2141 2142 2019 2140 2141 2142 -2500 2020)
    )
  )
)
