(supertux-level
  (version 3)
  (name (_ "Platforming"))
  (author "Sophie \"Vaesea\" Ball")
  (license "CC-BY-SA 4.0 International")
  (target-time 97)
  (allow-item-pocket "inherit")
  (icon "")
  (icon-locked "")
  (statistics
    (enable-coins #t)
    (enable-secrets #t)
  )
  (sector
    (name "main")
    (ambient-light
      (color 1 1 1)
    )
    (background
      (color 1 1 1)
      (alignment "bottom")
      (speed 0.5)
      (speed-y 0)
      (image "/images/background/arctis2.png")
    )
    (bonusblock
      (z-pos 51)
      (count 3)
      (sprite "/images/objects/bonus_block/orangeblock.sprite")
      (x 576)
      (y 832)
    )
    (bonusblock
      (z-pos 51)
      (count 3)
      (sprite "/images/objects/bonus_block/orangeblock.sprite")
      (x 4288)
      (y 128)
    )
    (bouncingsnowball
      (z-pos 50)
      (direction "left")
      (x 6336)
      (y 736)
      (glinting #f)
    )
    (camera
      (name "Camera")
      (mode "normal")
    )
    (decal
      (z-pos -100)
      (sprite "/images/decal/snow/exitbg.png")
      (x 7808)
      (y 544)
    )
    (decal
      (z-pos 100)
      (sprite "/images/decal/snow/exitfg.png")
      (x 7904)
      (y 544)
    )
    (firefly
      (z-pos 0)
      (x 4352)
      (y 672)
    )
    (flyingsnowball
      (z-pos 50)
      (x 480)
      (y 320)
      (glinting #f)
    )
    (flyingsnowball
      (z-pos 50)
      (x 1472)
      (y 320)
      (glinting #f)
    )
    (flyingsnowball
      (z-pos 50)
      (x 4896)
      (y 640)
      (glinting #f)
    )
    (jumpy
      (z-pos 50)
      (x 976)
      (y 192)
      (glinting #f)
    )
    (jumpy
      (z-pos 50)
      (x 2064)
      (y 768)
      (glinting #f)
    )
    (jumpy
      (z-pos 50)
      (x 2784)
      (y 576)
      (glinting #f)
    )
    (jumpy
      (z-pos 50)
      (x 5632)
      (y 288)
      (glinting #f)
    )
    (jumpy
      (z-pos 50)
      (x 5216)
      (y 256)
      (glinting #f)
    )
    (jumpy
      (z-pos 50)
      (x 3072)
      (y 160)
      (glinting #f)
    )
    (mriceblock
      (z-pos 50)
      (direction "left")
      (x 704)
      (y 928)
      (glinting #f)
    )
    (mriceblock
      (z-pos 50)
      (direction "left")
      (x 1664)
      (y 896)
      (glinting #f)
    )
    (music
      (file "/music/antarctic/chipdisko.music")
    )
    (particles-snow
    )
    (path
      (name "gen1767451818139948389992192")
      (path
        (mode "pingpong")
        (adapt_speed #f)
        (node
          (x 3104)
          (y 736)
          (time 6)
        )
        (node
          (x 4096)
          (y 736)
          (time 6)
        )
      )
    )
    (path
      (name "gen1767453148139627338683040")
      (path
        (mode "pingpong")
        (adapt_speed #f)
        (node
          (x 6400)
          (y 736)
          (time 5)
        )
        (node
          (x 7168)
          (y 736)
          (time 5)
        )
      )
    )
    (platform
      (z-pos 50)
      (handle
        (scale_x 0)
        (scale_y 0)
        (offset_x 0)
        (offset_y 0)
      )
      (running #f)
      (name "platform")
      (path-ref "gen1767451818139948389992192")
    )
    (platform
      (z-pos 50)
      (handle
        (scale_x 0)
        (scale_y 0)
        (offset_x 0)
        (offset_y 0)
      )
      (running #f)
      (name "platform2")
      (path-ref "gen1767453148139627338683040")
    )
    (pushbutton
      (z-pos -99)
      (script "platform.start_moving();")
      (x 64)
      (y 272)
    )
    (sequencetrigger
      (sequence "endsequence")
      (width 32)
      (height 736)
      (x 7488)
      (y 0)
    )
    (sequencetrigger
      (sequence "stoptux")
      (width 96)
      (height 96)
      (x 8096)
      (y 704)
    )
    (smartball
      (z-pos 50)
      (direction "left")
      (x 1344)
      (y 928)
      (glinting #f)
    )
    (smartball
      (z-pos 50)
      (direction "left")
      (x 1728)
      (y 256)
      (glinting #f)
    )
    (smartball
      (z-pos 50)
      (direction "left")
      (x 352)
      (y 256)
      (glinting #f)
    )
    (smartball
      (z-pos 50)
      (direction "left")
      (x 4768)
      (y 704)
      (glinting #f)
    )
    (smartball
      (z-pos 50)
      (direction "left")
      (x 5600)
      (y 704)
      (glinting #f)
    )
    (smartball
      (z-pos 50)
      (direction "left")
      (x 6112)
      (y 704)
      (glinting #f)
    )
    (smartball
      (z-pos 50)
      (direction "left")
      (x 5408)
      (y 704)
      (glinting #f)
    )
    (smartblock
      (z-pos 50)
      (direction "left")
      (x 4384)
      (y 224)
      (glinting #f)
    )
    (snowball
      (z-pos 50)
      (direction "left")
      (x 1504)
      (y 896)
      (glinting #f)
    )
    (snowball
      (z-pos 50)
      (direction "left")
      (x 3008)
      (y 800)
      (glinting #f)
    )
    (spawnpoint
      (name "main")
      (x 64)
      (y 832)
    )
    (stalactite
      (glinting #f)
      (z-pos -1)
      (x 2656)
      (y 672)
    )
    (stalactite
      (glinting #f)
      (z-pos -1)
      (x 2720)
      (y 320)
    )
    (stalactite
      (glinting #f)
      (z-pos -1)
      (x 2400)
      (y 608)
    )
    (stalactite
      (glinting #f)
      (z-pos -1)
      (x 2368)
      (y 608)
    )
    (stalactite
      (glinting #f)
      (z-pos -1)
      (x 5536)
      (y 384)
    )
    (stalactite
      (glinting #f)
      (z-pos -1)
      (x 5952)
      (y 448)
    )
    (stalactite
      (glinting #f)
      (z-pos -1)
      (x 6144)
      (y 544)
    )
    (switch
      (z-pos 1)
      (script "platform2.start_moving();")
      (sprite "/images/objects/switch/right.sprite")
      (x 2814)
      (y 125)
    )
    (tilemap
      (solid #f)
      (z-pos -100)
      (width 260)
      (height 35)
      (tiles -867 0 48 -9 0 122 123 -30 0 122 123 -132 0 122 123 -72 0 122 123 -8 0 48 -6 0 122 123 0 124 125 -30 0 124 125 -132 0 124 125 -72 0 124 125 -2 0 122 123 -4 0 48 -6 0 124 125 0 124 125 -18 0 24 -11 0 124 125 -132 0 124 125 -72 0 124 125 -2 0 124 125 -11 0 124 125 24 124 125 -7 0 106 107 108 -20 0 124 125 -34 0 122 123 -6 0 122 123 -88 0 124 125 -3 0 106 107 108 -8 0 122 123 -56 0 124 125 -2 0 124 125 -22 0 24 109 110 111 -26 0 24 -7 0 25 -7 0 24 -8 0 122 123 -3 0 124 125 -6 0 124 125 -3 0 122 123 -80 0 25 -2 0 124 125 24 25 0 109 110 111 -8 0 124 125 -20 0 122 123 -6 0 25 -3 0 24 -8 0 106 107 108 -12 0 124 125 25 0 124 125 -2 0 24 -74 0 124 125 106 107 108 124 125 -6 0 124 125 -3 0 124 125 -99 0 124 125 -20 0 124 125 -19 0 109 110 111 -95 0 124 125 109 110 111 124 125 -6 0 124 125 -3 0 124 125 -99 0 124 125 24 -18 8 0 124 125 -130 0 124 125 25 0 24 124 125 -1093 0 130 -217 0 24 -41 0 129 -259 0 129 -100 0 24 -158 0 129 -114 0 106 107 108 -47 0 122 123 -18 0 122 123 -12 0 122 123 -59 0 129 -5 0 122 123 -103 0 25 -3 0 109 110 111 24 -41 0 122 123 -3 0 124 125 -18 0 124 125 -2 0 122 123 -8 0 124 125 -55 0 122 123 -2 0 129 -5 0 124 125 -152 0 124 125 -3 0 124 125 -18 0 124 125 -2 0 124 125 -8 0 124 125 -13 0 122 123 -40 0 124 125 -2 0 129 -5 0 124 125 -86 0 122 123 -64 0 124 125 -3 0 124 125 -18 0 124 125 25 0 124 125 -4 0 106 107 108 0 124 125 -13 0 124 125 -40 0 124 125 -2 0 129 -2 0 106 107 108 124 125 -16 0 106 107 108 -61 0 122 123 -4 0 124 125 -64 0 124 125 25 -2 0 124 125 -28 0 109 110 111 24 124 125 -10 0 25 0 24 124 125 -5 0 106 107 108 -32 0 124 125 25 0 129 -2 0 109 110 111 124 125 0 24 -11 0 24 25 0 109 110 111 -61 0 124 125 -4 0 124 125 -75 0 24 -49 0 109 110 111 -68 0 122 123 -54 0 124 125 -4 0 124 125 -21 0 106 107 108 -172 0 124 125 -21 0 122 123 -19 0 122 123 -10 0 124 125 0 25 0 24 124 125 -21 0 109 110 111 -167 0 106 107 108 -2 0 124 125 -21 0 124 125 -19 0 124 125 -33 0 24 -175 0 109 110 111 -2 0 124 125 24 0 25 -18 0 124 125 -19 0 124 125 -26 0 24 25 -206 0 25 -2 0 124 125 0 24 -5 0 106 107 108 -6 0 24 -2 0 124 125 0 25 -224 0 24 -19 0 109 110 111 -1520 0)
    )
    (tilemap
      (solid #f)
      (z-pos 100)
      (width 260)
      (height 35)
      (tiles -3875 0 130 -259 0 129 -259 0 129 -259 0 129 -259 0 129 -259 0 129 -259 0 129 -259 0 129 -259 0 129 -3144 0)
    )
    (tilemap
      (solid #t)
      (z-pos 0)
      (width 260)
      (height 35)
      (tiles -87 0 206 -37 0 10 -27 11 12 -193 0 206 -37 0 16 -9 17 31 30 -6 17 31 30 -8 17 18 -193 0 206 -47 0 10 12 -6 0 10 12 -202 0 206 -47 0 10 12 -2 0 7 9 -2 0 10 12 -2 0 7 9 -198 0 206 -45 0 83 0 10 12 -2 0 13 15 -2 0 10 12 -2 0 13 15 -2 83 -115 0 -4 83 -74 0 78 105 78 206 -27 0 7 -3 8 9 -15 0 16 18 -2 0 10 12 -2 0 16 18 -2 0 10 12 -198 0 206 -5 0 7 -5 8 9 -15 0 13 -3 14 15 -8 0 2909 2910 2913 2914 -7 0 10 12 -6 0 10 12 -198 0 206 -5 0 13 -5 14 15 -5 0 7 -3 8 9 -5 0 16 -3 17 18 -5 0 7 2921 2922 2911 2912 2915 2916 2917 2918 -5 8 22 21 -6 8 22 21 -4 8 9 -106 0 -12 8 9 -15 0 27 -4 28 29 -15 0 7 -5 8 9 -16 0 7 9 -2 0 7 -10 8 3044 -5 0 16 -5 17 18 -5 0 13 -3 14 15 -15 0 13 2923 2924 1834 -2 11 1835 2919 2920 -5 14 23 20 -6 14 23 20 -4 14 15 -106 0 -12 14 15 -12 0 27 -4 28 29 27 -4 28 29 -12 0 13 -5 14 15 -5 0 7 -4 8 9 -5 0 13 15 -2 0 13 -10 14 3048 -17 0 16 -3 17 18 -15 0 16 -27 17 18 -5 0 7 -7 8 9 -92 0 -12 17 18 -5 0 7 -3 8 27 -4 28 29 27 -4 28 29 27 -4 28 29 -3 8 9 -5 0 16 -5 17 18 -5 0 13 -4 14 15 -5 0 16 18 -2 0 16 -10 17 18 -71 0 13 -7 14 15 -4 0 7 -7 8 9 -97 0 13 -24 14 15 -17 0 16 -4 17 18 -92 0 16 -7 17 18 -4 0 13 -7 14 15 -97 0 16 -24 17 18 -128 0 16 -7 17 18 -5 0 7 9 -258 0 13 15 -258 0 16 18 -263 0 7 9 -150 0 -3 83 -3 0 -3 83 -99 0 13 15 -139 0 7 -4 8 9 -113 0 16 18 -139 0 13 -4 14 15 -118 0 7 9 -134 0 16 -4 17 18 -4 0 7 -9 8 9 -90 0 78 105 -11 0 13 15 -144 0 13 -9 14 15 -50 0 -2 83 102 83 -49 0 16 18 -144 0 16 -9 17 18 -63 0 7 -8 8 2913 2914 -189 0 202 -35 0 7 -7 8 2913 2914 -6 0 2909 2910 9 -5 0 13 -8 14 2915 2916 2917 2918 -7 8 9 -5 0 7 -8 8 2913 2914 -6 0 202 -28 0 7 -31 8 -96 0 203 -35 0 13 -7 14 2915 2916 2917 2918 -2 8 2921 2922 2911 2912 15 -5 0 10 -9 11 1835 2919 2920 -7 14 15 -5 0 13 -8 14 2915 2916 2917 2918 -4 8 3051 -28 0 13 -31 14 -96 0 206 -35 0 10 -8 11 1835 2919 2920 -2 14 2923 2924 1834 11 12 -5 0 10 -19 11 12 -5 0 10 -9 11 1835 2919 2920 -4 14 3048 -28 0 10 -31 11 -60 0 7 -8 8 9 -16 0 7 -9 8 3044 -35 0 10 -17 11 12 -5 0 10 -19 11 12 -5 0 10 -16 11 12 -28 0 10 -31 11 -15 0 83 78 83 0 83 78 83 -15 0 83 78 102 78 83 -12 0 202 -5 0 13 -8 14 15 -11 0 7 -4 8 114 -9 14 3048 -35 0 10 -17 11 12 -5 0 10 -19 11 12 -5 0 10 -16 11 12 -28 0 10 -31 11 -12 8 9 -41 0 203 -5 0 10 -8 11 21 -11 8 114 -4 14 23 -9 11 12 -35 0 10 -17 11 12 -5 0 10 -19 11 12 -5 0 10 -16 11 12 -28 0 10 -31 11 -12 14 15 -11 0 7 -8 8 2913 2914 -9 0 2909 2910 -8 8 3044 -5 0 10 -8 11 20 -11 14 23 -14 11 12 -35 0 10 -17 11 12 -5 0 10 -19 11 12 -5 0 10 -16 11 12 -28 0 10 -43 11 21 -11 8 114 -8 14 2915 2916 2917 2918 -5 8 2921 2922 2911 2912 -8 14 3048 -5 0 10 -35 11 12 -35 0 10 -17 11 12 -5 0 10 -19 11 12 -5 0 10 -16 11 12 -28 0 10 -43 11 20 -11 14 23 -9 11 1835 2919 2920 -5 14 2923 2924 1834 -9 11 12 -5 0 10 -35 11 12 -35 0 10 -17 11 12 -5 0 10 -19 11 12 -5 0 10 -16 11 12 -28 0 10 -85 11 12 -5 0 10 -35 11 12 -35 0 10 -17 11 12 -5 0 10 -19 11 12 -5 0 10 -16 11 12 -28 0 10 -85 11 12 -5 0 10 -35 11 12 -35 0 10 -17 11 12 -5 0 10 -19 11 12 -5 0 10 -16 11 12 -28 0 10 -85 11 12 -5 0 10 -35 11 12 -35 0 10 -17 11 12 -5 0 10 -19 11 12 -5 0 10 -16 11 12 -28 0 10 -85 11 12 -5 0 10 -35 11 12 -35 0 10 -17 11 12 -5 0 10 -19 11 12 -5 0 10 -16 11 12 -28 0 10 -31 11)
    )
    (trampoline
      (type "stationary")
      (z-pos 50)
      (x 2384)
      (y 544)
    )
  )
)
