(supertux-level
  (version 3)
  (name (_ "Quick Level"))
  (author "Sophie \"Vaesea\" Ball")
  (license "CC-BY-SA 4.0 International")
  (target-time 30)
  (allow-item-pocket "inherit")
  (icon "")
  (icon-locked "")
  (statistics
    (enable-coins #t)
    (enable-secrets #t)
  )
  (sector
    (name "main")
    (init-script "platform1.stop_moving();
platform2.stop_moving();
platform3.stop_moving();
platform4.stop_moving();
platform5.stop_moving();")
    (ambient-light
      (color 1 1 1)
    )
    (background
      (color 1 1 1)
      (speed 0.5)
      (image-top "/images/background/icecliffs/icecliffs-top.png")
      (image "/images/background/icecliffs/icecliffs-middle.png")
      (image-bottom "/images/background/icecliffs/icecliffs-bottom.png")
    )
    (bouncingsnowball
      (z-pos 50)
      (direction "left")
      (x 2656)
      (y 832)
      (glinting #f)
    )
    (bouncingsnowball
      (z-pos 50)
      (direction "left")
      (x 2976)
      (y 832)
      (glinting #f)
    )
    (bouncingsnowball
      (z-pos 50)
      (direction "left")
      (x 3232)
      (y 832)
      (glinting #f)
    )
    (bouncingsnowball
      (z-pos 50)
      (direction "left")
      (x 7616)
      (y 832)
      (glinting #f)
    )
    (bouncingsnowball
      (z-pos 50)
      (direction "left")
      (x 7488)
      (y 832)
      (glinting #f)
    )
    (bouncingsnowball
      (z-pos 50)
      (direction "left")
      (x 7424)
      (y 832)
      (glinting #f)
    )
    (bouncingsnowball
      (z-pos 50)
      (direction "left")
      (x 7552)
      (y 832)
      (glinting #f)
    )
    (camera
      (name "Camera")
      (mode "normal")
    )
    (haywire
      (z-pos 50)
      (direction "left")
      (x 1056)
      (y 864)
      (glinting #f)
    )
    (infoblock
      (z-pos 51)
      (message (_ "Run!"))
      (x 256)
      (y 800)
    )
    (jumpy
      (z-pos 50)
      (x 3424)
      (y 800)
      (glinting #f)
    )
    (jumpy
      (z-pos 50)
      (x 5376)
      (y 896)
      (glinting #f)
    )
    (jumpy
      (z-pos 50)
      (x 5216)
      (y 896)
      (glinting #f)
    )
    (jumpy
      (z-pos 50)
      (x 5056)
      (y 896)
      (glinting #f)
    )
    (jumpy
      (z-pos 50)
      (x 4896)
      (y 896)
      (glinting #f)
    )
    (jumpy
      (z-pos 50)
      (x 4736)
      (y 896)
      (glinting #f)
    )
    (leveltime
      (time 50)
    )
    (music
      (file "/music/antarctic/voc-daytime2.music")
    )
    (particles-snow
    )
    (particles-snow
    )
    (particles-snow
    )
    (path
      (name "gen17667514371683985581312")
      (path
        (mode "oneshot")
        (adapt_speed #f)
        (node
          (x 3488)
          (y 864)
          (time 2)
        )
        (node
          (x 3488)
          (y 608)
          (time 3)
        )
      )
    )
    (path
      (name "gen17667515291683985584192")
      (path
        (mode "oneshot")
        (adapt_speed #f)
        (node
          (x 3616)
          (y 864)
          (time 2)
        )
        (node
          (x 3616)
          (y 608)
          (time 3)
        )
      )
    )
    (path
      (name "gen17667515301683985581456")
      (path
        (mode "oneshot")
        (adapt_speed #f)
        (node
          (x 3744)
          (y 864)
          (time 2)
        )
        (node
          (x 3744)
          (y 608)
          (time 3)
        )
      )
    )
    (path
      (name "gen17667515311683985583904")
      (path
        (mode "oneshot")
        (adapt_speed #f)
        (node
          (x 3872)
          (y 864)
          (time 2)
        )
        (node
          (x 3872)
          (y 608)
          (time 3)
        )
      )
    )
    (path
      (name "gen17667515321683985583472")
      (path
        (mode "oneshot")
        (adapt_speed #f)
        (node
          (x 4000)
          (y 864)
          (time 2)
        )
        (node
          (x 4000)
          (y 608)
          (time 3)
        )
      )
    )
    (platform
      (z-pos 50)
      (handle
        (scale_x 0)
        (scale_y 0)
        (offset_x 0)
        (offset_y 0)
      )
      (running #f)
      (name "platform1")
      (path-ref "gen17667514371683985581312")
    )
    (platform
      (z-pos 50)
      (handle
        (scale_x 0)
        (scale_y 0)
        (offset_x 0)
        (offset_y 0)
      )
      (running #f)
      (name "platform2")
      (path-ref "gen17667515291683985584192")
    )
    (platform
      (z-pos 50)
      (handle
        (scale_x 0)
        (scale_y 0)
        (offset_x 0)
        (offset_y 0)
      )
      (running #f)
      (name "platform3")
      (path-ref "gen17667515301683985581456")
    )
    (platform
      (z-pos 50)
      (handle
        (scale_x 0)
        (scale_y 0)
        (offset_x 0)
        (offset_y 0)
      )
      (running #f)
      (name "platform4")
      (path-ref "gen17667515311683985583904")
    )
    (platform
      (z-pos 50)
      (handle
        (scale_x 0)
        (scale_y 0)
        (offset_x 0)
        (offset_y 0)
      )
      (running #f)
      (name "platform5")
      (path-ref "gen17667515321683985583472")
    )
    (powerup
      (z-pos 50)
      (script "Tux.trigger_sequence(\"fireworks\");")
      (sprite "/images/objects/crystals/crystal_1.sprite")
      (x 7776)
      (y 832)
    )
    (scripttrigger
      (oneshot #t)
      (script "platform1.start_moving();")
      (button #f)
      (width 28)
      (height 256)
      (x 3492)
      (y 608)
    )
    (scripttrigger
      (oneshot #t)
      (script "platform2.start_moving();")
      (button #f)
      (width 28)
      (height 256)
      (x 3620)
      (y 608)
    )
    (scripttrigger
      (oneshot #t)
      (script "platform3.start_moving();")
      (button #f)
      (width 24)
      (height 256)
      (x 3752)
      (y 608)
    )
    (scripttrigger
      (oneshot #t)
      (script "platform4.start_moving();")
      (button #f)
      (width 24)
      (height 256)
      (x 3880)
      (y 608)
    )
    (scripttrigger
      (oneshot #t)
      (script "platform5.start_moving();")
      (button #f)
      (width 24)
      (height 256)
      (x 4008)
      (y 608)
    )
    (smartball
      (z-pos 50)
      (direction "left")
      (x 928)
      (y 864)
      (glinting #f)
    )
    (smartball
      (z-pos 50)
      (direction "left")
      (x 1536)
      (y 864)
      (glinting #f)
    )
    (snowball
      (z-pos 50)
      (direction "left")
      (x 1632)
      (y 896)
      (glinting #f)
    )
    (snowball
      (z-pos 50)
      (direction "left")
      (x 7264)
      (y 864)
      (glinting #f)
    )
    (snowball
      (z-pos 50)
      (direction "left")
      (x 7104)
      (y 864)
      (glinting #f)
    )
    (snowman
      (z-pos 50)
      (direction "left")
      (x 2304)
      (y 800)
      (glinting #f)
    )
    (spawnpoint
      (name "main")
      (x 64)
      (y 864)
    )
    (stalactite
      (glinting #f)
      (z-pos -1)
      (x 6528)
      (y 832)
    )
    (stalactite
      (glinting #f)
      (z-pos -1)
      (x 6560)
      (y 832)
    )
    (stalactite
      (glinting #f)
      (z-pos -1)
      (x 6592)
      (y 832)
    )
    (tilemap
      (solid #f)
      (z-pos -100)
      (width 250)
      (height 35)
      (tiles -3617 0 106 107 108 -242 0 25 -4 0 109 110 111 -5 0 25 -2508 0 106 107 108 -156 0 106 107 108 -24 0 25 -60 0 25 -2 0 109 110 111 24 -86 0 106 107 108 -22 0 106 -3 0 106 107 108 -20 0 25 -4 0 24 -9 0 25 0 109 110 111 24 -13 0 24 0 25 -158 0 25 -2 0 109 110 111 24 -6 0 24 -4 0 25 -4 0 24 -2 0 25 0 109 25 -2 0 109 110 111 -2 0 24 -5 0 25 -4 0 24 -33 0 25 -163 0 25 -227 0 106 107 108 -14 0 24 -181 0 25 -6 0 24 -8 0 25 -3 0 24 -5 0 25 -2 0 24 -3 0 25 -7 0 25 24 -8 0 109 110 111 24 -2 0 25 -4 0 24 -1043 0)
    )
    (tilemap
      (solid #f)
      (z-pos 100)
      (width 250)
      (height 35)
      (tiles -8750 0)
    )
    (tilemap
      (solid #t)
      (z-pos 0)
      (width 250)
      (height 35)
      (tiles -173 0 10 -13 11 19 -11 11 19 -7 11 12 -215 0 10 -33 11 12 -215 0 10 -3 11 19 -29 11 12 -215 0 10 -29 11 19 -3 11 12 -215 0 10 -21 11 19 -11 11 12 -215 0 10 -8 11 19 -24 11 12 -215 0 10 -33 11 12 -215 0 10 -25 11 115 116 -6 11 12 -215 0 10 19 -24 11 117 118 -6 11 12 -215 0 10 -33 11 12 -215 0 10 -15 11 19 -16 11 19 12 -215 0 10 -3 11 19 -22 11 19 -6 11 12 -215 0 10 -33 11 12 -215 0 10 -19 11 19 -13 11 12 -215 0 10 -33 11 12 -151 0 7 -18 8 9 -44 0 10 -12 11 19 -20 11 12 -151 0 13 -18 14 15 -44 0 10 -30 11 19 -2 11 12 -151 0 10 -18 11 12 -44 0 10 -33 11 12 -151 0 10 -18 11 12 -44 0 10 -33 11 12 -112 0 -2 83 -37 0 16 -18 17 18 -44 0 10 -3 11 19 -29 11 12 -215 0 10 -23 11 19 -9 11 12 -215 0 10 -33 11 12 -111 0 -4 44 -100 0 10 -3 11 115 116 -4 11 19 -23 11 12 -78 0 -2 44 -31 0 27 -2 28 29 -100 0 10 -3 11 117 118 -28 11 12 -77 0 44 -2 0 44 -134 0 10 19 -13 11 19 -18 11 12 -93 0 78 83 3161 83 78 -117 0 10 -32 11 19 12 -109 0 2909 2910 -4 8 9 -55 0 7 -8 8 9 -34 0 16 -4 17 31 30 -4 17 31 30 -4 17 31 30 -4 17 31 30 -4 17 31 30 -3 17 18 -66 0 2909 2910 -8 8 9 -4 0 7 -8 8 2913 2914 -7 0 2909 2910 -6 8 2921 2922 2911 2912 -4 14 15 -55 0 13 -8 14 113 9 -35 0 7 9 0 10 12 0 7 9 0 10 12 0 7 9 0 10 12 0 7 9 0 10 12 0 7 9 0 10 12 -17 0 7 -50 8 2921 2922 2911 2912 -8 14 15 -4 0 13 -8 14 2915 2916 2917 2918 -3 8 2921 2922 2911 2912 -6 14 2923 2924 1834 -5 11 12 -55 0 10 11 19 -6 11 20 113 9 -34 0 13 15 44 10 12 44 13 15 44 10 12 44 13 15 44 10 12 44 13 15 44 10 12 44 13 15 44 10 12 -12 0 7 -4 8 114 -50 14 2923 2924 1834 -6 11 19 -2 11 12 -4 0 10 -9 11 1835 2919 2920 -3 14 2923 2924 1834 -12 11 19 -2 11 12 -55 0 10 -9 11 20 113 9 -6 0 202 -4 0 202 -4 0 202 -4 0 202 -4 0 202 -6 0 10 12 0 16 18 0 10 12 0 16 18 0 10 12 0 16 18 0 10 12 0 16 18 0 10 12 0 16 18 -4 0 7 -7 8 114 -4 14 23 -6 11 19 -12 11 19 -8 11 115 116 -32 11 12 -4 0 10 11 19 -31 11 12 -55 0 10 -4 11 115 116 -4 11 20 113 -6 8 204 -4 8 204 -4 8 204 -4 8 204 -4 8 204 -6 8 22 21 -4 8 22 21 -4 8 22 21 -4 8 22 21 -4 8 22 21 -7 8 114 -7 14 23 -30 11 19 -2 11 117 118 -2 11 19 -29 11 12 -4 0 10 -25 11 19 -7 11 12 -55 0 10 -4 11 117 118 -5 11 20 -6 14 214 -4 14 214 -4 14 214 -4 14 214 -4 14 214 -6 14 23 20 -4 14 23 20 -4 14 23 20 -4 14 23 20 -4 14 23 20 -7 14 23 -9 11 19 -15 11 115 116 -37 11 19 -10 11 12 -4 0 10 -33 11 12 -55 0 10 -20 11 19 -31 11 19 -51 11 117 118 -48 11 12 -4 0 10 -12 11 19 -20 11 12 -55 0 10 -9 11 19 -69 11 19 -53 11 19 -20 11 12 -4 0 10 -33 11 12 -55 0 10 -37 11 19 -28 11 19 -53 11)
    )
    (tilemap
      (solid #t)
      (z-pos 1)
      (width 250)
      (height 35)
      (tiles -4859 0 -20 3038 -2770 0 -4 44 0 -4 44 0 -4 44 0 -4 44 -1082 0)
    )
    (unstable_tile
      (z-pos 0)
      (x 2368)
      (y 864)
    )
    (unstable_tile
      (z-pos 0)
      (x 2400)
      (y 864)
    )
    (unstable_tile
      (z-pos 0)
      (x 2432)
      (y 864)
    )
    (unstable_tile
      (z-pos 0)
      (x 2464)
      (y 864)
    )
    (unstable_tile
      (z-pos 0)
      (x 2496)
      (y 864)
    )
    (unstable_tile
      (z-pos 0)
      (x 2528)
      (y 864)
    )
    (unstable_tile
      (z-pos 0)
      (x 2560)
      (y 864)
    )
    (unstable_tile
      (z-pos 0)
      (x 2592)
      (y 864)
    )
    (unstable_tile
      (z-pos 0)
      (x 2624)
      (y 864)
    )
    (unstable_tile
      (z-pos 0)
      (x 2656)
      (y 864)
    )
    (unstable_tile
      (z-pos 0)
      (x 2688)
      (y 864)
    )
    (unstable_tile
      (z-pos 0)
      (x 2720)
      (y 864)
    )
    (unstable_tile
      (z-pos 0)
      (x 2752)
      (y 864)
    )
    (unstable_tile
      (z-pos 0)
      (x 2784)
      (y 864)
    )
    (unstable_tile
      (z-pos 0)
      (x 2816)
      (y 864)
    )
    (unstable_tile
      (z-pos 0)
      (x 2848)
      (y 864)
    )
    (unstable_tile
      (z-pos 0)
      (x 2880)
      (y 864)
    )
    (unstable_tile
      (z-pos 0)
      (x 2912)
      (y 864)
    )
    (unstable_tile
      (z-pos 0)
      (x 2944)
      (y 864)
    )
    (unstable_tile
      (z-pos 0)
      (x 2976)
      (y 864)
    )
    (unstable_tile
      (z-pos 0)
      (x 3008)
      (y 864)
    )
    (unstable_tile
      (z-pos 0)
      (x 3040)
      (y 864)
    )
    (unstable_tile
      (z-pos 0)
      (x 3072)
      (y 864)
    )
    (unstable_tile
      (z-pos 0)
      (x 3104)
      (y 864)
    )
    (unstable_tile
      (z-pos 0)
      (x 3136)
      (y 864)
    )
    (unstable_tile
      (z-pos 0)
      (x 3168)
      (y 864)
    )
    (unstable_tile
      (z-pos 0)
      (x 3200)
      (y 864)
    )
    (unstable_tile
      (z-pos 0)
      (x 3232)
      (y 864)
    )
    (unstable_tile
      (z-pos 0)
      (x 3264)
      (y 864)
    )
    (unstable_tile
      (z-pos 0)
      (x 3296)
      (y 864)
    )
    (unstable_tile
      (z-pos 0)
      (x 3328)
      (y 864)
    )
    (unstable_tile
      (z-pos 0)
      (x 3360)
      (y 864)
    )
    (unstable_tile
      (z-pos 0)
      (x 3392)
      (y 864)
    )
    (unstable_tile
      (z-pos 0)
      (x 3424)
      (y 864)
    )
    (unstable_tile
      (z-pos 0)
      (x 3456)
      (y 864)
    )
  )
)
