(supertux-level
  (version 3)
  (name (_ "Snowball Path"))
  (author "Sophie \"Vaesea\" Ball")
  (license "CC-BY-SA 4.0 International")
  (target-time 65)
  (allow-item-pocket "inherit")
  (icon "")
  (icon-locked "")
  (statistics
    (enable-coins #t)
    (enable-secrets #t)
  )
  (sector
    (name "main")
    (ambient-light
      (color 1 1 1)
    )
    (background
      (color 1 1 1)
      (alignment "bottom")
      (speed 0.5)
      (speed-y 0)
      (image "/images/background/snow_background2.png")
    )
    (bouncingsnowball
      (z-pos 50)
      (direction "left")
      (x 3072)
      (y 1152)
      (glinting #f)
    )
    (camera
      (name "Camera")
      (mode "normal")
    )
    (captainsnowball
      (z-pos 50)
      (direction "left")
      (x 8000)
      (y 1184)
      (glinting #f)
    )
    (decal
      (z-pos -100)
      (sprite "/images/decal/snow/exitbg.png")
      (x 15680)
      (y 1184)
    )
    (decal
      (z-pos 100)
      (sprite "/images/decal/snow/exitfg.png")
      (x 15776)
      (y 1184)
    )
    (firefly
      (z-pos 0)
      (x 9408)
      (y 1024)
    )
    (jumpy
      (z-pos 50)
      (x 2368)
      (y 1184)
      (glinting #f)
    )
    (jumpy
      (z-pos 50)
      (x 7296)
      (y 800)
      (glinting #f)
    )
    (jumpy
      (z-pos 50)
      (x 10336)
      (y 1024)
      (glinting #f)
    )
    (jumpy
      (z-pos 50)
      (x 11136)
      (y 1152)
      (glinting #f)
    )
    (jumpy
      (z-pos 50)
      (x 11808)
      (y 1152)
      (glinting #f)
    )
    (jumpy
      (z-pos 50)
      (x 9696)
      (y 1024)
      (glinting #f)
    )
    (mrbomb
      (z-pos 50)
      (direction "left")
      (x 11584)
      (y 1184)
      (glinting #f)
    )
    (mrbomb
      (z-pos 50)
      (direction "left")
      (x 12864)
      (y 1056)
      (glinting #f)
    )
    (mriceblock
      (z-pos 50)
      (direction "left")
      (x 1696)
      (y 1216)
      (glinting #f)
    )
    (mriceblock
      (z-pos 50)
      (direction "left")
      (x 4096)
      (y 992)
      (glinting #f)
    )
    (mriceblock
      (z-pos 50)
      (direction "left")
      (x 6144)
      (y 1248)
      (glinting #f)
    )
    (music
      (file "/music/antarctic/chipdisko.music")
    )
    (path
      (name "gen17666161202153472203248")
      (path
        (mode "pingpong")
        (adapt_speed #f)
        (node
          (x 8352)
          (y 1216)
          (time 8)
        )
        (node
          (x 9216)
          (y 1088)
          (time 8)
        )
      )
    )
    (platform
      (z-pos 50)
      (handle
        (scale_x 0)
        (scale_y 0)
        (offset_x 0)
        (offset_y 0)
      )
      (running #f)
      (path-ref "gen17666161202153472203248")
      (sprite "/images/objects/platforms/icefloe_small.sprite")
    )
    (secretarea
      (fade-tilemap "secret1")
      (width 320)
      (height 192)
      (x 5056)
      (y 1184)
    )
    (sequencetrigger
      (sequence "endsequence")
      (width 32)
      (height 1376)
      (x 15456)
      (y 0)
    )
    (sequencetrigger
      (sequence "stoptux")
      (width 32)
      (height 672)
      (x 15968)
      (y 768)
    )
    (smartball
      (z-pos 50)
      (direction "left")
      (x 864)
      (y 1120)
      (glinting #f)
    )
    (smartball
      (z-pos 50)
      (direction "left")
      (x 11520)
      (y 928)
      (glinting #f)
    )
    (smartblock
      (z-pos 50)
      (direction "left")
      (x 12800)
      (y 928)
      (glinting #f)
    )
    (snowball
      (z-pos 50)
      (direction "left")
      (x 1280)
      (y 1248)
      (glinting #f)
    )
    (snowball
      (z-pos 50)
      (direction "left")
      (x 4224)
      (y 992)
      (glinting #f)
    )
    (snowball
      (z-pos 50)
      (direction "left")
      (x 3968)
      (y 992)
      (glinting #f)
    )
    (snowball
      (z-pos 50)
      (direction "left")
      (x 5344)
      (y 1120)
      (glinting #f)
    )
    (snowball
      (z-pos 50)
      (direction "left")
      (x 5152)
      (y 1120)
      (glinting #f)
    )
    (snowball
      (z-pos 50)
      (direction "left")
      (x 8288)
      (y 1184)
      (glinting #f)
    )
    (snowball
      (z-pos 50)
      (direction "left")
      (x 7936)
      (y 832)
      (glinting #f)
    )
    (snowball
      (z-pos 50)
      (direction "left")
      (x 13760)
      (y 960)
      (glinting #f)
    )
    (snowball
      (z-pos 50)
      (direction "left")
      (x 10272)
      (y 1088)
      (glinting #f)
    )
    (snowball
      (z-pos 50)
      (direction "left")
      (x 10208)
      (y 960)
      (glinting #f)
    )
    (snowball
      (z-pos 50)
      (direction "left")
      (x 10144)
      (y 832)
      (glinting #f)
    )
    (snowball
      (z-pos 50)
      (direction "left")
      (x 14368)
      (y 1216)
      (glinting #f)
    )
    (spawnpoint
      (name "main")
      (x 64)
      (y 1216)
    )
    (spiky
      (z-pos 50)
      (direction "left")
      (x 12480)
      (y 1056)
      (glinting #f)
    )
    (stalactite
      (glinting #f)
      (z-pos -1)
      (x 7552)
      (y 960)
    )
    (stalactite
      (glinting #f)
      (z-pos -1)
      (x 7424)
      (y 928)
    )
    (stalactite
      (glinting #f)
      (z-pos -1)
      (x 7616)
      (y 960)
    )
    (tilemap
      (solid #f)
      (z-pos -100)
      (width 500)
      (height 45)
      (tiles -5270 0 122 123 -489 0 122 123 -7 0 124 125 -489 0 124 125 -7 0 124 125 122 123 -485 0 122 123 124 125 -7 0 124 125 124 125 -485 0 124 125 124 125 -7 0 124 125 124 125 -485 0 124 125 124 125 -7 0 124 125 124 125 -485 0 124 125 124 125 0 25 0 24 25 -2 0 124 125 124 125 -2970 0 122 123 -490 0 122 123 -6 0 124 125 -490 0 124 125 -2 0 25 -3 0 124 125 -210 0 25 -273 0 106 107 108 -3 0 124 125 -6 0 124 125 -484 0 109 110 111 -80 0 25 0 -2 8 -801 0 122 123 -281 0 122 123 -215 0 124 125 -281 0 124 125 -209 0 122 123 -4 0 124 125 -7 0 106 107 108 -173 0 122 123 -7 0 24 0 -4 8 25 -82 0 124 125 -209 0 124 125 -4 0 124 125 -5 0 24 0 109 110 111 25 -76 0 122 123 -94 0 124 125 -20 0 122 123 -65 0 122 123 -7 0 124 125 -209 0 124 125 -4 0 124 125 -87 0 124 125 -7 0 106 107 108 -6 0 122 123 -65 0 106 107 108 -8 0 124 125 -20 0 124 125 -65 0 124 125 -7 0 124 125 -204 0 106 107 108 -2 0 124 125 -4 0 124 125 -46 0 122 123 -39 0 124 125 -7 0 109 110 111 0 25 -4 0 124 125 -65 0 109 110 111 -4 0 25 0 24 0 124 125 -4 0 106 107 108 -13 0 124 125 -65 0 124 125 0 25 -3 0 24 0 124 125 -36 0 122 123 -119 0 122 123 -23 0 122 123 -20 0 109 110 111 0 24 124 125 25 -25 0 122 123 -16 0 106 107 108 -5 0 124 125 -39 0 124 125 -2 0 24 -13 0 124 125 -82 0 109 110 111 -2 8 25 -5 8 -4 0 24 124 125 0 25 -110 0 124 125 -7 0 122 123 -32 0 130 -52 0 122 123 -23 0 124 125 -19 0 122 123 -2 0 124 125 -46 0 28 -6 0 124 125 -16 0 109 110 111 0 24 0 25 0 124 125 -7 0 25 -31 0 124 125 -20 0 24 -3 0 25 -2 0 106 107 108 -200 0 124 125 -7 0 124 125 -32 0 129 -21 0 122 123 -29 0 124 125 -4 0 122 123 -17 0 124 125 -19 0 124 125 -2 0 124 125 -4 0 24 0 25 -46 0 124 125 -42 0 122 123 -18 0 25 -31 0 109 110 111 -16 0 106 107 108 -82 0 106 107 108 -34 0 106 107 108 -59 0 124 125 -7 0 124 125 -32 0 129 -21 0 124 125 -29 0 124 125 -4 0 124 125 -17 0 124 125 -19 0 124 125 -2 0 124 125 -47 0 106 107 108 -3 0 124 125 -42 0 124 125 -56 0 24 -3 0 25 -6 0 24 0 109 110 111 -82 0 109 110 111 24 0 25 -27 0 24 25 -2 0 109 110 111 0 24 -29 0 106 107 108 -25 0 124 125 106 107 108 -4 0 124 125 -23 0 106 107 108 -6 0 129 -17 0 106 107 108 0 124 125 -29 0 124 125 0 106 107 108 124 125 -3 0 24 -4 0 25 -8 0 124 125 -8 0 106 107 108 -8 0 124 125 -51 0 109 110 111 -3 0 124 125 -2 0 25 0 24 -27 0 28 -9 0 124 125 0 106 107 108 -219 0 25 0 109 110 111 -8 0 25 -5 0 24 -6 0 25 -3 0 124 125 109 110 111 0 24 -2 0 124 125 -2 0 25 0 24 -18 0 109 110 111 -6 0 129 -17 0 109 110 111 0 124 125 -3 0 25 -4 0 24 -4 0 25 -7 0 24 -5 0 25 0 124 125 0 109 110 111 124 125 -15 0 24 0 124 125 -7 0 24 109 110 111 -3 0 25 -83 0 17 -23 0 124 125 0 109 110 111 24 -291 0 129 -499 0 129 -499 0 129 -3 0 106 107 108 -493 0 129 -2 0 24 109 110 111 -1011 0)
    )
    (tilemap
      (solid #f)
      (z-pos 100)
      (width 500)
      (height 45)
      (tiles -17484 0 130 -499 0 129 -499 0 129 -499 0 129 -499 0 129 -499 0 129 -499 0 129 -499 0 129 -499 0 129 -1015 0)
    )
    (tilemap
      (solid #t)
      (z-pos 0)
      (width 500)
      (height 45)
      (tiles -6288 0 -2 44 -473 0 27 29 83 128 83 27 29 -17 0 44 -2 0 44 -495 0 44 -4 0 44 -500 0 44 -466 0 7 -13 8 9 -18 0 44 -466 0 13 -13 14 15 -19 0 44 -465 0 16 2925 2926 11 19 -5 11 19 11 2929 2930 18 -4 0 27 -6 28 29 -7 0 44 -467 0 2928 17 2937 2940 -3 17 2933 2935 17 2931 -21 0 44 -469 0 2938 2941 -3 0 2934 2936 -24 0 44 -445 0 83 2947 -21 0 2939 2942 -29 0 44 -424 0 83 102 -73 0 44 -499 0 44 -444 0 2909 2910 2913 2914 -213 0 7 2913 2914 -276 0 2909 2910 2921 2922 2911 2912 2915 2916 2917 2918 2913 2914 -209 0 13 2915 2916 3139 3140 -257 0 83 -2 0 83 -5 0 7 -5 8 2921 2922 2911 2912 2923 2924 1834 -2 11 1835 2919 2920 2915 2916 2917 2918 9 -63 0 7 8 -2 44 8 9 -38 0 47 102 83 47 -95 0 10 11 1835 3143 3144 1838 -265 0 13 -5 14 2923 2924 1834 -4 11 19 -5 11 1835 2919 2920 15 -63 0 13 -4 14 15 -137 0 10 -3 11 3147 1840 1838 -264 0 16 2925 2926 -15 11 19 -3 11 12 -63 0 16 -4 17 18 -137 0 10 -4 11 1842 1840 1838 -265 0 2928 -4 17 2925 2926 -13 11 12 -106 0 44 0 -2 44 0 44 -94 0 10 -5 11 1842 1840 1838 -245 0 -2 44 -5 0 27 29 -2 83 27 29 -12 0 2928 -5 17 2925 2926 -4 11 2929 2930 18 -61 0 7 -2 8 -4 44 -2 8 9 -35 0 27 -4 28 29 -31 0 27 29 -2 83 2947 -2 83 27 29 -54 0 10 -6 11 1842 1840 1838 -157 0 7 -9 8 9 -73 0 -3 44 -2 0 44 -29 0 2928 -4 17 2931 -63 0 13 -8 14 15 -135 0 10 -7 11 1842 1840 1838 -57 0 83 105 83 -93 0 7 -2 8 114 -9 14 15 -71 0 -2 44 -104 0 16 -8 17 18 -135 0 10 -8 11 1842 1840 1838 -149 0 7 -2 8 114 -2 14 23 -9 11 12 -70 0 44 -9 0 2909 2910 -7 8 2913 2914 -67 0 7 -13 8 2913 2914 -15 0 202 -27 0 -5 44 -6 0 -5 44 -23 0 2909 2910 -11 8 9 -52 0 10 -9 11 1842 1840 1838 -77 0 44 -5 0 44 -53 0 7 -10 8 114 -2 14 23 -12 11 12 -76 0 2909 2910 2921 2922 2911 2912 -7 14 2915 2916 2917 2918 9 -64 0 13 -13 14 2915 2916 2917 2918 -2 8 -8 44 -3 8 204 -5 8 2913 2914 -20 0 27 -3 28 29 -6 0 27 -3 28 29 -21 0 1826 1829 2911 2912 -11 14 113 9 -51 0 10 -10 11 1842 1840 1838 -75 0 44 0 44 -3 0 44 0 44 -46 0 202 -5 0 13 -10 14 23 -15 11 12 -3 28 29 -18 0 2909 2910 -10 8 9 -5 0 7 8 2913 2914 -28 0 2909 2910 2921 2922 2911 2912 2923 2924 1834 -9 11 1835 2919 2920 113 -6 8 9 -57 0 10 -14 11 1835 2919 2920 -13 14 214 -5 14 2915 2916 2917 2918 2913 2914 -51 0 1826 1829 1830 1833 1834 -12 11 20 113 9 -49 0 2944 10 -5 11 19 -5 11 1842 1840 1838 -48 0 -2 83 -2 0 27 -3 28 29 -2 0 102 83 -56 0 2909 2910 -10 8 3051 -5 0 10 -19 11 19 -6 11 12 -18 0 2909 2910 2921 2922 2911 2912 -10 14 15 -5 0 13 14 2915 2916 3139 3140 -7 0 -3 83 -12 0 2909 2910 2921 2922 2911 2912 2923 2924 1834 -16 11 20 -6 14 113 -6 8 9 -50 0 10 -37 11 1835 2919 2920 2915 2916 2917 2918 2913 2914 -45 0 1826 1829 1830 1833 1834 -15 11 20 113 9 -49 0 10 -12 11 1842 1840 3149 -112 0 2909 2910 2921 2922 2911 2912 -10 14 3048 -5 0 10 -26 11 12 -14 0 2909 2910 2921 2922 2911 2912 2923 2924 1834 -8 11 30 -2 17 18 -5 0 10 -2 11 1835 3143 3144 3149 -18 0 7 2921 2922 2911 2912 2923 2924 1834 -7 11 19 -19 11 20 -6 14 113 -18 8 9 -31 0 10 -2 11 19 -38 11 1835 2919 2920 2915 2916 2917 2918 -5 8 9 -24 0 7 -10 8 2921 2922 1830 1833 1834 -3 11 19 -14 11 20 113 9 -48 0 10 -13 11 1842 3151 3152 -70 0 2909 2910 -9 8 2913 2914 -18 0 202 -5 0 2909 2910 2921 2922 2911 2912 2923 2924 1834 -11 11 12 -5 0 10 -26 11 21 -12 8 2921 2922 2911 2912 2923 2924 1834 -8 11 30 -3 17 18 -7 0 27 10 -4 11 3147 3151 3152 -17 0 13 2923 2924 1834 -38 11 20 -18 14 15 -31 0 10 -28 11 19 -16 11 1835 2919 2920 -5 14 15 27 -22 28 29 13 -10 14 2923 2924 1834 -21 11 20 113 -43 8 48 -4 8 22 -14 11 3155 3156 2917 2918 2913 2914 -23 0 -41 8 2921 2922 2911 2912 -9 14 2915 2916 2917 2918 -4 8 9 -5 0 7 -5 8 204 -3 8 2921 2922 2911 2912 2923 2924 1834 -15 11 12 -5 0 10 -26 11 20 -12 14 2923 2924 1834 -10 11 30 128 18 -12 0 10 11 19 -3 11 3155 3156 2917 2918 -9 8 9 -5 0 10 -28 11 19 -31 11 12 -31 0 10 -53 11 12 27 -22 28 29 10 -35 11 20 -48 14 23 -15 11 1835 2919 2920 2915 2916 3139 3140 -21 0 -41 14 2923 2924 1834 -11 11 1835 2919 2920 -4 14 15 -5 0 13 -5 14 214 -3 14 2923 2924 1834 -13 11 19 -5 11 12 -5 0 10 -6 11 19 -3 11 115 116 -38 11 30 17 18 -14 0 10 -6 11 1835 2919 2920 -9 14 15 -5 0 10 -36 11 115 116 -16 11 19 -5 11 12 -31 0 10 -53 11 12 -3 211 27 29 -14 0 27 29 -3 211 10 -104 11 1835 3143 3144 3149 -20 0 11 19 -23 11 19 -36 11 12 -5 0 10 -31 11 12 -5 0 10 -10 11 117 118 -27 11 19 -10 11 12 -9 0 7 9 -5 0 10 -18 11 12 -5 0 10 -36 11 117 118 -22 11 12 -31 0 10 -17 11 19 -30 11 19 -4 11 12 -3 212 47 -16 0 47 -3 212 10 -4 11 19 -5 11 115 116 -38 11 19 -29 11 19 -25 11 3147 3151 3152 -19 0 -4 11 115 116 -34 11 19 -21 11 12 -5 0 10 -10 11 19 -20 11 12 -5 0 10 -25 11 19 -20 11 19 -3 11 21 -9 8 114 15 -5 0 10 -14 11 19 -3 11 12 -5 0 10 -2 11 19 -38 11 19 -18 11 12 -31 0 10 -53 11 12 -2 212 213 -18 0 213 -2 212 10 -10 11 117 118 -18 11 19 -66 11 19 -9 11 3155 3156 2917 2918 -17 8 -4 11 117 118 -46 11 19 -9 11 12 -5 0 10 11 19 -29 11 12 -5 0 10 -50 11 20 -9 14 23 12 -5 0 10 -18 11 12 -5 0 10 -60 11 12 -31 0 10 -38 11 19 -14 11 12 -2 212 -20 0 -2 212 10 -64 11 19 -43 11 1835 2919 2920 -17 14 -13 11 19 -48 11 12 -5 0 10 -31 11 12 -5 0 10 -61 11 12 -5 0 10 -18 11 12 -5 0 10 -60 11 12 -31 0 10 -53 11 12 -2 212 -20 0 -2 212 10 -117 11 19 -6 11 115 116 -2 11)
    )
    (tilemap
      (solid #f)
      (z-pos 101)
      (name "secret1")
      (width 500)
      (height 45)
      (tiles -18665 0 -3 2127 3250 -492 0 -7 2127 2128 -490 0 -2 2127 19 -6 2127 2128 -488 0 -11 2127 2128 -488 0 -8 2127 19 -2 2127 3254 -488 0 -11 2127 12 -488 0 -11 2127 -832 0)
    )
    (tilemap
      (solid #t)
      (z-pos -1)
      (width 500)
      (height 45)
      (tiles -15923 0 27 -7 28 29 -491 0 27 -7 28 29 -491 0 -2 211 47 -3 0 47 -2 211 -491 0 -2 213 -5 0 -2 213 -484 0 27 -7 28 29 -5 0 27 -7 28 29 -477 0 27 -7 28 29 -5 0 27 -7 28 29 -477 0 -2 211 47 -17 0 47 -2 211 -477 0 -2 212 -19 0 -2 213 -3061 0)
    )
    (trampoline
      (type "stationary")
      (z-pos 50)
      (x 7968)
      (y 832)
    )
  )
)
