(supertux-level
  (version 3)
  (name (_ "Trampolines And Hills"))
  (author "Sophie \"Vaesea\" Ball")
  (license "CC-BY-SA 4.0 International")
  (target-time 85)
  (allow-item-pocket "inherit")
  (icon "")
  (icon-locked "")
  (statistics
    (enable-coins #t)
    (enable-secrets #t)
  )
  (sector
    (name "main")
    (ambient-light
      (color 1 1 1)
    )
    (background
      (scroll-offset-x 704)
      (scroll-offset-y 480)
      (color 1 1 1)
      (speed 0.25)
      (image-top "/images/background/arctis_top.jpg")
      (image "/images/background/arctis_top.jpg")
      (image-bottom "/images/background/arctis_top.jpg")
    )
    (bonusblock
      (z-pos 51)
      (count 5)
      (sprite "/images/objects/bonus_block/purpleblock.sprite")
      (x 5632)
      (y 864)
    )
    (bonusblock
      (z-pos 51)
      (count 5)
      (sprite "/images/objects/bonus_block/purpleblock.sprite")
      (x 5696)
      (y 864)
    )
    (camera
      (name "Camera")
      (mode "normal")
    )
    (captainsnowball
      (z-pos 50)
      (direction "left")
      (x 3552)
      (y 640)
      (glinting #f)
    )
    (captainsnowball
      (z-pos 50)
      (direction "left")
      (x 3456)
      (y 640)
      (glinting #f)
    )
    (coin
      (z-pos 49)
      (handle
        (scale_x 0)
        (scale_y 0)
        (offset_x 0)
        (offset_y 0)
      )
      (path-ref "gen17667644382928786397264")
    )
    (decal
      (z-pos -100)
      (sprite "/images/decal/snow/exitbg.png")
      (x 18080)
      (y 448)
    )
    (decal
      (z-pos 100)
      (sprite "/images/decal/snow/exitfg.png")
      (x 18176)
      (y 448)
    )
    (dispenser
      (z-pos 55)
      (cycle 5)
      (type "cannon")
      (objects
        (kamikazesnowball
          (z-pos 50)
          (glinting #f)
        )
      )
      (x 7968)
      (y 612)
    )
    (firefly
      (z-pos 0)
      (x 7328)
      (y 832)
    )
    (flyingsnowball
      (z-pos 50)
      (x 2432)
      (y 544)
      (glinting #f)
    )
    (flyingsnowball
      (z-pos 50)
      (x 1824)
      (y 544)
      (glinting #f)
    )
    (flyingsnowball
      (z-pos 50)
      (x 13120)
      (y 448)
      (glinting #f)
    )
    (flyingsnowball
      (z-pos 50)
      (x 13392)
      (y 448)
      (glinting #f)
    )
    (flyingsnowball
      (z-pos 50)
      (x 13744)
      (y 448)
      (glinting #f)
    )
    (flyingsnowball
      (z-pos 50)
      (x 14016)
      (y 448)
      (glinting #f)
    )
    (haywire
      (z-pos 50)
      (direction "left")
      (x 7968)
      (y 768)
      (glinting #f)
    )
    (infoblock
      (z-pos 51)
      (message (_ "Bring the purple trampoline here."))
      (x 6944)
      (y 768)
    )
    (jumpy
      (z-pos 50)
      (x 6176)
      (y 352)
      (glinting #f)
    )
    (jumpy
      (z-pos 50)
      (x 8448)
      (y 800)
      (glinting #f)
    )
    (jumpy
      (z-pos 50)
      (x 9312)
      (y 832)
      (glinting #f)
    )
    (jumpy
      (z-pos 50)
      (x 9504)
      (y 832)
      (glinting #f)
    )
    (jumpy
      (z-pos 50)
      (x 9696)
      (y 832)
      (glinting #f)
    )
    (jumpy
      (z-pos 50)
      (x 10144)
      (y 832)
      (glinting #f)
    )
    (jumpy
      (z-pos 50)
      (x 12128)
      (y 896)
      (glinting #f)
    )
    (jumpy
      (z-pos 50)
      (x 12992)
      (y 512)
      (glinting #f)
    )
    (jumpy
      (z-pos 50)
      (x 12416)
      (y 384)
      (glinting #f)
    )
    (jumpy
      (z-pos 50)
      (x 16704)
      (y 736)
      (glinting #f)
    )
    (jumpy
      (z-pos 50)
      (x 17024)
      (y 704)
      (glinting #f)
    )
    (mrbomb
      (z-pos 50)
      (direction "left")
      (x 2176)
      (y 768)
      (glinting #f)
    )
    (mriceblock
      (z-pos 50)
      (direction "left")
      (x 12064)
      (y 928)
      (glinting #f)
    )
    (mriceblock
      (z-pos 50)
      (direction "left")
      (x 12000)
      (y 928)
      (glinting #f)
    )
    (music
      (file "/music/antarctic/voc-daytime2.music")
    )
    (particles-snow
      (z-pos -145)
    )
    (path
      (name "gen17667644382928786397264")
      (path
        (adapt_speed #f)
        (node
          (x 7008)
          (y 768)
        )
        (node
          (x 6944)
          (y 704)
        )
        (node
          (x 6880)
          (y 768)
        )
        (node
          (x 6944)
          (y 832)
        )
      )
    )
    (secretarea
      (fade-tilemap "secret1")
      (width 352)
      (height 192)
      (x 5504)
      (y 800)
    )
    (secretarea
      (fade-tilemap "secret2")
      (width 32)
      (height 160)
      (x 14976)
      (y 768)
    )
    (sequencetrigger
      (sequence "endsequence")
      (width 32)
      (height 640)
      (x 17792)
      (y 0)
    )
    (sequencetrigger
      (sequence "stoptux")
      (width 32)
      (height 736)
      (x 18368)
      (y 0)
    )
    (smartball
      (z-pos 50)
      (direction "left")
      (x 2528)
      (y 768)
      (glinting #f)
    )
    (smartball
      (z-pos 50)
      (direction "left")
      (x 1824)
      (y 768)
      (glinting #f)
    )
    (smartball
      (z-pos 50)
      (direction "left")
      (x 12320)
      (y 448)
      (glinting #f)
    )
    (snowball
      (z-pos 50)
      (direction "left")
      (x 5024)
      (y 480)
      (glinting #f)
    )
    (snowball
      (z-pos 50)
      (direction "left")
      (x 3936)
      (y 768)
      (glinting #f)
    )
    (snowball
      (z-pos 50)
      (direction "left")
      (x 6016)
      (y 384)
      (glinting #f)
    )
    (snowball
      (z-pos 50)
      (direction "left")
      (x 864)
      (y 768)
      (glinting #f)
    )
    (snowball
      (z-pos 50)
      (direction "left")
      (x 1792)
      (y 896)
      (glinting #f)
    )
    (snowball
      (z-pos 50)
      (direction "left")
      (x 2112)
      (y 896)
      (glinting #f)
    )
    (snowball
      (z-pos 50)
      (direction "left")
      (x 2432)
      (y 896)
      (glinting #f)
    )
    (snowball
      (z-pos 50)
      (direction "left")
      (x 8960)
      (y 896)
      (glinting #f)
    )
    (snowball
      (z-pos 50)
      (direction "left")
      (x 8864)
      (y 896)
      (glinting #f)
    )
    (snowball
      (z-pos 50)
      (direction "left")
      (x 8768)
      (y 896)
      (glinting #f)
    )
    (snowball
      (z-pos 50)
      (direction "left")
      (x 10080)
      (y 864)
      (glinting #f)
    )
    (spawnpoint
      (name "main")
      (x 64)
      (y 736)
    )
    (spiky
      (z-pos 50)
      (direction "left")
      (x 5024)
      (y 832)
      (glinting #f)
    )
    (spiky
      (z-pos 50)
      (direction "left")
      (x 4800)
      (y 800)
      (glinting #f)
    )
    (stalactite
      (glinting #f)
      (z-pos -1)
      (x 4608)
      (y 640)
    )
    (stalactite
      (glinting #f)
      (z-pos -1)
      (x 4768)
      (y 640)
    )
    (stalactite
      (glinting #f)
      (z-pos -1)
      (x 4800)
      (y 640)
    )
    (stalactite
      (glinting #f)
      (z-pos -1)
      (x 4992)
      (y 576)
    )
    (stalactite
      (glinting #f)
      (z-pos -1)
      (x 4960)
      (y 576)
    )
    (stalactite
      (glinting #f)
      (z-pos -1)
      (x 5024)
      (y 576)
    )
    (switch
      (z-pos 1)
      (script "wind.start();")
      (off-script "wind.stop();")
      (x 12364)
      (y 828)
    )
    (tilemap
      (solid #f)
      (z-pos -100)
      (width 575)
      (height 35)
      (tiles -2609 0 122 123 -573 0 124 125 0 122 123 -567 0 122 123 0 124 125 0 124 125 -6 0 24 -446 0 122 123 -112 0 124 125 0 124 125 0 124 125 -443 0 122 123 -8 0 124 125 -112 0 124 125 0 124 125 0 124 125 -427 0 122 123 -14 0 124 125 -8 0 124 125 -112 0 124 125 0 124 125 0 124 125 -427 0 124 125 -14 0 124 125 -8 0 124 125 -184 0 122 123 -351 0 122 123 -8 0 124 125 -14 0 124 125 -3 0 106 107 108 -2 0 124 125 -184 0 124 125 -4 0 122 123 -169 0 130 -171 0 122 123 -2 0 124 125 -8 0 124 125 -14 0 124 125 25 -2 0 109 110 111 0 24 124 125 -184 0 124 125 -4 0 124 125 -169 0 129 -171 0 124 125 -2 0 124 125 -8 0 124 125 -210 0 124 125 -4 0 124 125 -3 0 25 0 24 -163 0 129 -168 0 106 107 108 124 125 -2 0 124 125 -7 0 24 124 125 0 25 -2 0 24 -205 0 124 125 -4 0 124 125 -56 0 122 123 -108 0 122 123 0 129 -85 0 106 107 108 -80 0 109 110 111 124 125 0 24 124 125 -284 0 124 125 -108 0 124 125 0 129 -83 0 25 0 109 110 111 -36 0 122 123 -146 0 122 123 -146 0 106 107 108 -38 0 124 125 -108 0 124 125 0 129 -124 0 124 125 -3 0 122 123 -141 0 124 125 -146 0 109 110 111 25 0 24 -34 0 24 124 125 -108 0 124 125 0 129 -124 0 124 125 -3 0 124 125 -141 0 124 125 -297 0 124 125 0 129 -5 0 106 107 108 -82 0 106 107 108 -31 0 124 125 106 107 108 124 125 -141 0 124 125 -195 0 122 123 -96 0 25 -2 0 24 124 125 0 129 -3 0 25 0 109 110 111 -27 0 122 123 -43 0 25 -8 0 24 109 110 111 -29 0 25 24 124 125 109 110 111 124 125 -139 0 24 0 124 125 -195 0 124 125 -4 0 106 107 108 -124 0 122 123 -6 0 124 125 -17 0 122 123 -103 0 122 123 -11 0 122 123 -66 0 122 123 -116 0 24 -110 0 124 125 24 25 -2 0 109 110 111 -8 0 24 -115 0 124 125 -2 0 122 123 -2 0 124 125 -17 0 124 125 -103 0 124 125 -11 0 124 125 -66 0 124 125 -25 0 2193 2184 2180 2181 2180 2189 2182 2194 -277 0 106 107 108 -39 0 107 108 -6 0 124 125 -2 0 124 125 -2 0 124 125 -8 0 106 107 108 -6 0 124 125 -12 0 122 123 -3 0 106 107 108 -83 0 124 125 -11 0 124 125 -63 0 122 123 0 124 125 -26 0 2192 2188 2189 2188 2181 2190 -105 0 122 123 -171 0 109 110 111 -2 0 24 -36 0 110 111 25 -3 0 24 0 124 125 25 0 124 125 -2 0 124 125 -2 0 25 0 24 -3 0 109 110 111 0 25 -2 0 24 0 124 125 -12 0 124 125 -3 0 109 110 111 24 -8 0 25 -9 0 25 -18 0 24 -24 0 25 0 24 -15 0 25 0 124 125 24 -10 0 124 125 -63 0 124 125 0 124 125 -20 0 106 107 108 -2 0 2185 2200 2197 2187 2195 2196 2198 2186 24 -103 0 124 125 -105 0 2192 -3 2180 -54 0 24 -2 0 25 -95 0 124 125 -32 0 122 123 -65 0 25 -2 0 124 125 106 107 108 -13 0 2193 2184 2180 2181 2180 2189 2180 2181 2180 2189 2180 2181 2180 -34 0 124 125 0 124 125 -20 0 109 110 111 -21 0 122 123 -91 0 124 125 -105 0 2192 2196 2179 -2 2180 -3 0 24 -7 0 122 123 -139 0 124 125 -21 0 122 123 -9 0 124 125 -68 0 124 125 109 110 111 0 24 -12 0 2192 2188 2189 2188 2181 2188 2189 2188 2181 2188 2189 2188 -34 0 124 125 0 124 125 -17 0 24 -18 0 25 -2 0 24 -4 0 124 125 -12 0 106 107 108 -31 0 106 107 108 -42 0 124 125 -105 0 2192 2180 2189 -3 2180 -10 0 124 125 -139 0 124 125 -16 0 106 107 108 -2 0 124 125 -9 0 124 125 -87 0 2192 2197 2187 2195 2196 2197 2187 2195 2196 2197 2187 2195 -30 0 24 0 25 0 124 125 0 124 125 25 24 -8 0 24 25 -32 0 124 125 -12 0 109 110 111 -6 0 25 -5 0 24 -6 0 25 -11 0 109 110 111 24 -41 0 124 125 -105 0 2192 2188 2181 2188 2189 -4 2180 -7 0 124 125 -28 0 24 -104 0 25 -3 0 24 0 124 125 -11 0 24 -4 0 109 110 111 -2 0 124 125 -7 0 24 0 124 125 25 -86 0 2192 2187 2195 2196 2179 2187 2195 2196 2179 2187 2195 2196 -83 0 124 125 -2 0 25 -7 0 24 -75 0 106 107 108 -2 0 124 125 -105 0 2192 2195 2196 2197 2187 2195 2196 2197 -3 2180 -5 0 124 125 -8 0 106 107 108 -251 0 2192 2180 2181 2180 2189 2180 2181 2180 2189 2180 2181 2180 -171 0 109 110 111 -2 0 124 125 -2 0 25 24 -14 0 24 25 -86 0 2180 2179 2187 2195 2196 2179 2187 2195 2196 -2 2180 -4 0 124 125 -5 0 24 -2 0 109 110 111 25 -249 0 2185 2200 2188 2189 2188 2181 2188 2189 2188 2181 2188 2189 2188 -284 0 2180 2189 2180 2181 2180 2189 2180 2181 2180 2189 -2 2180 -563 0 -2 2180 2188 2189 2188 2181 2188 2189 2188 2181 2188 -2 2180 -563 0 -2 2180 2187 2195 2196 2197 2187 2195 2196 2197 2187 2180 -564 0 -2 2180 2196 2179 2187 2195 2196 2179 2187 2195 2180 -565 0 -10 2180 -94 0)
    )
    (tilemap
      (solid #f)
      (z-pos 100)
      (width 575)
      (height 35)
      (tiles -6882 0 130 -574 0 129 -574 0 129 -574 0 129 -574 0 129 -574 0 129 -574 0 129 -574 0 129 -574 0 129 -3854 0 -2 1719 2150 -574 0 79 -574 0 79 -574 0 79 -574 0 79 -574 0 79 -574 0 79 -574 0 79 -574 0 79 -185 0)
    )
    (tilemap
      (solid #t)
      (z-pos 0)
      (width 575)
      (height 35)
      (tiles -3770 0 7 2913 2914 -572 0 13 2915 2916 3139 3140 -570 0 10 11 1835 3143 3144 1838 -555 0 -2 44 0 -2 44 0 -2 44 -6 0 10 -3 11 3147 1840 1838 -568 0 10 11 19 -2 11 1842 1840 1838 -63 0 -3 83 -501 0 10 -5 11 1842 1840 1838 -426 0 2909 2910 -12 8 2913 2914 -124 0 10 -6 11 1842 1840 1838 -272 0 2947 -37 0 78 83 102 78 -107 0 2909 2910 2921 2922 2911 2912 -12 14 2915 2916 3139 3140 -28 0 44 -93 0 10 -7 11 1842 1840 1838 -56 0 7 -6 8 2913 2914 -342 0 7 -10 8 2921 2922 2911 2912 2923 2924 1834 -11 11 19 -2 11 1835 3143 3144 1838 -26 0 44 0 44 -92 0 10 -8 11 1842 1840 1838 -55 0 13 -6 14 2915 2916 3139 3140 -326 0 7 -8 8 9 -4 0 13 -10 14 2923 2924 1834 -4 11 19 -15 11 3147 1840 1838 -24 0 44 -3 0 44 -91 0 10 -9 11 1842 1840 1838 -54 0 10 -7 11 1835 3143 3144 3149 -202 0 7 8 9 -35 0 7 -4 8 9 -34 0 -2 44 -3 0 -2 44 -37 0 7 114 -8 14 15 -4 0 10 11 19 -32 11 1842 1840 1838 -23 0 44 -3 0 44 -91 0 10 -6 11 19 -3 11 1842 1840 1838 -53 0 10 -9 11 3147 3151 3152 -201 0 13 14 15 -35 0 13 -4 14 15 -33 0 44 -2 0 44 0 44 -2 0 44 -35 0 7 114 23 -8 11 12 -2 0 44 0 10 -7 11 19 -27 11 1842 1840 1838 -21 0 44 -2 0 202 -2 0 44 -21 0 83 102 -44 0 -2 44 -21 0 10 -11 11 1842 1840 1838 -52 0 10 -4 11 115 116 -4 11 3155 3156 2917 2918 -5 8 9 -5 0 202 -10 0 202 -10 0 202 -5 0 7 8 2913 2914 -156 0 16 17 18 -35 0 16 -4 17 18 -72 0 7 -4 8 114 23 -4 11 2929 2930 -3 17 18 -2 0 44 0 16 -2 17 2925 2926 -29 11 19 -2 11 1842 1840 1838 -20 0 44 -2 0 203 -2 0 44 -66 0 44 -23 0 10 -12 11 1842 1840 1838 -51 0 10 -4 11 117 118 -5 11 1835 2919 2920 -5 14 15 -5 0 203 -10 0 203 -10 0 203 -5 0 13 14 2915 2916 3139 3140 -6 0 -4 83 -260 0 13 -4 14 23 -3 11 2929 2930 2931 -7 0 44 -5 0 2928 2933 -32 11 1842 1840 1838 -19 0 44 -2 0 206 -2 0 44 -61 0 -2 44 -27 0 10 -13 11 1842 1840 3149 -50 0 10 -17 11 19 11 12 -5 0 206 -10 0 206 -10 0 206 -5 0 10 -2 11 1835 3143 3144 3149 -99 0 7 -27 8 -23 0 7 8 9 -3 0 7 8 9 -27 0 7 -3 8 9 -6 0 7 -3 8 9 -26 0 2909 2910 -9 8 2913 2914 -28 0 16 -8 17 2931 -9 0 44 -6 0 2934 2937 -9 11 19 -22 11 1842 1840 1838 -18 0 44 -2 0 206 -2 0 44 -18 0 7 -6 8 9 -34 0 44 -29 0 10 -14 11 1842 3151 3152 -49 0 10 -17 11 19 11 12 -5 0 206 -10 0 206 -10 0 206 -5 0 10 -4 11 3147 3151 3152 -77 0 -2 44 -19 0 13 -27 14 -23 0 13 14 15 -3 0 13 14 15 -27 0 13 -3 14 15 -6 0 13 -3 14 15 -24 0 3141 3142 2911 2912 -9 14 2915 2916 3139 3140 -45 0 44 -7 0 2938 -16 11 19 -16 11 1842 1840 1838 -17 0 44 -2 0 206 -2 0 44 -18 0 13 -6 14 15 -64 0 10 11 19 -13 11 3155 3156 2917 2918 2913 2914 -45 0 10 19 -18 11 12 -5 0 206 -10 0 206 -10 0 206 -5 0 10 -5 11 3155 3156 2917 2918 -8 8 9 -7 0 7 2913 2914 -55 0 44 -2 0 44 -16 0 2909 2910 22 -15 11 19 -11 11 -23 0 16 17 18 -3 0 16 17 18 -27 0 16 -3 17 18 -6 0 16 -3 17 18 -23 0 3150 3145 3146 1834 -11 11 1835 3143 3144 3149 -10 0 -2 48 -4 0 -2 48 -34 0 2939 2937 -3 11 19 -29 11 1842 1840 1838 -16 0 44 -2 0 206 -2 0 44 -18 0 16 -6 17 18 -64 0 10 -16 11 1835 2919 2920 2915 2916 3139 3140 -43 0 10 -19 11 12 -5 0 206 -10 0 206 -10 0 206 -5 0 10 -6 11 1835 2919 2920 -8 14 15 -7 0 13 2915 2916 3139 3140 -69 0 2909 2910 2921 2922 2911 2912 23 -21 11 115 116 -4 11 -97 0 3153 3154 3148 -5 11 19 -3 11 19 -5 11 3147 3151 3152 -8 0 50 49 48 -4 0 48 50 49 -34 0 2938 -22 11 19 -11 11 1842 1840 1838 -18 0 206 -93 0 10 -14 11 19 -5 11 1835 3143 3144 1838 -42 0 10 -12 11 19 -6 11 12 -5 0 206 -10 0 206 -10 0 206 -5 0 10 -3 11 19 -13 11 12 -7 0 10 11 1835 3143 3144 3149 -58 0 7 -7 8 2921 2922 2911 2912 2923 2924 1834 -23 11 117 118 -4 11 -36 8 2913 2914 -15 0 7 -4 8 9 -5 0 7 -4 8 9 -5 0 7 -4 8 9 -12 0 2909 2910 2921 2922 3157 3158 -17 11 3155 3156 2917 2918 -5 8 48 51 52 48 -4 2178 48 51 52 48 -5 8 2913 2914 -26 0 2939 31 -34 11 1842 1840 1838 -17 0 206 -6 0 -3 83 -10 0 2909 2910 -8 8 9 -63 0 10 -22 11 3147 1840 1838 -41 0 10 -19 11 12 -5 0 206 -10 0 206 -10 0 206 -5 0 10 -16 11 19 12 -7 0 16 17 31 11 3147 3151 3152 -47 0 7 -9 8 114 -7 14 2923 2924 1834 -33 11 -36 14 2915 2916 3139 3140 -13 0 13 -4 14 15 -5 0 13 -4 14 15 -5 0 13 -4 14 15 -10 0 3141 3142 2911 2912 2923 2924 1834 -3 11 19 -9 11 19 -5 11 1835 2919 2920 -22 14 2915 2916 2917 2918 -5 8 2913 2914 -18 0 16 -11 17 31 -20 11 19 -2 11 1842 1840 3149 -16 0 206 -15 0 2909 2910 2921 2922 2911 2912 -8 14 15 -63 0 10 -23 11 1842 1840 1838 -8 0 -2 44 -5 0 -2 44 -23 0 10 -19 11 12 -5 0 206 -10 0 206 -10 0 206 -5 0 10 -17 11 12 -9 0 16 17 31 3155 3156 2917 2918 2913 2914 -9 0 -2 44 -4 0 -2 44 -24 0 2909 2910 114 -9 14 23 -43 11 19 -31 11 19 -4 11 1835 3143 3144 3149 -12 0 16 -4 17 18 -5 0 16 -4 17 18 -5 0 16 -4 17 18 -9 0 3150 3145 3146 1834 -13 11 19 -35 11 1835 2919 2920 -5 14 2915 2916 2917 2918 -7 8 9 -20 0 10 -24 11 1842 3151 3152 -15 0 206 -11 0 2909 2910 2921 2922 2911 2912 2923 2924 1834 -5 11 19 -3 11 21 -8 8 9 -54 0 10 -7 11 19 -13 11 19 -2 11 1842 1840 1838 -6 0 44 -2 0 44 0 83 0 44 -2 0 44 -22 0 10 -19 11 12 -5 0 206 -10 0 206 -10 0 206 -5 0 10 -17 11 12 -11 0 16 31 1835 2919 2920 2915 2916 3139 3140 -6 0 44 -2 0 44 -2 0 44 -2 0 44 -19 0 2909 2910 2921 2922 2911 2912 23 -36 11 19 -18 11 115 116 -5 11 19 -10 11 19 -18 11 3147 3151 3152 -47 0 3153 3154 3148 -39 11 19 -20 11 1835 2919 2920 -7 14 15 -14 0 128 -5 0 10 -25 11 3155 3156 2917 2918 -13 8 205 -9 8 2921 2922 2911 2912 2923 2924 1834 -13 11 20 -8 14 15 -15 0 7 -38 8 22 -25 11 1842 1840 3149 -38 0 10 -19 11 12 -5 0 206 -10 0 206 -10 0 206 -5 0 10 -17 11 12 -7 0 202 -4 0 16 31 -3 11 1835 3143 3144 3149 -30 0 2909 2910 2921 2922 2911 2912 2923 2924 1834 -28 11 19 -28 11 117 118 -23 11 19 -12 11 3155 3156 2917 2918 -43 8 2921 2922 3157 3158 -14 11 19 -14 11 19 -21 11 19 -16 11 19 -2 11 12 -20 0 10 -2 11 19 -23 11 1835 2919 2920 -13 14 214 -9 14 2923 2924 1834 -6 11 19 -15 11 115 116 -2 11 21 -15 8 114 -38 14 23 -26 11 1842 3151 3152 -37 0 10 -19 11 12 -5 0 206 -10 0 206 -10 0 206 -5 0 10 -7 11 19 -9 11 12 -7 0 3050 9 -4 0 16 17 31 -3 11 3147 3151 3152 -25 0 2909 2910 2921 2922 2911 2912 2923 2924 1834 -57 11 19 -37 11 19 -4 11 1835 2919 2920 -43 14 2923 2924 1834 -6 11 19 -12 11 19 -52 11 12 -20 0 10 -38 11 19 -38 11 117 118 -2 11 20 -15 14 23 -16 11 19 -49 11 3155 3156 2917 2918 -15 8 9 -10 0 7 -8 8 22 -19 11 12 -5 0 206 -10 0 206 -10 0 206 -5 0 10 -17 11 12 -7 0 3056 113 9 -5 0 16 31 -3 11 3155 3156 2917 2918 -14 8 9 -5 0 7 2921 2922 2911 2912 2923 2924 1834 -75 11 19 -47 11 19 -66 11 19 -34 11 12 -8 0 7 -11 8 22 -13 11 19 -12 11 19 -28 11 19 -8 11 19 -10 11 19 -10 11 19 -12 11 19 -25 11 19 -39 11 1835 2919 2920 -15 14 15 2085 2086 2085 2086 2085 2086 2085 2086 2085 2086 13 -8 14 23 -3 11 19 -15 11 12 -5 0 206 -10 0 206 -10 0 206 -5 0 10 -17 11 12 -7 0 10 20 113 9 -5 0 16 17 31 -2 11 1835 2919 2920 -14 14 15 -5 0 13 2923 2924 1834 -13 11 19 -58 11 19 -76 11 19 -9 11 19 -6 11 115 116 -61 11 12 -8 0 13 -11 14 23 -45 11 19 -46 11 19 -10 11 19 -35 11 19 -40 11 19 -2 11 12 2087 2088 2087 2088 2087 2088 2087 2088 2087 2088 10 -28 11 12 -5 0 206 -10 0 206 -10 0 206 -5 0 10 -17 11 12 -7 0 10 11 20 113 8 9 -5 0 16 31 -18 11 12 -5 0 10 -51 11 19 -25 11 19 -48 11 19 -17 11 19 -24 11 117 118 -5 11 19 -6 11 19 -35 11 19 -12 11 12 -8 0 10 -45 11 19 -24 11 19 -13 11 19 -9 11 19 -29 11 19 -38 11 19 -11 11 19 -19 11 12 2087 2088 2087 2088 2087 2088 2087 2088 2087 2088 10 -28 11 12 -5 0 206 -10 0 206 -10 0 206 -5 0 10 -17 11 12 -7 0 10 19 11 20 14 113 9 -5 0 10 11 19 -16 11 12 -5 0 10 -34 11 19 -35 11 19 -15 11 19 -28 11 19 -21 11 19 -20 11 19 -7 11 19 -34 11 19 -30 11 12 -8 0 10 -29 11 19 -31 11 19 -17 11 19 -20 11 -2 19 -28 11 19 -13 11 19 -50 11 12 2087 2088 2087 2088 2087 2088 2087 2088 2087 2088 10 -4 11 19 -23 11 12 -5 0 206 -10 0 206 -10 0 206 -5 0 10 -9 11 19 -7 11 12 -7 0 10 -4 11 20 113 -5 8 22 -16 11 19 11 12 -5 0 10 -71 11 19 -29 11 19 -130 11 12 -8 0 10 -19 11 19 -30 11 19 -68 11 19 -75 11 12 2087 2088 2087 2088 2087 2088 2087 2088 2087 2088 10 -28 11 12 -5 0 206 -10 0 206 -10 0 206 -5 0 10 -17 11 12 -7 0 10 -5 11 20 -5 14 23 -18 11 12 -5 0 10 -70 11)
    )
    (tilemap
      (solid #f)
      (speed-x 0.5)
      (speed-y 0.5)
      (z-pos -150)
      (width 575)
      (height 35)
      (tiles -6333 0 149 -14 150 151 -50 0 149 -14 150 151 -50 0 149 -14 150 151 -50 0 149 -14 150 151 -50 0 149 -14 150 151 -50 0 149 -14 150 151 -50 0 149 -14 150 151 -50 0 149 -14 150 151 -50 0 149 -14 150 151 -30 0 149 159 -14 153 158 151 -21 0 149 -9 150 151 -16 0 149 159 -14 153 158 151 -21 0 149 -9 150 151 -16 0 149 159 -14 153 158 151 -21 0 149 -9 150 151 -16 0 149 159 -14 153 158 151 -21 0 149 -9 150 151 -16 0 149 159 -14 153 158 151 -21 0 149 -9 150 151 -16 0 149 159 -14 153 158 151 -21 0 149 -9 150 151 -16 0 149 159 -14 153 158 151 -21 0 149 -9 150 151 -16 0 149 159 -14 153 158 151 -21 0 149 -9 150 151 -16 0 149 159 -14 153 158 151 -21 0 149 -7 150 159 -16 153 158 151 -10 0 149 -9 150 159 -9 153 154 -8 0 149 -7 150 159 -16 153 158 151 -10 0 149 -9 150 159 -9 153 154 -8 0 149 -7 150 159 -16 153 158 151 -10 0 149 -9 150 159 -9 153 154 -8 0 149 -7 150 159 -16 153 158 151 -10 0 149 -9 150 159 -9 153 154 -8 0 149 -7 150 159 -16 153 158 151 -10 0 149 -9 150 159 -9 153 154 -8 0 149 -7 150 159 -16 153 158 151 -10 0 149 -9 150 159 -9 153 154 -8 0 149 -7 150 159 -16 153 158 151 -10 0 149 -9 150 159 -9 153 154 -8 0 149 -7 150 159 -16 153 158 151 -10 0 149 -9 150 159 -9 153 154 -8 0 149 -7 150 159 -16 153 158 151 -10 0 149 -9 150 159 -25 153 158 -10 150 159 -19 153 158 -8 150 159 -25 153 158 -10 150 159 -19 153 158 -8 150 159 -25 153 158 -10 150 159 -19 153 158 -8 150 159 -25 153 158 -10 150 159 -19 153 158 -8 150 159 -25 153 158 -10 150 159 -19 153 158 -8 150 159 -25 153 158 -10 150 159 -19 153 158 -8 150 159 -25 153 158 -10 150 159 -19 153 158 -8 150 159 -25 153 158 -10 150 159 -19 153 158 -8 150 159 -25 153 158 -10 150 159 -11510 153)
    )
    (tilemap
      (solid #f)
      (speed-x 0.25)
      (speed-y 0.25)
      (z-pos -151)
      (width 575)
      (height 35)
      (tiles -1204 0 161 -7 162 163 -58 0 161 -7 162 163 -58 0 161 -7 162 163 -58 0 161 -7 162 163 -58 0 161 -7 162 163 -58 0 161 -7 162 163 -58 0 161 -7 162 163 -58 0 161 -7 162 163 -82 0 161 -13 162 163 164 -7 165 170 163 -42 0 161 -13 162 163 164 -7 165 170 163 -42 0 161 -13 162 163 164 -7 165 170 163 -42 0 161 -13 162 163 164 -7 165 170 163 -42 0 161 -13 162 163 164 -7 165 170 163 -42 0 161 -13 162 163 164 -7 165 170 163 -42 0 161 -13 162 163 164 -7 165 170 163 -42 0 161 -13 162 163 164 -7 165 170 163 -57 0 161 -6 162 163 -11 0 161 -4 162 171 -13 165 170 171 -8 165 170 163 -17 0 161 -6 162 163 -11 0 161 -4 162 171 -13 165 170 171 -8 165 170 163 -17 0 161 -6 162 163 -11 0 161 -4 162 171 -13 165 170 171 -8 165 170 163 -17 0 161 -6 162 163 -11 0 161 -4 162 171 -13 165 170 171 -8 165 170 163 -17 0 161 -6 162 163 -11 0 161 -4 162 171 -13 165 170 171 -8 165 170 163 -17 0 161 -6 162 163 -11 0 161 -4 162 171 -13 165 170 171 -8 165 170 163 -17 0 161 -6 162 163 -11 0 161 -4 162 171 -13 165 170 171 -8 165 170 163 -17 0 161 -6 162 163 -11 0 161 -4 162 171 -13 165 170 171 -8 165 170 163 -17 0 161 -6 162 163 -11 0 161 -4 162 -5 0 161 -8 162 163 164 -6 165 170 163 -5 0 161 -4 162 171 -29 165 170 163 -6 0 161 -8 162 163 164 -6 165 170 163 -5 0 161 -4 162 171 -29 165 170 163 -6 0 161 -8 162 163 164 -6 165 170 163 -5 0 161 -4 162 171 -29 165 170 163 -6 0 161 -8 162 163 164 -6 165 170 163 -5 0 161 -4 162 171 -29 165 170 163 -6 0 161 -8 162 163 164 -6 165 170 163 -5 0 161 -4 162 171 -29 165 170 163 -6 0 161 -8 162 163 164 -6 165 170 163 -5 0 161 -4 162 171 -29 165 170 163 -6 0 161 -8 162 163 164 -6 165 170 163 -5 0 161 -4 162 171 -29 165 170 163 -6 0 161 -8 162 163 164 -6 165 170 163 -5 0 161 -4 162 171 -29 165 170 163 -6 0 161 -8 162 163 164 -6 165 170 163 -5 0 161 -4 162 171 -4 165 -4 0 161 171 -8 165 170 171 -7 165 170 -5 162 171 -35 165 170 163 -4 0 161 171 -8 165 170 171 -7 165 170 -5 162 171 -35 165 170 163 -4 0 161 171 -8 165 170 171 -7 165 170 -5 162 171 -35 165 170 163 -4 0 161 171 -8 165 170 171 -7 165 170 -5 162 171 -35 165 170 163 -4 0 161 171 -8 165 170 171 -7 165 170 -5 162 171 -35 165 170 163 -4 0 161 171 -8 165 170 171 -7 165 170 -5 162 171 -35 165 170 163 -4 0 161 171 -8 165 170 171 -7 165 170 -5 162 171 -35 165 170 163 -4 0 161 171 -8 165 170 171 -7 165 170 -5 162 171 -35 165 170 163 -4 0 161 171 -8 165 170 171 -7 165 170 -5 162 171 -9 165 -4 162 171 -61 165 170 -4 162 171 -61 165 170 -4 162 171 -61 165 170 -4 162 171 -61 165 170 -4 162 171 -61 165 170 -4 162 171 -61 165 170 -4 162 171 -61 165 170 -4 162 171 -61 165 170 -4 162 171 -15559 165)
    )
    (tilemap
      (solid #t)
      (z-pos 1)
      (width 575)
      (height 35)
      (tiles -7082 0 44 0 44 0 44 -2 0 44 0 44 0 44 -9474 0 44 -5 0 128 -569 0 44 -277 0 -11 44 -287 0 44 -4 0 44 0 44 -568 0 -2 44 0 44 0 44 0 44 -569 0 44 0 44 0 44 -571 0 44 0 44 0 44 -671 0)
    )
    (tilemap
      (solid #f)
      (z-pos 101)
      (name "secret1")
      (width 575)
      (height 35)
      (tiles -14546 0 3249 -12 11 -562 0 2126 11 19 -10 11 -562 0 2126 -3 11 19 -2 11 19 -5 11 -562 0 2126 -12 11 -562 0 2126 -2 11 19 -9 11 -562 0 3253 -9 11 19 -2 11 -562 0 10 -12 11 -2116 0)
    )
    (tilemap
      (solid #t)
      (z-pos -1)
      (width 575)
      (height 35)
      (tiles -5480 0 2067 -8 2068 2069 -565 0 2072 -8 2073 2074 -565 0 2057 2060 2061 2065 2066 2060 2061 2065 2066 2059 -565 0 2057 2065 2066 2061 2060 2065 2066 2061 2060 2059 -565 0 2057 2061 2060 -2 2065 2061 2060 -2 2065 2059 -565 0 2057 2060 2061 2060 2061 2060 2061 2060 2061 2059 -60 0 2067 -12 2068 -492 0 2057 2060 2061 2065 2066 2060 2061 2065 2066 2059 -60 0 2072 -12 2073 2058 -491 0 2057 2065 2066 2061 2060 2065 2066 2061 2060 2059 -60 0 2062 2051 2065 2060 2065 2058 2065 2060 2065 2058 2065 2060 2065 2058 -491 0 2057 2061 2060 -2 2065 2061 2060 -2 2065 2059 -61 0 2057 2061 -2 2060 2058 2061 -2 2060 2058 2061 -2 2060 2058 -491 0 2057 2060 2061 2060 2061 2060 2061 2060 2061 2059 -61 0 2062 2051 2061 2066 2061 2066 2061 2066 2061 2066 2061 2066 2058 -491 0 2057 2060 2061 2065 2066 2060 2061 2065 2066 2059 -62 0 2057 2058 -2 2060 2061 2058 -2 2060 2061 2058 2060 2058 -485 0 2067 2068 2069 -3 0 2057 2065 2066 2061 2060 2065 2066 2061 2060 2059 -62 0 2062 2051 2065 2058 2065 2060 2065 2058 2065 2060 2065 2058 -479 0 2067 2068 2069 -3 0 2072 2073 2074 -3 0 2057 2061 2060 -2 2065 2061 2060 -2 2065 2059 -63 0 2057 2060 2058 2061 -2 2060 2058 2061 -2 2060 2058 -479 0 2072 2073 2074 -3 0 2057 2060 2059 -3 0 2057 2060 2061 2060 2061 2060 2061 2060 2061 2059 -63 0 2062 2051 2061 2066 2061 2066 2061 2066 2061 2066 2058 -470 0 2067 -4 2068 2069 -3 0 2057 2060 2059 -3 0 2057 2058 2059 -3 0 2057 2060 2061 2065 2066 2060 2061 2065 2066 2059 -64 0 2057 2060 2061 2058 -2 2060 2061 2058 2060 2058 -470 0 2072 -4 2073 2074 -3 0 2057 2058 2059 -3 0 2057 2065 2059 -3 0 2057 2065 2066 2061 2060 2065 2066 2061 2060 2059 -64 0 2062 2051 2065 2060 2065 2058 2065 2060 2065 2058 -470 0 2057 2060 2061 2060 2071 2059 -3 0 2057 2065 2059 -3 0 2057 2066 2059 -3 0 2057 2061 2060 -2 2065 2061 2060 -2 2065 2059 -65 0 2057 2061 -2 2060 2058 2061 2060 48 -2 2058 -69 0 -3 28 29 -396 0 2057 2070 2066 2065 2066 2059 -3 0 2057 2066 2059 -3 0 2057 2060 2059 -3 0 2057 2060 2061 2060 2061 2060 2061 2060 2061 2059 -65 0 2062 2051 2061 2066 2061 2066 2061 48 2061 2058 -469 0 2057 2060 2061 2070 2061 2059 -3 0 2057 2060 2059 -3 0 2057 2061 2059 -3 0 2057 2060 2061 2065 2066 2060 2061 2065 2066 2059 -66 0 2057 2058 -2 2060 2061 2058 48 2060 2058 -470 0 2065 2066 2065 2066 -92 0 2062 2051 2065 2058 2065 2060 2065 -2 2058 -567 0 2057 2060 2058 2061 -2 2060 -2 2058 -568 0 -7 2058 -2485 0)
    )
    (tilemap
      (solid #f)
      (z-pos 102)
      (name "secret2")
      (width 575)
      (height 35)
      (tiles -13692 0 10 11 -566 0 -3 2178 -4 0 3249 -3 11 -571 0 2126 -4 11 -570 0 2126 -5 11 -569 0 3253 -2 11 19 -6 11 -565 0 10 -11 11 -563 0 10 -12 11 -562 0 10 -7 11 19 -5 11 -562 0 -13 11 -562 0 19 -12 11 -564 0 -11 11 -565 0 -10 11 -94 0)
    )
    (trampoline
      (type "stationary")
      (z-pos 50)
      (x 5152)
      (y 832)
    )
    (trampoline
      (z-pos 50)
      (x 5120)
      (y 832)
    )
    (trampoline
      (z-pos 50)
      (x 10208)
      (y 864)
    )
    (trampoline
      (type "stationary")
      (z-pos 50)
      (x 13216)
      (y 544)
    )
    (trampoline
      (type "stationary")
      (z-pos 50)
      (x 13568)
      (y 544)
    )
    (trampoline
      (type "stationary")
      (z-pos 50)
      (x 13920)
      (y 544)
    )
    (unstable_tile
      (z-pos 0)
      (x 14912)
      (y 704)
    )
    (unstable_tile
      (z-pos 0)
      (x 14880)
      (y 704)
    )
    (unstable_tile
      (z-pos 0)
      (x 14848)
      (y 704)
    )
    (unstable_tile
      (z-pos 0)
      (x 14816)
      (y 704)
    )
    (unstable_tile
      (z-pos 0)
      (x 14784)
      (y 704)
    )
    (unstable_tile
      (z-pos 0)
      (x 14752)
      (y 704)
    )
    (unstable_tile
      (z-pos 0)
      (x 14720)
      (y 704)
    )
    (wind
      (z-pos -99)
      (blowing #f)
      (speed-x 0)
      (speed-y -500)
      (acceleration 100)
      (affects-player #t)
      (width 64)
      (height 608)
      (name "wind")
      (x 11904)
      (y 352)
    )
  )
)
