(supertux-level
  (version 3)
  (name (_ "Unstable Ice"))
  (author "Sophie \"Vaesea\" Ball")
  (license "CC-BY-SA 4.0 International")
  (target-time 61)
  (allow-item-pocket "inherit")
  (icon "")
  (icon-locked "")
  (statistics
    (enable-coins #t)
    (enable-secrets #t)
  )
  (sector
    (name "main")
    (ambient-light
      (color 1 1 1)
    )
    (bouncingsnowball
      (z-pos 50)
      (direction "left")
      (x 4448)
      (y 800)
      (glinting #f)
    )
    (bouncingsnowball
      (z-pos 50)
      (direction "left")
      (x 13280)
      (y 672)
      (glinting #f)
    )
    (camera
      (name "Camera")
      (mode "normal")
    )
    (captainsnowball
      (z-pos 50)
      (direction "left")
      (x 2112)
      (y 896)
      (glinting #f)
    )
    (decal
      (z-pos -100)
      (sprite "/images/decal/snow/exitbg.png")
      (x 16800)
      (y 672)
    )
    (decal
      (z-pos 100)
      (sprite "/images/decal/snow/exitfg.png")
      (x 16896)
      (y 672)
    )
    (firefly
      (z-pos 0)
      (x 11200)
      (y 800)
    )
    (flyingsnowball
      (z-pos 50)
      (x 7520)
      (y 480)
      (glinting #f)
    )
    (goldbomb
      (z-pos 50)
      (direction "left")
      (x 4320)
      (y 512)
      (glinting #t)
    )
    (gradient
      (top_color 0.3 0.4 0.75)
      (bottom_color 1 1 1)
    )
    (jumpy
      (z-pos 50)
      (x 1792)
      (y 864)
      (glinting #f)
    )
    (jumpy
      (z-pos 50)
      (x 2176)
      (y 864)
      (glinting #f)
    )
    (jumpy
      (z-pos 50)
      (x 5200)
      (y 640)
      (glinting #f)
    )
    (jumpy
      (z-pos 50)
      (x 6944)
      (y 608)
      (glinting #f)
    )
    (jumpy
      (z-pos 50)
      (x 15136)
      (y 672)
      (glinting #f)
    )
    (mriceblock
      (z-pos 50)
      (direction "left")
      (x 12320)
      (y 832)
      (glinting #f)
    )
    (music
      (file "/music/antarctic/chipdisko.music")
    )
    (secretarea
      (width 224)
      (height 256)
      (x 12768)
      (y 0)
    )
    (sequencetrigger
      (sequence "endsequence")
      (width 32)
      (height 864)
      (x 16416)
      (y 0)
    )
    (sequencetrigger
      (sequence "stoptux")
      (width 32)
      (height 704)
      (x 17088)
      (y 288)
    )
    (smartball
      (z-pos 50)
      (direction "left")
      (x 928)
      (y 576)
      (glinting #f)
    )
    (smartball
      (z-pos 50)
      (direction "left")
      (x 5344)
      (y 672)
      (glinting #f)
    )
    (smartball
      (z-pos 50)
      (direction "left")
      (x 6656)
      (y 608)
      (glinting #f)
    )
    (smartball
      (z-pos 50)
      (direction "left")
      (x 6784)
      (y 768)
      (glinting #f)
    )
    (smartball
      (z-pos 50)
      (direction "left")
      (x 6144)
      (y 832)
      (glinting #f)
    )
    (smartball
      (z-pos 50)
      (direction "left")
      (x 15808)
      (y 736)
      (glinting #f)
    )
    (smartball
      (z-pos 50)
      (direction "left")
      (x 15680)
      (y 736)
      (glinting #f)
    )
    (smartball
      (z-pos 50)
      (direction "left")
      (x 7808)
      (y 704)
      (glinting #f)
    )
    (smartball
      (z-pos 50)
      (direction "left")
      (x 12000)
      (y 672)
      (glinting #f)
    )
    (smartball
      (z-pos 50)
      (direction "left")
      (x 12704)
      (y 544)
      (glinting #f)
    )
    (smartblock
      (z-pos 50)
      (direction "left")
      (x 6016)
      (y 608)
      (glinting #f)
    )
    (snowball
      (z-pos 50)
      (direction "left")
      (x 8992)
      (y 896)
      (glinting #f)
    )
    (snowball
      (z-pos 50)
      (direction "left")
      (x 12512)
      (y 832)
      (glinting #f)
    )
    (snowball
      (z-pos 50)
      (direction "left")
      (x 12704)
      (y 832)
      (glinting #f)
    )
    (snowball
      (z-pos 50)
      (direction "left")
      (x 13920)
      (y 864)
      (glinting #f)
    )
    (snowball
      (z-pos 50)
      (direction "left")
      (x 15424)
      (y 864)
      (glinting #f)
    )
    (spawnpoint
      (name "main")
      (x 64)
      (y 800)
    )
    (spiky
      (z-pos 50)
      (direction "left")
      (x 6048)
      (y 832)
      (glinting #f)
    )
    (spiky
      (z-pos 50)
      (direction "left")
      (x 6688)
      (y 768)
      (glinting #f)
    )
    (spiky
      (z-pos 50)
      (direction "left")
      (x 8064)
      (y 768)
      (glinting #f)
    )
    (spiky
      (z-pos 50)
      (direction "left")
      (x 8320)
      (y 832)
      (glinting #f)
    )
    (spiky
      (z-pos 50)
      (direction "left")
      (x 10848)
      (y 800)
      (glinting #f)
    )
    (stalactite
      (glinting #f)
      (z-pos -1)
      (x 3488)
      (y 704)
    )
    (stalactite
      (glinting #f)
      (z-pos -1)
      (x 3872)
      (y 672)
    )
    (stalactite
      (glinting #f)
      (z-pos -1)
      (x 3168)
      (y 704)
    )
    (stalactite
      (glinting #f)
      (z-pos -1)
      (x 4096)
      (y 608)
    )
    (stalactite
      (glinting #f)
      (z-pos -1)
      (x 4128)
      (y 608)
    )
    (stalactite
      (glinting #f)
      (z-pos -1)
      (x 4224)
      (y 608)
    )
    (stalactite
      (glinting #f)
      (z-pos -1)
      (x 4320)
      (y 608)
    )
    (stalactite
      (glinting #f)
      (z-pos -1)
      (x 11904)
      (y 736)
    )
    (stalactite
      (glinting #f)
      (z-pos -1)
      (x 11968)
      (y 736)
    )
    (stalactite
      (glinting #f)
      (z-pos -1)
      (x 12608)
      (y 608)
    )
    (stalactite
      (glinting #f)
      (z-pos -1)
      (x 12544)
      (y 608)
    )
    (stalactite
      (glinting #f)
      (z-pos -1)
      (x 12672)
      (y 608)
    )
    (stalactite
      (glinting #f)
      (z-pos -1)
      (x 12480)
      (y 608)
    )
    (tilemap
      (solid #f)
      (z-pos -100)
      (width 535)
      (height 35)
      (tiles -399 0 124 125 -533 0 124 125 -3 0 122 123 -528 0 124 125 -3 0 124 125 -528 0 124 125 -3 0 124 125 -528 0 124 125 -3 0 124 125 -528 0 124 125 0 25 0 124 125 -3486 0 122 123 -245 0 122 123 -286 0 124 125 -245 0 124 125 -286 0 124 125 -245 0 124 125 -269 0 106 107 108 -14 0 124 125 -68 0 122 123 -175 0 124 125 -11 0 122 123 -254 0 24 0 109 110 111 0 25 -12 0 124 125 -12 0 122 123 -54 0 124 125 -9 0 106 107 108 -160 0 106 107 108 124 125 -11 0 124 125 -273 0 124 125 -12 0 124 125 -54 0 124 125 -8 0 25 109 110 111 -160 0 109 110 111 124 125 24 -10 0 124 125 -110 0 122 123 -118 0 24 -42 0 124 125 -12 0 124 125 -54 0 124 125 -17 0 122 123 -134 0 122 123 -33 0 124 125 -103 0 130 -6 0 124 125 -31 0 122 123 -102 0 24 -25 0 124 125 -12 0 124 125 -51 0 106 107 108 124 125 -17 0 124 125 -134 0 124 125 -33 0 124 125 -103 0 129 -6 0 124 125 -31 0 124 125 -90 0 25 -37 0 124 125 -12 0 124 125 -51 0 109 110 111 124 125 25 -16 0 124 125 -13 0 122 123 -75 0 122 123 -32 0 122 123 -8 0 124 125 -33 0 124 125 -70 0 122 123 -31 0 129 -6 0 124 125 -25 0 122 123 -4 0 124 125 -128 0 124 125 -9 0 25 -2 0 124 125 0 24 -39 0 122 123 -21 0 122 123 -7 0 124 125 -13 0 124 125 -75 0 124 125 -32 0 124 125 -8 0 124 125 -32 0 24 124 125 0 25 -68 0 124 125 -31 0 129 -6 0 124 125 -25 0 124 125 -4 0 124 125 -15 0 122 123 -51 0 25 -2 0 24 -39 0 122 123 -15 0 124 125 -39 0 122 123 -14 0 124 125 -21 0 124 125 -6 0 24 124 125 -13 0 124 125 -75 0 124 125 -32 0 124 125 -115 0 124 125 -3 0 106 107 108 -25 0 129 -6 0 124 125 -19 0 122 123 -4 0 124 125 -4 0 124 125 -15 0 124 125 -24 0 122 123 -56 0 122 123 -10 0 124 125 -4 0 122 123 -9 0 124 125 -39 0 124 125 -14 0 124 125 -21 0 124 125 -18 0 25 -3 0 124 125 -75 0 124 125 -22 0 122 123 -8 0 124 125 -66 0 122 123 -36 0 25 -10 0 124 125 -3 0 109 110 111 0 25 -2 0 24 0 25 -8 0 122 123 -8 0 129 -6 0 124 125 -19 0 124 125 -4 0 124 125 -4 0 124 125 -15 0 124 125 -24 0 124 125 -19 0 24 -36 0 124 125 -10 0 124 125 -4 0 124 125 -9 0 124 125 -39 0 124 125 -10 0 25 -3 0 124 125 -2 0 24 -18 0 124 125 24 0 25 -19 0 124 125 0 106 107 108 -71 0 124 125 -22 0 124 125 -8 0 124 125 -66 0 124 125 -47 0 124 125 -21 0 124 125 -8 0 129 -6 0 124 125 -14 0 108 -4 0 124 125 -4 0 124 125 -4 0 124 125 -9 0 106 107 108 -3 0 124 125 -20 0 122 123 -2 0 124 125 -11 0 106 107 108 -42 0 124 125 -8 0 25 0 124 125 0 24 -2 0 124 125 -9 0 124 125 24 0 25 -5 0 106 107 108 -28 0 124 125 -64 0 109 110 111 -64 0 106 107 108 -4 0 124 125 -4 0 25 -2 0 24 -14 0 124 125 -8 0 124 125 -66 0 124 125 -25 0 25 -21 0 124 125 -21 0 124 125 -8 0 129 -6 0 124 125 106 107 108 -11 0 111 -2 0 24 0 124 125 0 25 -2 0 124 125 -2 0 25 0 124 125 -4 0 25 -4 0 109 110 111 25 0 24 124 125 -20 0 124 125 -2 0 124 125 -11 0 109 110 111 0 25 -20 0 24 -19 0 124 125 -37 0 109 110 111 -6 0 25 24 -14 0 24 25 -4 0 124 125 -131 0 109 110 111 -2 0 24 0 124 125 -17 0 25 -2 0 24 0 124 125 -8 0 124 125 106 107 108 -22 0 24 -3 0 25 -2 0 24 -29 0 106 107 108 0 124 125 -19 0 24 -27 0 124 125 -13 0 106 107 108 -5 0 124 125 -4 0 25 -3 0 129 -2 0 25 -2 0 24 124 125 109 110 111 -67 0 124 125 -2 0 124 125 -56 0 124 125 -241 0 24 124 125 109 110 111 -13 0 24 -43 0 25 0 109 110 111 0 124 125 0 24 -41 0 25 0 24 0 124 125 -13 0 109 110 111 -3 0 24 0 124 125 -85 0 24 0 124 125 -2 0 124 125 0 25 -6 0 24 -44 0 24 -258 0 25 -64 0 25 -200 0 106 107 108 -3 0 25 -209 0 122 123 -81 0 106 107 108 -233 0 109 110 111 -213 0 124 125 -77 0 24 0 25 0 109 110 111 0 25 -447 0 124 125 -533 0 124 125 -4 8 -1278 0)
    )
    (tilemap
      (solid #f)
      (z-pos 100)
      (width 535)
      (height 35)
      (tiles -10144 0 130 -534 0 129 -534 0 129 -534 0 129 -534 0 129 -534 0 129 -534 0 129 -534 0 129 -534 0 129 -4300 0)
    )
    (tilemap
      (solid #t)
      (z-pos 0)
      (width 535)
      (height 35)
      (tiles -1471 0 83 128 83 -1352 0 83 128 -245 0 7 -7 8 9 -526 0 13 -7 14 15 -526 0 10 -7 11 12 -275 0 -10 44 -241 0 16 -7 17 18 -1224 0 78 102 78 -1168 0 83 -2 0 78 83 78 -2 0 2944 -627 0 -3 83 -161 0 -3 83 -801 0 7 -9 8 9 -524 0 13 -9 14 15 -90 0 7 -3 8 9 -157 0 7 -7 8 9 -241 0 202 -10 0 202 -10 0 10 11 19 -7 11 12 -21 0 -3 83 -4 0 83 102 83 -59 0 13 -3 14 15 -157 0 13 -7 14 15 -224 0 -3 83 -14 0 203 -10 0 203 -5 0 202 -4 0 16 -9 17 18 -90 0 16 -3 17 18 -157 0 16 -7 17 18 -236 0 202 -4 0 3059 -4 0 202 -5 0 3059 -5 0 203 -92 0 7 -5 8 2913 2914 -264 0 78 -3 83 78 -143 0 203 -9 0 203 -11 0 3059 -35 0 7 -10 8 9 -45 0 13 -5 14 2915 2916 3139 3140 -147 0 7 -3 8 9 -26 0 7 -12 8 2913 2914 -203 0 7 -5 8 2913 2914 -6 0 3059 -9 0 3059 -47 0 13 -10 14 15 -45 0 16 2933 -5 11 1835 3143 3144 3149 -9 0 7 -2 8 9 -5 0 7 2913 2914 -125 0 13 -3 14 15 -26 0 13 -12 14 2915 2916 3139 3140 -52 0 2909 2910 9 -146 0 13 -5 14 2915 2916 3139 3140 -62 0 16 -3 17 31 -2 11 30 -3 17 18 -46 0 2934 2933 -6 11 3147 3151 3152 -8 0 13 -2 14 15 -5 0 13 2915 2916 2917 2918 2913 2914 -73 0 -2 83 102 -2 83 -43 0 16 -3 17 18 -26 0 16 2925 2926 -11 11 1835 3143 3144 1838 -48 0 7 2921 2922 2911 2912 15 -7 0 7 -13 8 9 -118 0 7 -5 8 22 -6 11 1835 3143 3144 3149 -65 0 10 19 11 12 -34 0 7 -13 8 9 -2 0 2934 2937 -6 11 3155 3156 2917 2918 -6 8 22 -2 11 12 -5 0 10 11 1835 2919 2920 2915 2916 2917 2918 2913 2914 -150 0 2928 -5 17 2925 2926 -6 11 3147 1840 1838 -39 0 2909 2910 9 -5 0 13 2923 2924 1834 11 12 -7 0 13 -13 14 15 -118 0 13 -5 14 23 -8 11 3147 3151 3152 -28 0 2909 2910 -13 8 9 -5 0 7 -6 8 2913 2914 -6 0 10 -2 11 12 -34 0 13 -13 14 15 -3 0 2938 -7 11 1835 2919 2920 -6 14 23 -2 11 12 -5 0 10 -5 11 1835 2919 2920 2915 2916 2917 2918 2913 2914 -74 0 2909 2910 -6 8 9 -70 0 2928 2933 -6 11 1842 1840 3149 -35 0 7 2921 2922 2911 2912 15 -5 0 10 -4 11 12 -7 0 16 2925 2926 -9 11 2929 2930 18 -39 0 -36 8 9 -36 0 7 -5 8 22 -15 11 3155 3156 2917 2918 2913 2914 -20 0 2909 2910 2921 2922 2911 2912 -13 14 15 -5 0 13 -6 14 2915 2916 2917 2918 -4 8 22 -2 11 21 -4 8 9 -9 0 7 -13 8 9 -5 0 16 -13 17 18 -3 0 2939 31 11 19 -16 11 12 -5 0 10 -9 11 1835 2919 2920 2915 2916 2917 2918 9 -59 0 7 -9 8 2921 2922 2911 2912 -6 14 15 -5 0 7 -7 8 9 -28 0 2909 2910 -13 8 9 -13 0 2934 2933 -6 11 1842 3151 3152 -26 0 2909 2910 9 -5 0 13 2923 2924 1834 11 12 -5 0 10 -4 11 12 -9 0 2928 31 -2 11 19 -4 11 30 2931 -11 0 2909 2910 -28 8 -36 14 15 -36 0 13 -5 14 23 -16 11 1835 2919 2920 2915 2916 3139 3140 -14 0 2909 2910 2921 2922 2911 2912 2923 2924 1834 -14 11 12 -5 0 10 -7 11 1835 2919 2920 -4 14 23 -2 11 20 -4 14 15 -9 0 13 -13 14 15 -24 0 10 -18 11 12 -5 0 10 -13 11 1835 2919 2920 15 -59 0 13 -9 14 2923 2924 1834 -7 11 12 -5 0 13 -7 14 15 -5 0 7 -7 8 2913 2914 -7 0 2909 2910 -2 8 2921 2922 2911 2912 -13 14 15 -5 0 2948 -3 83 -5 0 2934 2937 -6 11 3155 3156 2917 2918 -11 8 2913 2914 -8 0 7 2921 2922 2911 2912 15 -5 0 10 -2 11 19 11 12 -5 0 10 -4 11 21 -10 8 22 -7 11 21 -10 8 2921 2922 2911 2912 -28 14 -36 11 12 -15 0 7 -20 8 22 -26 11 1835 3143 3144 3149 -9 0 2909 2910 2921 2922 2911 2912 2923 2924 1834 -18 11 12 -5 0 10 -9 11 19 -12 11 12 -9 0 16 -13 17 18 -24 0 10 -18 11 12 -5 0 10 -16 11 12 -59 0 16 -5 17 44 31 -12 11 12 -5 0 10 -7 11 12 -5 0 13 -7 14 2915 2916 2917 2918 -3 8 2921 2922 2911 2912 -2 14 2923 2924 1834 -14 11 12 -15 0 2938 -7 11 1835 2919 2920 -11 14 2915 2916 2917 2918 9 -5 0 13 2923 2924 1834 11 12 -5 0 10 -4 11 12 -5 0 10 -4 11 20 -10 14 23 -7 11 20 -10 14 2923 2924 1834 -57 11 115 116 -6 11 12 -15 0 13 -20 14 23 -8 11 19 -19 11 3147 3151 3152 -4 0 2909 2910 2921 2922 2911 2912 2923 2924 1834 -22 11 12 -5 0 10 -22 11 12 -48 0 10 -18 11 12 -5 0 10 -4 11 19 -11 11 12 -64 0 44 0 10 -12 11 12 -5 0 10 -6 11 19 12 -5 0 10 -8 11 1835 2919 2920 -3 14 2923 2924 1834 -20 11 12 -15 0 2939 2937 -21 11 1835 2919 2920 15 -5 0 10 -4 11 12 -5 0 10 -4 11 12 -5 0 10 -77 11 19 -16 11 117 118 -6 11 12 -15 0 10 -50 11 3155 3156 2917 2918 2921 2922 2911 2912 2923 2924 1834 -17 11 19 -8 11 12 -5 0 10 -22 11 12 -48 0 10 -12 11 19 -5 11 12 -5 0 10 -16 11 12 -63 0 44 0 44 10 -7 11 19 -4 11 12 -5 0 10 -7 11 12 -5 0 10 -9 11 19 -21 11 19 -5 11 21 -11 8 9 -4 0 2938 -24 11 12 -5 0 10 -4 11 12 -5 0 10 -4 11 12 -5 0 10 -24 11 19 -22 11 115 116 -5 11 19 -22 11 19 -24 11 12 -15 0 10 -5 11 19 -45 11 1835 2919 2920 2923 2924 1834 -30 11 12 -5 0 10 -22 11 12 -48 0 10 -18 11 12 -5 0 10 -16 11 12 -62 0 44 0 44 0 10 -12 11 12 -5 0 10 -7 11 12 -5 0 10 -37 11 20 -11 14 15 -4 0 2939 2937 -9 11 19 -13 11 12 -5 0 10 -4 11 12 -5 0 10 -4 11 12 -5 0 10 -47 11 117 118 -15 11 19 -32 11 19 -4 11 12 -15 0 10 -43 11 19 -43 11 12 -5 0 10 -22 11 12 -48 0 10 -18 11 12 -5 0 10 -16 11 12 -59 0 7 8 44 0 44 0 44 22 -12 11 12 -5 0 10 19 -6 11 12 -5 0 10 -49 11 12 -5 0 2938 -23 11 12 -5 0 10 11 19 -2 11 12 -5 0 10 -4 11 12 -5 0 10 -6 11 19 -31 11 19 -63 11 12 -15 0 10 -87 11 12 -5 0 10 -22 11 12 -48 0 10 -18 11 12 -5 0 10 -16 11 12 -59 0 13 -6 14 23 -12 11 12 -5 0 10 -7 11 12 -5 0 10 -45 11 19 -3 11 12 -5 0 2939 2937 -20 11 19 11 12 -5 0 10 -4 11 12 -5 0 10 -4 11 12 -5 0 10 -102 11 12 -15 0 10 -87 11 12 -5 0 10 -22 11 12 -48 0 10 -18 11 12 -5 0 10 -16 11 12 -59 0 10 -19 11 12 -5 0 10 -7 11 12 -5 0 10 -49 11 12 -6 0 2938 -22 11 12 -5 0 10 -4 11 12 -5 0 10 -4 11 12 -5 0 10 -66 11)
    )
    (tilemap
      (solid #f)
      (speed-x 0.5)
      (speed-y 0.5)
      (z-pos -225)
      (width 535)
      (height 35)
      (tiles -7000 0 149 -6 150 151 -47 0 149 -6 150 151 -47 0 149 -6 150 151 -47 0 149 -6 150 151 -47 0 149 -6 150 151 -47 0 149 -6 150 151 -47 0 149 -6 150 151 -47 0 149 -6 150 151 -47 0 149 -6 150 151 -64 0 149 -11 150 151 -9 0 149 159 -6 153 158 151 -23 0 149 -11 150 151 -9 0 149 159 -6 153 158 151 -23 0 149 -11 150 151 -9 0 149 159 -6 153 158 151 -23 0 149 -11 150 151 -9 0 149 159 -6 153 158 151 -23 0 149 -11 150 151 -9 0 149 159 -6 153 158 151 -23 0 149 -11 150 151 -9 0 149 159 -6 153 158 151 -23 0 149 -11 150 151 -9 0 149 159 -6 153 158 151 -23 0 149 -11 150 151 -9 0 149 159 -6 153 158 151 -23 0 149 -11 150 151 -9 0 149 159 -6 153 158 151 -23 0 149 -7 150 -32 0 152 -11 153 158 151 -7 0 149 159 -8 153 158 151 -22 0 152 -11 153 158 151 -7 0 149 159 -8 153 158 151 -22 0 152 -11 153 158 151 -7 0 149 159 -8 153 158 151 -22 0 152 -11 153 158 151 -7 0 149 159 -8 153 158 151 -22 0 152 -11 153 158 151 -7 0 149 159 -8 153 158 151 -22 0 152 -11 153 158 151 -7 0 149 159 -8 153 158 151 -22 0 152 -11 153 158 151 -7 0 149 159 -8 153 158 151 -22 0 152 -11 153 158 151 -7 0 149 159 -8 153 158 151 -22 0 152 -11 153 158 151 -7 0 149 159 -8 153 158 151 -22 0 152 -7 153 -10 0 -22 150 159 -12 153 158 151 -5 0 149 159 -10 153 158 -22 150 159 -12 153 158 151 -5 0 149 159 -10 153 158 -22 150 159 -12 153 158 151 -5 0 149 159 -10 153 158 -22 150 159 -12 153 158 151 -5 0 149 159 -10 153 158 -22 150 159 -12 153 158 151 -5 0 149 159 -10 153 158 -22 150 159 -12 153 158 151 -5 0 149 159 -10 153 158 -22 150 159 -12 153 158 151 -5 0 149 159 -10 153 158 -22 150 159 -12 153 158 151 -5 0 149 159 -10 153 158 -22 150 159 -12 153 158 151 -5 0 149 159 -10 153 158 -22 150 159 -7 153 -10 0 -36 153 158 -5 150 159 -48 153 158 -5 150 159 -48 153 158 -5 150 159 -48 153 158 -5 150 159 -48 153 158 -5 150 159 -48 153 158 -5 150 159 -48 153 158 -5 150 159 -48 153 158 -5 150 159 -48 153 158 -5 150 159 -42 153 -10 0 -525 153 -10 0 -525 153 -10 0 -525 153 -10 0 -525 153 -10 0 -525 153 -10 0 -525 153 -10 0 -525 153 -10 0 -525 153 -10 0 -525 153 -10 0 -525 153 -10 0 -525 153 -10 0 -525 153 -10 0 -525 153 -10 0 -525 153 -10 0 -525 153 -10 0 -525 153 -10 0 -525 153 -10 0)
    )
    (tilemap
      (solid #f)
      (speed-x 0.25)
      (speed-y 0.25)
      (z-pos -250)
      (width 535)
      (height 35)
      (tiles -3266 0 161 -9 162 163 -59 0 161 -9 162 163 -444 0 161 -9 162 171 -9 165 170 163 -48 0 161 -9 162 171 -9 165 170 163 -58 0 161 -9 162 163 -59 0 161 -9 162 163 -59 0 161 -9 162 163 -59 0 161 -9 162 163 -59 0 161 -9 162 163 -68 0 161 -15 162 163 -8 0 161 171 -20 165 170 163 -21 0 161 -15 162 163 -8 0 161 171 -20 165 170 163 -21 0 161 -14 162 -11 0 161 -9 162 171 -9 165 170 163 -48 0 161 -9 162 171 -9 165 170 163 -48 0 161 -9 162 171 -9 165 170 163 -48 0 161 -9 162 171 -9 165 170 163 -48 0 161 -9 162 171 -9 165 170 163 -58 0 161 -8 162 171 -15 165 170 -8 162 171 -22 165 170 163 -11 0 161 -8 162 171 -15 165 170 -8 162 171 -22 165 170 163 -11 0 161 -8 162 171 -14 165 162 163 -8 0 161 171 -20 165 170 163 -21 0 161 -15 162 163 -8 0 161 171 -20 165 170 163 -21 0 161 -15 162 163 -8 0 161 171 -20 165 170 163 -21 0 161 -15 162 163 -8 0 161 171 -20 165 170 163 -21 0 161 -15 162 163 -8 0 161 171 -20 165 170 163 -21 0 161 -14 162 -10 0 -11 162 171 -57 165 170 -11 162 171 -57 165 170 -11 162 171 -24 165 170 -8 162 171 -22 165 170 163 -11 0 161 -8 162 171 -15 165 170 -8 162 171 -22 165 170 163 -11 0 161 -8 162 171 -15 165 170 -8 162 171 -22 165 170 163 -11 0 161 -8 162 171 -15 165 170 -8 162 171 -22 165 170 163 -11 0 161 -8 162 171 -15 165 170 -8 162 171 -22 165 170 163 -11 0 161 -8 162 171 -14 165 -10 0 -209 165 170 -11 162 171 -57 165 170 -11 162 171 -57 165 170 -11 162 171 -57 165 170 -11 162 171 -57 165 170 -11 162 171 -23 165 -10 0 -525 165 -10 0 -525 165 -10 0 -525 165 -10 0 -525 165 -10 0 -525 165 -10 0 -525 165 -10 0 -525 165 -10 0 -525 165 -10 0 -525 165 -10 0 -525 165 -10 0 -525 165 -10 0 -525 165 -10 0 -525 165 -10 0 -525 165 -10 0 -525 165 -10 0 -525 165 -10 0 -525 165 -10 0 -525 165 -10 0 -525 165 -10 0 -525 165 -10 0 -525 165 -10 0 -525 165 -10 0 -525 165 -10 0)
    )
    (tilemap
      (solid #f)
      (z-pos -1)
      (width 535)
      (height 35)
      (tiles -15306 0 17 -2135 0 8 -1282 0)
    )
    (trampoline
      (z-pos 50)
      (x 10400)
      (y 1024)
    )
    (unstable_tile
      (z-pos 0)
      (x 832)
      (y 480)
    )
    (unstable_tile
      (z-pos 0)
      (x 864)
      (y 480)
    )
    (unstable_tile
      (z-pos 0)
      (x 896)
      (y 480)
    )
    (unstable_tile
      (z-pos 0)
      (x 928)
      (y 480)
    )
    (unstable_tile
      (z-pos 0)
      (x 800)
      (y 480)
    )
    (unstable_tile
      (z-pos 0)
      (x 800)
      (y 608)
    )
    (unstable_tile
      (z-pos 0)
      (x 768)
      (y 608)
    )
    (unstable_tile
      (z-pos 0)
      (x 832)
      (y 608)
    )
    (unstable_tile
      (z-pos 0)
      (x 864)
      (y 608)
    )
    (unstable_tile
      (z-pos 0)
      (x 896)
      (y 608)
    )
    (unstable_tile
      (z-pos 0)
      (x 928)
      (y 608)
    )
    (unstable_tile
      (z-pos 0)
      (x 960)
      (y 608)
    )
    (unstable_tile
      (z-pos 0)
      (x 992)
      (y 736)
    )
    (unstable_tile
      (z-pos 0)
      (x 960)
      (y 736)
    )
    (unstable_tile
      (z-pos 0)
      (x 928)
      (y 736)
    )
    (unstable_tile
      (z-pos 0)
      (x 896)
      (y 736)
    )
    (unstable_tile
      (z-pos 0)
      (x 864)
      (y 736)
    )
    (unstable_tile
      (z-pos 0)
      (x 832)
      (y 736)
    )
    (unstable_tile
      (z-pos 0)
      (x 800)
      (y 736)
    )
    (unstable_tile
      (z-pos 0)
      (x 736)
      (y 736)
    )
    (unstable_tile
      (z-pos 0)
      (x 768)
      (y 736)
    )
    (unstable_tile
      (z-pos 0)
      (x 1184)
      (y 864)
    )
    (unstable_tile
      (z-pos 0)
      (x 1216)
      (y 864)
    )
    (unstable_tile
      (z-pos 0)
      (x 1248)
      (y 864)
    )
    (unstable_tile
      (z-pos 0)
      (x 1280)
      (y 864)
    )
    (unstable_tile
      (z-pos 0)
      (x 1312)
      (y 864)
    )
    (unstable_tile
      (z-pos 0)
      (x 1344)
      (y 896)
    )
    (unstable_tile
      (z-pos 0)
      (x 1376)
      (y 896)
    )
    (unstable_tile
      (z-pos 0)
      (x 1408)
      (y 896)
    )
    (unstable_tile
      (z-pos 0)
      (x 1440)
      (y 896)
    )
    (unstable_tile
      (z-pos 0)
      (x 1472)
      (y 896)
    )
    (unstable_tile
      (z-pos 0)
      (x 1504)
      (y 928)
    )
    (unstable_tile
      (z-pos 0)
      (x 1536)
      (y 928)
    )
    (unstable_tile
      (z-pos 0)
      (x 1568)
      (y 928)
    )
    (unstable_tile
      (z-pos 0)
      (x 1600)
      (y 928)
    )
    (unstable_tile
      (z-pos 0)
      (x 1632)
      (y 928)
    )
    (unstable_tile
      (z-pos 0)
      (x 4992)
      (y 288)
    )
    (unstable_tile
      (z-pos 0)
      (x 4960)
      (y 288)
    )
    (unstable_tile
      (z-pos 0)
      (x 4928)
      (y 288)
    )
    (unstable_tile
      (z-pos 0)
      (x 4896)
      (y 288)
    )
    (unstable_tile
      (z-pos 0)
      (x 4864)
      (y 288)
    )
    (unstable_tile
      (z-pos 0)
      (x 4832)
      (y 288)
    )
    (unstable_tile
      (z-pos 0)
      (x 4768)
      (y 288)
    )
    (unstable_tile
      (z-pos 0)
      (x 4800)
      (y 288)
    )
    (unstable_tile
      (z-pos 0)
      (x 4736)
      (y 288)
    )
    (unstable_tile
      (z-pos 0)
      (x 4704)
      (y 288)
    )
    (unstable_tile
      (z-pos 0)
      (x 5696)
      (y 672)
    )
    (unstable_tile
      (z-pos 0)
      (x 5664)
      (y 672)
    )
    (unstable_tile
      (z-pos 0)
      (x 5632)
      (y 672)
    )
    (unstable_tile
      (z-pos 0)
      (x 5600)
      (y 672)
    )
    (unstable_tile
      (z-pos 0)
      (x 5568)
      (y 672)
    )
    (unstable_tile
      (z-pos 0)
      (x 5888)
      (y 640)
    )
    (unstable_tile
      (z-pos 0)
      (x 5920)
      (y 640)
    )
    (unstable_tile
      (z-pos 0)
      (x 5952)
      (y 640)
    )
    (unstable_tile
      (z-pos 0)
      (x 5984)
      (y 640)
    )
    (unstable_tile
      (z-pos 0)
      (x 6016)
      (y 640)
    )
    (unstable_tile
      (z-pos 0)
      (x 6208)
      (y 608)
    )
    (unstable_tile
      (z-pos 0)
      (x 6240)
      (y 608)
    )
    (unstable_tile
      (z-pos 0)
      (x 6272)
      (y 608)
    )
    (unstable_tile
      (z-pos 0)
      (x 6304)
      (y 608)
    )
    (unstable_tile
      (z-pos 0)
      (x 6336)
      (y 608)
    )
    (unstable_tile
      (z-pos 0)
      (x 6528)
      (y 640)
    )
    (unstable_tile
      (z-pos 0)
      (x 6592)
      (y 640)
    )
    (unstable_tile
      (z-pos 0)
      (x 6560)
      (y 640)
    )
    (unstable_tile
      (z-pos 0)
      (x 6624)
      (y 640)
    )
    (unstable_tile
      (z-pos 0)
      (x 6656)
      (y 640)
    )
    (unstable_tile
      (z-pos 0)
      (x 7744)
      (y 736)
    )
    (unstable_tile
      (z-pos 0)
      (x 7712)
      (y 736)
    )
    (unstable_tile
      (z-pos 0)
      (x 7680)
      (y 736)
    )
    (unstable_tile
      (z-pos 0)
      (x 7648)
      (y 736)
    )
    (unstable_tile
      (z-pos 0)
      (x 7616)
      (y 736)
    )
    (unstable_tile
      (z-pos 0)
      (x 8352)
      (y 864)
    )
    (unstable_tile
      (z-pos 0)
      (x 8384)
      (y 864)
    )
    (unstable_tile
      (z-pos 0)
      (x 8416)
      (y 864)
    )
    (unstable_tile
      (z-pos 0)
      (x 8448)
      (y 864)
    )
    (unstable_tile
      (z-pos 0)
      (x 8480)
      (y 864)
    )
    (unstable_tile
      (z-pos 0)
      (x 8512)
      (y 896)
    )
    (unstable_tile
      (z-pos 0)
      (x 8544)
      (y 896)
    )
    (unstable_tile
      (z-pos 0)
      (x 8576)
      (y 896)
    )
    (unstable_tile
      (z-pos 0)
      (x 8608)
      (y 896)
    )
    (unstable_tile
      (z-pos 0)
      (x 8640)
      (y 896)
    )
    (unstable_tile
      (z-pos 0)
      (x 8672)
      (y 928)
    )
    (unstable_tile
      (z-pos 0)
      (x 8704)
      (y 928)
    )
    (unstable_tile
      (z-pos 0)
      (x 8736)
      (y 928)
    )
    (unstable_tile
      (z-pos 0)
      (x 8768)
      (y 928)
    )
    (unstable_tile
      (z-pos 0)
      (x 8800)
      (y 928)
    )
    (unstable_tile
      (z-pos 0)
      (x 8832)
      (y 928)
    )
    (unstable_tile
      (z-pos 0)
      (x 8864)
      (y 928)
    )
    (unstable_tile
      (z-pos 0)
      (x 8896)
      (y 928)
    )
    (unstable_tile
      (z-pos 0)
      (x 8928)
      (y 928)
    )
    (unstable_tile
      (z-pos 0)
      (x 8960)
      (y 928)
    )
    (unstable_tile
      (z-pos 0)
      (x 8992)
      (y 928)
    )
    (unstable_tile
      (z-pos 0)
      (x 9024)
      (y 896)
    )
    (unstable_tile
      (z-pos 0)
      (x 9056)
      (y 896)
    )
    (unstable_tile
      (z-pos 0)
      (x 9088)
      (y 896)
    )
    (unstable_tile
      (z-pos 0)
      (x 9120)
      (y 896)
    )
    (unstable_tile
      (z-pos 0)
      (x 9152)
      (y 896)
    )
    (unstable_tile
      (z-pos 0)
      (x 9184)
      (y 864)
    )
    (unstable_tile
      (z-pos 0)
      (x 9216)
      (y 864)
    )
    (unstable_tile
      (z-pos 0)
      (x 9248)
      (y 864)
    )
    (unstable_tile
      (z-pos 0)
      (x 9280)
      (y 864)
    )
    (unstable_tile
      (z-pos 0)
      (x 9312)
      (y 864)
    )
    (unstable_tile
      (z-pos 0)
      (x 9504)
      (y 864)
    )
    (unstable_tile
      (z-pos 0)
      (x 9536)
      (y 864)
    )
    (unstable_tile
      (z-pos 0)
      (x 9568)
      (y 864)
    )
    (unstable_tile
      (z-pos 0)
      (x 9760)
      (y 864)
    )
    (unstable_tile
      (z-pos 0)
      (x 9792)
      (y 864)
    )
    (unstable_tile
      (z-pos 0)
      (x 9824)
      (y 864)
    )
    (unstable_tile
      (z-pos 0)
      (x 10016)
      (y 864)
    )
    (unstable_tile
      (z-pos 0)
      (x 10048)
      (y 864)
    )
    (unstable_tile
      (z-pos 0)
      (x 10080)
      (y 864)
    )
    (unstable_tile
      (z-pos 0)
      (x 9984)
      (y 864)
    )
    (unstable_tile
      (z-pos 0)
      (x 9856)
      (y 864)
    )
    (unstable_tile
      (z-pos 0)
      (x 9728)
      (y 864)
    )
    (unstable_tile
      (z-pos 0)
      (x 9600)
      (y 864)
    )
    (unstable_tile
      (z-pos 0)
      (x 9472)
      (y 864)
    )
    (unstable_tile
      (z-pos 0)
      (x 9344)
      (y 864)
    )
    (unstable_tile
      (z-pos 0)
      (x 10112)
      (y 864)
    )
    (unstable_tile
      (z-pos 0)
      (x 11712)
      (y 768)
    )
    (unstable_tile
      (z-pos 0)
      (x 11648)
      (y 768)
    )
    (unstable_tile
      (z-pos 0)
      (x 11680)
      (y 768)
    )
    (unstable_tile
      (z-pos 0)
      (x 11616)
      (y 768)
    )
    (unstable_tile
      (z-pos 0)
      (x 11584)
      (y 768)
    )
    (unstable_tile
      (z-pos 0)
      (x 12160)
      (y 640)
    )
    (unstable_tile
      (z-pos 0)
      (x 12192)
      (y 640)
    )
    (unstable_tile
      (z-pos 0)
      (x 12224)
      (y 640)
    )
    (unstable_tile
      (z-pos 0)
      (x 12256)
      (y 640)
    )
    (unstable_tile
      (z-pos 0)
      (x 12288)
      (y 640)
    )
    (unstable_tile
      (z-pos 0)
      (x 10144)
      (y 960)
    )
    (unstable_tile
      (z-pos 0)
      (x 10176)
      (y 960)
    )
    (unstable_tile
      (z-pos 0)
      (x 10208)
      (y 960)
    )
    (unstable_tile
      (z-pos 0)
      (x 15328)
      (y 768)
    )
    (unstable_tile
      (z-pos 0)
      (x 15360)
      (y 768)
    )
    (unstable_tile
      (z-pos 0)
      (x 15296)
      (y 768)
    )
    (unstable_tile
      (z-pos 0)
      (x 15264)
      (y 752)
    )
    (unstable_tile
      (z-pos 0)
      (x 15232)
      (y 736)
    )
    (unstable_tile
      (z-pos 0)
      (x 15200)
      (y 736)
    )
    (unstable_tile
      (z-pos 0)
      (x 15168)
      (y 736)
    )
  )
)
