(supertux-level
  (version 3)
  (name (_ "Walking Snowballs"))
  (author "Sophie \"Vaesea\" Ball")
  (license "CC-BY-SA 4.0 International")
  (target-time 70)
  (allow-item-pocket "inherit")
  (icon "")
  (icon-locked "")
  (statistics
    (enable-coins #t)
    (enable-secrets #t)
  )
  (sector
    (name "main")
    (ambient-light
      (color 1 1 1)
    )
    (background
      (scroll-offset-x 846)
      (scroll-offset-y 378)
      (color 1 1 1)
      (speed 0.25)
      (image-top "/images/background/arctis_top.jpg")
      (image "/images/background/arctis_top.jpg")
      (image-bottom "/images/background/arctis_top.jpg")
    )
    (bouncingsnowball
      (z-pos 50)
      (direction "left")
      (x 3840)
      (y 192)
      (glinting #f)
    )
    (camera
      (name "Camera")
      (mode "normal")
    )
    (decal
      (z-pos -100)
      (sprite "/images/decal/snow/exitbg.png")
      (x 12000)
      (y 256)
    )
    (decal
      (z-pos 100)
      (sprite "/images/decal/snow/exitfg.png")
      (x 12096)
      (y 256)
    )
    (firefly
      (z-pos 0)
      (x 7056)
      (y 288)
    )
    (flyingsnowball
      (z-pos 50)
      (x 2528)
      (y 416)
      (glinting #f)
    )
    (flyingsnowball
      (z-pos 50)
      (x 4032)
      (y 320)
      (glinting #f)
    )
    (mrbomb
      (z-pos 50)
      (direction "left")
      (x 1856)
      (y 704)
      (glinting #f)
    )
    (mrbomb
      (z-pos 50)
      (direction "left")
      (x 8448)
      (y 864)
      (glinting #f)
    )
    (mriceblock
      (z-pos 50)
      (direction "left")
      (x 3392)
      (y 768)
      (glinting #f)
    )
    (mriceblock
      (z-pos 50)
      (direction "left")
      (x 3520)
      (y 768)
      (glinting #f)
    )
    (mriceblock
      (z-pos 50)
      (direction "left")
      (x 10912)
      (y 736)
      (glinting #f)
    )
    (music
      (file "/music/antarctic/voc-daytime.music")
    )
    (particles-snow
    )
    (path
      (name "gen17669303322351328493904")
      (path
        (mode "oneshot")
        (adapt_speed #f)
        (node
          (x 5536)
          (y 320)
        )
        (node
          (x 5504)
          (y 320)
        )
      )
    )
    (path
      (name "gen17670149762613595994960")
      (path
        (mode "pingpong")
        (adapt_speed #f)
        (node
          (x 6752)
          (y 352)
          (time 5)
        )
        (node
          (x 6752)
          (y 672)
          (time 5)
        )
      )
    )
    (path
      (name "gen17670192842613596031680")
      (path
        (mode "pingpong")
        (adapt_speed #f)
        (node
          (x 10976)
          (y 736)
          (time 5)
        )
        (node
          (x 10976)
          (y 448)
          (time 5)
        )
      )
    )
    (platform
      (z-pos 50)
      (handle
        (scale_x 0)
        (scale_y 0)
        (offset_x 0)
        (offset_y 0)
      )
      (running #f)
      (name "platform")
      (path-ref "gen17669303322351328493904")
      (sprite "/images/objects/platforms/wood-fivetiles.sprite")
    )
    (platform
      (z-pos 50)
      (handle
        (scale_x 0)
        (scale_y 0)
        (offset_x 0)
        (offset_y 0)
      )
      (path-ref "gen17670149762613595994960")
      (sprite "/images/objects/platforms/icefloe_small.sprite")
    )
    (platform
      (z-pos 50)
      (handle
        (scale_x 0)
        (scale_y 0)
        (offset_x 0)
        (offset_y 0)
      )
      (running #f)
      (name "platform2")
      (path-ref "gen17670192842613596031680")
      (sprite "/images/objects/platforms/icefloe.sprite")
    )
    (pushbutton
      (z-pos -99)
      (script "platform2.start_moving();")
      (x 9440)
      (y 336)
    )
    (secretarea
      (width 224)
      (height 384)
      (x 0)
      (y 0)
    )
    (sequencetrigger
      (sequence "endsequence")
      (width 32)
      (height 448)
      (x 11584)
      (y 0)
    )
    (sequencetrigger
      (sequence "stoptux")
      (width 96)
      (height 480)
      (x 12288)
      (y 32)
    )
    (smartball
      (z-pos 50)
      (direction "left")
      (x 2208)
      (y 800)
      (glinting #f)
    )
    (smartball
      (z-pos 50)
      (direction "left")
      (x 1568)
      (y 800)
      (glinting #f)
    )
    (smartball
      (z-pos 50)
      (direction "left")
      (x 4352)
      (y 800)
      (glinting #f)
    )
    (smartball
      (z-pos 50)
      (direction "left")
      (x 4800)
      (y 576)
      (glinting #f)
    )
    (smartball
      (z-pos 50)
      (direction "left")
      (x 9632)
      (y 416)
      (glinting #f)
    )
    (smartball
      (z-pos 50)
      (direction "left")
      (x 10176)
      (y 736)
      (glinting #f)
    )
    (snowball
      (z-pos 50)
      (direction "left")
      (x 704)
      (y 736)
      (glinting #f)
    )
    (snowball
      (z-pos 50)
      (direction "left")
      (x 896)
      (y 736)
      (glinting #f)
    )
    (snowball
      (z-pos 50)
      (direction "left")
      (x 3648)
      (y 768)
      (glinting #f)
    )
    (snowball
      (z-pos 50)
      (direction "left")
      (x 5184)
      (y 608)
      (glinting #f)
    )
    (snowball
      (z-pos 50)
      (direction "left")
      (x 3360)
      (y 320)
      (glinting #f)
    )
    (snowball
      (z-pos 50)
      (direction "left")
      (x 9344)
      (y 800)
      (glinting #f)
    )
    (snowball
      (z-pos 50)
      (direction "left")
      (x 9280)
      (y 832)
      (glinting #f)
    )
    (snowball
      (z-pos 50)
      (direction "left")
      (x 9408)
      (y 800)
      (glinting #f)
    )
    (snowball
      (z-pos 50)
      (direction "left")
      (x 6656)
      (y 736)
      (glinting #f)
    )
    (spawnpoint
      (name "main")
      (x 64)
      (y 672)
    )
    (spiky
      (z-pos 50)
      (direction "left")
      (x 6784)
      (y 736)
      (glinting #f)
    )
    (spiky
      (z-pos 50)
      (direction "left")
      (x 7872)
      (y 736)
      (glinting #f)
    )
    (switch
      (z-pos 1)
      (script "platform.start_moving();")
      (x 5612)
      (y 544)
    )
    (tilemap
      (solid #f)
      (z-pos -100)
      (width 388)
      (height 35)
      (tiles -1652 0 122 123 -383 0 24 -2 0 124 125 -8 0 106 107 108 -182 0 122 123 -64 0 130 -126 0 124 125 -6 0 24 0 109 110 111 -3 0 25 -2 0 24 -99 0 122 123 -74 0 124 125 -64 0 129 -126 0 124 125 -117 0 124 125 -74 0 124 125 -55 0 122 123 -7 0 129 -111 0 25 -3 0 24 -10 0 124 125 -117 0 124 125 -74 0 124 125 -55 0 124 125 -7 0 129 -120 0 25 -5 0 124 125 -117 0 124 125 -74 0 124 125 -55 0 124 125 -7 0 129 -9 0 122 123 -18 0 106 107 108 -173 0 25 -3 0 24 -32 0 25 0 24 124 125 -72 0 25 0 124 125 -55 0 124 125 -7 0 129 -5 0 122 123 -2 0 124 125 -16 0 24 0 109 110 111 -151 0 122 123 -193 0 124 125 -7 0 129 -5 0 124 125 -2 0 124 125 -172 0 124 125 -193 0 124 125 -7 0 129 -2 0 106 107 108 124 125 -2 0 124 125 -161 0 122 123 -9 0 124 125 -69 0 24 -71 0 7 -3 8 9 -47 0 124 125 -4 8 0 24 0 129 -2 0 109 110 111 124 125 25 0 124 125 0 24 -11 0 25 -147 0 124 125 -9 0 124 125 -6 0 122 123 -21 0 25 -199 0 123 -145 0 124 125 -9 0 124 125 -6 0 124 125 -221 0 125 -145 0 124 125 -9 0 124 125 -6 0 124 125 -9 0 48 -62 0 122 123 -25 0 24 -40 0 7 -3 8 9 -3 0 122 123 -71 0 125 -23 0 122 123 -120 0 124 125 -9 0 124 125 -6 0 124 125 -9 0 48 -23 0 122 123 -37 0 124 125 -74 0 124 125 -71 0 125 -23 0 124 125 -118 0 24 0 124 125 -9 0 124 125 -6 0 124 125 -9 0 48 -23 0 124 125 -37 0 124 125 -74 0 124 125 -11 0 122 123 -58 0 125 -23 0 124 125 -83 0 122 123 -17 0 122 123 -24 0 25 -2 0 124 125 0 24 -4 0 124 125 -3 0 106 107 108 -27 0 124 125 -37 0 124 125 -74 0 124 125 24 -10 0 124 125 -58 0 125 -23 0 124 125 -69 0 122 123 -12 0 124 125 -17 0 124 125 -14 0 28 -20 0 124 125 -3 0 109 110 111 0 24 -25 0 124 125 -37 0 124 125 -46 0 122 123 -39 0 124 125 -58 0 125 -23 0 124 125 -61 0 106 107 108 -5 0 124 125 -12 0 124 125 -17 0 124 125 -2 0 25 -67 0 124 125 -37 0 124 125 -46 0 124 125 -39 0 124 125 -58 0 125 -2 0 25 -9 0 106 107 108 -8 0 124 125 -58 0 25 -2 0 109 110 111 -5 0 124 125 -12 0 124 125 -17 0 124 125 -68 0 24 0 124 125 -14 0 106 107 108 -18 0 25 0 124 125 0 24 -40 0 122 123 -2 0 124 125 -37 0 24 0 124 125 -2 0 25 -11 0 106 107 108 -51 0 24 -2 0 109 110 111 -3 0 25 -4 0 124 125 -4 0 24 -62 0 24 0 124 125 0 25 -10 0 124 125 -17 0 124 125 -13 0 28 -66 0 24 -5 0 109 110 111 -40 0 122 123 -22 0 124 125 -2 0 124 125 -15 0 122 123 -2 0 106 107 108 -3 0 25 -3 0 24 -19 0 24 25 -4 0 109 110 111 -2 0 24 -145 0 24 0 124 125 -17 0 124 125 -4 0 106 107 108 -122 0 124 125 -22 0 124 125 -2 0 124 125 -15 0 124 125 -2 0 109 110 111 -197 0 24 -7 0 124 125 0 25 -2 0 109 110 111 -116 0 24 -5 0 124 125 -22 0 124 125 -2 0 124 125 -5 0 24 -9 0 124 125 -341 0 124 125 -19 0 106 107 108 124 125 -2 0 124 125 -12 0 24 -345 0 124 125 0 25 -17 0 109 110 111 124 125 25 0 124 125 -1675 0 28 -1139 0)
    )
    (tilemap
      (solid #f)
      (z-pos 100)
      (width 388)
      (height 35)
      (tiles -2303 0 130 -387 0 129 -387 0 129 -387 0 129 -387 0 129 -387 0 129 -387 0 129 -387 0 129 -387 0 129 -8172 0)
    )
    (tilemap
      (solid #t)
      (z-pos 0)
      (width 388)
      (height 35)
      (tiles -83 0 10 11 19 -13 11 19 -12 11 19 -5 11 19 -2 11 12 -349 0 16 -37 17 18 -2 0 -2 44 -359 0 -2 44 -24 0 44 -2 0 44 -383 0 44 -4 0 44 -388 0 44 -355 0 7 -2 8 9 -29 0 44 -352 0 -2 83 13 -2 14 15 -2 83 -4 0 7 -14 8 9 -362 0 16 -2 17 18 -6 0 13 -14 14 15 -8 0 44 -48 0 83 78 83 78 83 -207 0 128 83 -78 0 7 -6 8 2913 2914 -14 0 10 11 19 -8 11 19 -3 11 12 -349 0 13 -6 14 2915 2916 2917 2918 -8 8 2913 2914 -2 0 10 -6 11 19 -7 11 12 -9 0 44 -339 0 10 -7 11 1835 2919 2920 -8 14 2915 2916 2917 2918 22 -13 11 19 12 -50 0 7 -12 8 9 -29 0 7 -10 8 9 -66 0 7 -3 8 9 -90 0 -7 8 9 -75 0 10 -6 11 19 -4 11 19 -7 11 1835 2919 2920 23 -14 11 12 -9 0 44 -40 0 13 -12 14 15 -29 0 13 -10 14 15 -66 0 13 -3 14 15 -90 0 -7 14 15 -75 0 10 -3 11 19 -13 11 19 -9 11 19 -6 11 19 -2 11 12 -50 0 16 -3 17 31 -6 11 19 11 21 8 9 -25 0 44 0 10 11 19 -4 11 19 -3 11 12 -66 0 16 -3 17 18 -90 0 -7 17 18 -75 0 10 -4 11 115 116 -16 11 19 -14 11 12 -10 0 44 -43 0 10 -5 11 19 -2 11 20 14 15 -27 0 16 -3 17 31 -6 11 21 -2 8 9 -70 0 44 0 44 0 44 -46 0 7 -2 8 -4 44 -30 8 -83 0 10 11 19 -2 11 117 118 -7 11 19 -4 11 19 -10 11 30 -7 17 18 -54 0 10 19 -9 11 21 8 9 -22 0 44 -6 0 10 -6 11 20 -2 14 15 -70 0 13 -3 14 15 -46 0 13 -36 14 -83 0 10 -29 11 12 -18 0 44 -13 0 -4 83 -26 0 10 -9 11 19 20 14 15 -29 0 10 -8 11 19 12 -70 0 16 -3 17 18 -46 0 10 19 -7 11 19 -27 11 -83 0 16 -7 17 2925 2926 -20 11 12 -62 0 10 -5 11 19 -6 11 21 8 9 -21 0 44 -5 0 10 -4 11 19 -4 11 21 -2 8 9 -33 0 7 2913 2914 -38 0 44 0 44 0 44 -39 0 10 -23 11 19 -12 11 -92 0 2928 -10 17 2925 2926 -4 11 19 -3 11 12 -62 0 10 -8 11 19 -3 11 20 14 15 -27 0 10 -9 11 20 -2 14 15 -33 0 13 2915 2916 3139 3140 -36 0 13 -3 14 15 -39 0 10 -5 11 19 -7 11 19 -9 11 115 116 -11 11 -104 0 2928 -8 17 18 -30 0 7 -6 8 9 -24 0 10 -14 11 21 8 9 -18 0 44 -6 0 10 19 -11 11 12 -33 0 10 11 1835 3143 3144 1838 -35 0 16 -3 17 18 -39 0 10 -14 11 19 -8 11 117 118 -3 11 19 -7 11 -144 0 13 -6 14 113 -11 8 9 -12 0 10 -2 11 19 -11 11 20 14 15 -25 0 10 -9 11 19 -2 11 21 -2 8 9 -30 0 10 11 19 11 3147 1840 1838 -41 0 7 -3 8 9 -32 0 10 -31 11 19 -4 11 -142 0 27 28 10 -6 11 20 -11 14 113 -12 8 22 -5 11 19 -10 11 21 8 9 -22 0 102 10 -5 11 19 -4 11 19 11 20 -2 14 15 -30 0 10 -4 11 1842 1840 1838 -40 0 13 -3 14 15 -19 0 -4 83 -9 0 10 -2 11 19 -7 11 19 -8 11 19 -16 11 -76 0 2944 -54 0 7 8 9 -10 0 10 -2 11 19 -15 11 20 -12 14 23 -14 11 19 11 20 14 15 -23 0 10 -8 11 19 -6 11 12 -30 0 10 19 -4 11 1842 1840 1838 -39 0 16 -3 17 18 -32 0 10 -3 11 19 -21 11 19 -10 11 -7 8 9 -75 0 7 -6 8 2913 2914 -39 0 13 14 15 -9 0 7 22 -11 11 19 -20 11 19 -9 11 19 -7 11 21 -6 8 2913 2914 -15 0 10 -12 11 19 -2 11 21 -7 8 2913 2914 -21 0 10 -6 11 1842 1840 1838 -49 0 7 -7 8 2913 2914 -16 0 10 -36 11 -7 14 113 -23 8 9 -23 0 -2 83 102 -2 83 -23 0 13 -6 14 2915 2916 2917 2918 -8 8 2913 2914 -27 0 16 17 18 -6 0 27 -2 28 13 23 -7 11 19 -7 11 -2 19 -28 11 19 -4 11 20 -6 14 2915 2916 2917 2918 -13 8 22 -2 11 19 -12 11 20 -7 14 2915 2916 2917 2918 9 -18 0 10 -5 11 19 11 1842 1840 1838 -34 0 2909 2910 -6 8 9 -5 0 13 -7 14 2915 2916 2917 2918 -14 8 22 -8 11 19 -7 11 19 -19 11 116 -6 11 20 -23 14 15 -51 0 16 2925 2926 -5 11 1835 2919 2920 -8 14 2915 2916 2917 2918 -8 8 2913 2914 -27 0 10 115 116 -9 11 19 -14 11 19 -16 11 19 -15 11 1835 2919 2920 -13 14 23 -9 11 19 -14 11 1835 2919 2920 15 -18 0 10 -8 11 1842 1840 1838 -29 0 2909 2910 2921 2922 2911 2912 -6 14 15 -5 0 10 19 -7 11 1835 2919 2920 -14 14 23 -10 11 19 -22 11 19 -2 11 118 -28 11 2929 2930 18 -4 0 27 -3 28 29 -4 0 -5 44 -15 0 -5 44 -4 0 27 -3 28 29 -6 0 2928 2925 2926 -9 11 19 -5 11 1835 2919 2920 -8 14 2915 2916 2917 2918 -3 8 9 -5 0 7 -9 8 9 -5 0 10 117 118 -20 11 19 -17 11 19 -11 11 19 11 19 -31 11 19 11 19 -8 11 19 -5 11 12 -5 0 7 2913 2914 -10 0 10 -7 11 19 11 1842 1840 3149 -13 0 2909 2910 9 -8 0 2909 2910 2921 2922 2911 2912 2923 2924 1834 -7 11 12 -5 0 10 -11 11 19 -40 11 19 -22 11 19 -8 11 19 -4 11 2929 2930 2931 -6 0 211 -8 0 27 -3 28 29 -15 0 27 -3 28 29 -17 0 2928 2933 -26 11 1835 2919 2920 -3 14 15 -5 0 13 -9 14 15 -4 0 7 22 -5 11 19 -4 11 19 -14 11 19 -22 11 19 -14 11 19 -11 11 19 -8 11 19 -6 11 19 -11 11 12 -5 0 13 2915 2916 1832 1827 -8 0 10 -2 11 19 -7 11 1842 3151 3152 -10 0 1826 1829 2911 2912 15 -5 0 7 2921 2922 2911 2912 2923 2924 1834 -11 11 12 -5 0 10 -5 11 19 -11 11 19 -7 11 19 -5 11 19 -9 11 19 -23 11 19 -22 11 2935 2931 -8 0 212 -17 0 27 -5 28 29 -27 0 2934 2937 -4 11 19 -4 11 19 -21 11 12 -5 0 10 -7 11 19 11 12 -4 0 13 23 -25 11 19 -25 11 19 -7 11 19 -5 11 19 -21 11 19 -14 11 19 12 -5 0 10 11 1835 1836 1831 2917 2918 -6 8 22 -11 11 3155 3156 2917 2918 -6 8 2921 2922 1830 1833 1834 19 12 -5 0 13 2923 2924 1834 -12 11 19 -2 11 12 -5 0 10 -6 11 19 -9 11 19 -25 11 19 -14 11 19 -29 11 2940 2936 -6 0 27 28 29 213 -52 0 2938 -27 11 19 -3 11 12 -5 0 10 19 -8 11 12 -4 0 10 -16 11 19 -3 11 19 -15 11 19 -26 11 19 -11 11 19 -21 11 19 -6 11 12 -5 0 10 -3 11 1835 2919 2920 -6 14 23 -4 11 19 -7 11 1835 2919 2920 -6 14 2923 2924 1834 -3 11 12 -5 0 10 19 -6 11 19 -10 11 12 -5 0 10 -22 11 19 -7 11 19 -37 11 19 -18 11 2941 -4 0 105 27 28 29 -55 0 2939 31 -15 11 -2 19 -6 11 19 -6 11 12 -5 0 10 -9 11 12 -4 0 10 -4 11 19 -26 11 19 -11 11 19 -2 11 19 -8 11 19 -15 11 19 -10 11 19 -21 11 12 -5 0 10 19 -14 11 19 -6 11 19 -10 11 19 -6 11 12 -5 0 10 -12 11 19 -5 11 12 -5 0 10 -2 11 19 -35 11 19 -8 11 19 -31 11 19 -6 11 30 2942 -5 0 211 -58 0 10 -30 11 12 -5 0 10 -4 11 19 -4 11 12 -4 0 10 -9 11 19 -43 11 19 -6 11 19 -11 11 19 -16 11 19 -4 11 19 -5 11 19 -3 11 12 -5 0 10 -40 11 12 -5 0 10 -5 11 19 -12 11 12 -5 0 10 -13 11 19 -17 11 19 -22 11 19 -31 11 12 -6 0 212 -58 0 10 -13 11 19 -16 11 12 -5 0 10 -9 11 12 -4 0 10 -13 11 19 -4 11 19 -15 11 19 -43 11 19 -25 11 12 -5 0 10 -5 11 19 -3 11 19 -10 11 19 -6 11 19 -10 11 19 11 12 -5 0 10 -3 11 19 -13 11 19 12 -5 0 10 -12 11 19 -6 11 19 -7 11 19 -20 11 19 -14 11 19 -22 11 12 -5 28 29 213 -58 0 10 -28 11 19 11 12 -5 0 10 -9 11 12 -4 0 10 -23 11 19 -4 11 19 -9 11 19 -26 11 19 -2 11 19 -16 11 19 -4 11 19 -8 11 19 -4 11 12 -5 0 10 -29 11 19 -10 11 12 -5 0 10 -18 11 12 -5 0 10 -2 11 19 -5 11 19 -27 11 19 -7 11 19 -28 11 19 -12 11 12 -65 0 10 -6 11 19 -23 11 12 -5 0 10 -2 11 19 -6 11 12 -4 0 10 -47 11 19 -32 11 19 -23 11 12 -5 0 10 -14 11 19 -25 11 12 -5 0 10 -2 11 19 -6 11 19 -8 11 12 -5 0 10 -17 11 19 -35 11 19 -27 11 19 -4 11 12 -65 0 10 -7 11 19 -16 11 19 -5 11 12 -5 0 10 -8 11 19 12 -4 0 10 11 19 -9 11 19 -2 11 19 -11 11 19 -16 11 19 -13 11 19 -4 11 19 -11 11 19 -20 11 19 -8 11 12 -5 0 10 -2 11 19 -14 11 19 -6 11 19 -10 11 19 -4 11 12 -5 0 10 -14 11 19 -3 11 12 -5 0 10 -7 11 19 -54 11)
    )
    (tilemap
      (solid #f)
      (speed-x 0.5)
      (speed-y 0.5)
      (z-pos -250)
      (width 388)
      (height 35)
      (tiles -4277 0 149 -8 150 151 -10 0 149 -8 150 151 -19 0 149 -8 150 151 -10 0 149 -8 150 151 -19 0 149 -8 150 151 -10 0 149 -8 150 151 -19 0 149 -8 150 151 -10 0 149 -8 150 151 -19 0 149 -8 150 151 -10 0 149 -8 150 151 -19 0 149 -8 150 151 -10 0 149 -8 150 151 -19 0 149 -8 150 151 -10 0 149 -8 150 151 -19 0 149 -8 150 151 -10 0 149 -8 150 151 -14 0 149 159 -8 153 154 -9 0 149 159 -8 153 154 -18 0 149 159 -8 153 154 -9 0 149 159 -8 153 154 -18 0 149 159 -8 153 154 -9 0 149 159 -8 153 154 -18 0 149 159 -8 153 154 -9 0 149 159 -8 153 154 -18 0 149 159 -8 153 154 -9 0 149 159 -8 153 154 -18 0 149 159 -8 153 154 -9 0 149 159 -8 153 154 -18 0 149 159 -8 153 154 -9 0 149 159 -8 153 154 -18 0 149 159 -8 153 154 -9 0 149 159 -8 153 154 -6 0 -8 150 159 -9 153 158 151 -8 0 152 -9 153 158 151 -8 0 149 -8 150 159 -9 153 158 151 -8 0 152 -9 153 158 151 -8 0 149 -8 150 159 -9 153 158 151 -8 0 152 -9 153 158 151 -8 0 149 -8 150 159 -9 153 158 151 -8 0 152 -9 153 158 151 -8 0 149 -8 150 159 -9 153 158 151 -8 0 152 -9 153 158 151 -8 0 149 -8 150 159 -9 153 158 151 -8 0 152 -9 153 158 151 -8 0 149 -8 150 159 -9 153 158 151 -8 0 152 -9 153 158 151 -8 0 149 -8 150 159 -9 153 158 151 -8 0 152 -9 153 158 151 -5 0 -19 153 158 -8 150 159 -10 153 158 -8 150 159 -19 153 158 -8 150 159 -10 153 158 -8 150 159 -19 153 158 -8 150 159 -10 153 158 -8 150 159 -19 153 158 -8 150 159 -10 153 158 -8 150 159 -19 153 158 -8 150 159 -10 153 158 -8 150 159 -19 153 158 -8 150 159 -10 153 158 -8 150 159 -19 153 158 -8 150 159 -10 153 158 -8 150 159 -19 153 158 -8 150 159 -10 153 158 -5 150 -7760 153)
    )
    (tilemap
      (solid #f)
      (speed-x 0.25)
      (speed-y 0.25)
      (z-pos -275)
      (width 388)
      (height 35)
      (tiles -2333 0 161 -3 162 163 -5 0 161 -3 162 163 -10 0 161 -3 162 163 -5 0 161 -3 162 163 -10 0 161 -3 162 163 -5 0 161 -3 162 163 -10 0 161 -3 162 163 -5 0 161 -3 162 163 -10 0 161 -3 162 163 -5 0 161 -3 162 163 -10 0 161 -3 162 163 -5 0 161 -3 162 163 -10 0 161 -3 162 163 -5 0 161 -3 162 163 -10 0 161 -3 162 163 -5 0 161 -3 162 163 -10 0 161 -3 162 163 -5 0 161 -3 162 163 -10 0 161 -3 162 163 -5 0 161 -3 162 163 -10 0 161 -3 162 163 -5 0 161 -3 162 163 -10 0 161 -3 162 163 -5 0 161 -3 162 163 -10 0 161 -3 162 163 -5 0 161 -3 162 163 -10 0 161 -3 162 163 -5 0 161 -3 162 163 -10 0 161 -3 162 163 -5 0 161 -3 162 163 -10 0 161 -3 162 163 -7 0 161 171 -3 165 166 -4 0 161 171 -3 165 166 -9 0 161 171 -3 165 166 -4 0 161 171 -3 165 166 -9 0 161 171 -3 165 166 -4 0 161 171 -3 165 166 -9 0 161 171 -3 165 166 -4 0 161 171 -3 165 166 -9 0 161 171 -3 165 166 -4 0 161 171 -3 165 166 -9 0 161 171 -3 165 166 -4 0 161 171 -3 165 166 -9 0 161 171 -3 165 166 -4 0 161 171 -3 165 166 -9 0 161 171 -3 165 166 -4 0 161 171 -3 165 166 -9 0 161 171 -3 165 166 -4 0 161 171 -3 165 166 -9 0 161 171 -3 165 166 -4 0 161 171 -3 165 166 -9 0 161 171 -3 165 166 -4 0 161 171 -3 165 166 -9 0 161 171 -3 165 166 -4 0 161 171 -3 165 166 -9 0 161 171 -3 165 166 -4 0 161 171 -3 165 166 -9 0 161 171 -3 165 166 -4 0 161 171 -3 165 166 -9 0 161 171 -3 165 166 -4 0 161 171 -3 165 166 -9 0 161 171 -3 165 166 -3 0 -4 162 171 -4 165 170 163 -3 0 164 -4 165 170 163 -3 0 161 -4 162 171 -4 165 170 163 -3 0 164 -4 165 170 163 -3 0 161 -4 162 171 -4 165 170 163 -3 0 164 -4 165 170 163 -3 0 161 -4 162 171 -4 165 170 163 -3 0 164 -4 165 170 163 -3 0 161 -4 162 171 -4 165 170 163 -3 0 164 -4 165 170 163 -3 0 161 -4 162 171 -4 165 170 163 -3 0 164 -4 165 170 163 -3 0 161 -4 162 171 -4 165 170 163 -3 0 164 -4 165 170 163 -3 0 161 -4 162 171 -4 165 170 163 -3 0 164 -4 165 170 163 -3 0 161 -4 162 171 -4 165 170 163 -3 0 164 -4 165 170 163 -3 0 161 -4 162 171 -4 165 170 163 -3 0 164 -4 165 170 163 -3 0 161 -4 162 171 -4 165 170 163 -3 0 164 -4 165 170 163 -3 0 161 -4 162 171 -4 165 170 163 -3 0 164 -4 165 170 163 -3 0 161 -4 162 171 -4 165 170 163 -3 0 164 -4 165 170 163 -3 0 161 -4 162 171 -4 165 170 163 -3 0 164 -4 165 170 163 -3 0 161 -4 162 171 -4 165 170 163 -3 0 164 -4 165 170 163 -3 0 161 -4 162 171 -4 165 170 163 -2 0 -10 165 170 -3 162 171 -5 165 170 -3 162 171 -10 165 170 -3 162 171 -5 165 170 -3 162 171 -10 165 170 -3 162 171 -5 165 170 -3 162 171 -10 165 170 -3 162 171 -5 165 170 -3 162 171 -10 165 170 -3 162 171 -5 165 170 -3 162 171 -10 165 170 -3 162 171 -5 165 170 -3 162 171 -10 165 170 -3 162 171 -5 165 170 -3 162 171 -10 165 170 -3 162 171 -5 165 170 -3 162 171 -10 165 170 -3 162 171 -5 165 170 -3 162 171 -10 165 170 -3 162 171 -5 165 170 -3 162 171 -10 165 170 -3 162 171 -5 165 170 -3 162 171 -10 165 170 -3 162 171 -5 165 170 -3 162 171 -10 165 170 -3 162 171 -5 165 170 -3 162 171 -10 165 170 -3 162 171 -5 165 170 -3 162 171 -10 165 170 -3 162 171 -5 165 170 -3 162 171 -10 165 170 -2 162 -9700 165)
    )
    (trampoline
      (z-pos 50)
      (x 5504)
      (y 320)
    )
    (trampoline
      (z-pos 50)
      (x 6976)
      (y 736)
    )
  )
)
