(supertux-level
  (version 3)
  (name (_ "A Yeti Is Nearby..."))
  (author "Sophie \"Vaesea\" Ball")
  (license "CC-BY-SA 4.0 International")
  (allow-item-pocket "inherit")
  (icon "")
  (icon-locked "")
  (statistics
    (enable-coins #t)
    (enable-secrets #t)
  )
  (sector
    (name "main")
    (init-script "Yeti.set_action(\"stand-right\");
Tux.deactivate();
Tux.set_dir(true);
Tux.walk(200);
Text.set_text(\"Tux didn't find Penny or Nolok in the castle, so he was sadly walking outside...\");
Text.set_font(\"normal\");
Text.fade_in(1);
wait(3);
Text.fade_out(1);")
    (ambient-light
      (color 1 1 1)
    )
    (background
      (color 1 1 1)
      (speed 0.5)
      (image "images/background/arctis2.png")
    )
    (camera
      (name "Camera")
      (mode "normal")
    )
    (music
      (file "/music/voc-dark.music")
    )
    (particles-snow
    )
    (scriptedobject
      (z-pos 50)
      (name "Yeti")
      (sprite "/images/creatures/yeti/yeti.sprite")
      (x 1504)
      (y 288)
    )
    (scripttrigger
      (oneshot #t)
      (script "Tux.do_jump(-512);")
      (button #f)
      (width 32)
      (height 32)
      (x 1216)
      (y 896)
    )
    (scripttrigger
      (oneshot #t)
      (script "Yeti.set_action(\"walk-right\");
play_sound(\"sounds/yeti_gna.wav\");
Yeti.set_velocity(350, 0);")
      (button #f)
      (width 32)
      (height 32)
      (x 2400)
      (y 960)
    )
    (scripttrigger
      (oneshot #t)
      (script "Tux.walk(50);
Tux.set_dir(false);
Tux.do_jump(-128);")
      (button #f)
      (width 32)
      (height 32)
      (x 2656)
      (y 960)
    )
    (scripttrigger
      (oneshot #t)
      (script "Tux.walk(320);
Tux.set_dir(true);
Effect.fade_out(2);
wait(3);
Level.finish(true);")
      (button #f)
      (width 32)
      (height 32)
      (x 2688)
      (y 960)
    )
    (scripttrigger
      (script "Tux.do_jump(-320);")
      (button #f)
      (width 32)
      (height 32)
      (x 512)
      (y 928)
    )
    (spawnpoint
      (name "main")
      (x 64)
      (y 896)
    )
    (tilemap
      (solid #f)
      (z-pos -100)
      (width 150)
      (height 35)
      (tiles -3782 0 122 123 -14 0 122 123 -26 0 122 123 -63 0 122 123 -10 0 122 123 -13 0 122 123 -12 0 124 125 -14 0 124 125 -22 0 122 123 -2 0 124 125 -2 0 122 123 -37 0 122 123 -20 0 124 125 -10 0 124 125 -13 0 124 125 -9 0 106 107 108 124 125 -14 0 124 125 -4 0 106 107 108 -11 0 122 123 -2 0 124 125 -2 0 124 125 -2 0 124 125 -2 0 122 123 -11 0 122 123 -20 0 124 125 -20 0 124 125 -10 0 124 125 -2 0 106 107 108 -8 0 124 125 -8 0 24 109 110 111 124 125 0 25 -10 0 24 0 124 125 -3 0 24 109 110 111 -11 0 124 125 -2 0 124 125 -2 0 124 125 -2 0 124 125 -2 0 124 125 -11 0 124 125 -20 0 124 125 -20 0 124 125 -7 0 24 -2 0 124 125 -2 0 109 110 111 0 25 -3 0 24 -2 0 124 125 -2 0 24 -45 0 124 125 -2 0 124 125 -2 0 124 125 -2 0 124 125 -2 0 124 125 -2 0 106 107 108 -6 0 124 125 -12 0 106 107 108 -5 0 124 125 -20 0 124 125 -2 0 106 107 108 -65 0 24 0 25 -2 0 124 125 0 24 124 125 -2 0 124 125 -2 0 124 125 24 0 124 125 -2 0 109 110 111 0 25 -3 0 24 124 125 -2 0 25 -4 0 24 -4 0 109 110 111 -3 0 24 0 124 125 -6 0 25 -5 0 24 -2 0 25 -4 0 124 125 -2 0 109 110 111 0 24 -600 0)
    )
    (tilemap
      (solid #f)
      (z-pos 100)
      (width 150)
      (height 35)
      (tiles -5250 0)
    )
    (tilemap
      (solid #t)
      (z-pos 0)
      (width 150)
      (height 35)
      (tiles -1689 0 2909 2910 -12 8 9 -133 0 1826 1829 2911 2912 -12 14 15 -131 0 1826 1829 1830 1833 1834 -12 11 19 12 -116 0 7 -12 8 2921 2922 1830 1833 1834 2929 2930 -13 17 18 -116 0 13 -12 14 2923 2924 1834 2929 2930 2931 -131 0 10 -6 11 19 -6 11 2929 2930 2931 -133 0 16 -13 17 2931 -1641 0 2909 2910 -10 8 9 -4 0 7 -12 8 2913 2914 -92 0 -24 8 2921 2922 2911 2912 -10 14 15 -4 0 13 -12 14 2915 2916 2917 2918 2913 2914 -88 0 -24 14 2923 2924 1834 -11 11 12 -4 0 10 -13 11 1835 2919 2920 2915 2916 2917 2918 -86 8 -34 11 19 -3 11 12 -4 0 10 -9 11 19 -7 11 1835 2919 2920 -86 14 -38 11 12 -4 0 10 -59 11 19 -30 11 115 116 -13 11 19 -38 11 12 -4 0 10 -36 11 19 -53 11 117 118 -8 11 19 -18 11 19 -24 11 12 -4 0 10 -81 11 19 -22 11 19 11)
    )
  )
)
