(supertux-level
  (version 3)
  (name (_ "Bouncy Coils"))
  (author "Christoph Sommer")
  (license "GPL 2+ / CC-by-sa 3.0")
  (allow-item-pocket "inherit")
  (icon "")
  (icon-locked "")
  (statistics
    (enable-coins #t)
    (enable-secrets #t)
  )
  (sector
    (name "main")
    (ambient-light
      (color 1 1 1)
    )
    (background
      (scroll-offset-y -128)
      (color 1 1 1)
      (speed 0.7)
      (image-top "images/background/BlueRock_Forest/blue-top.jpg")
      (image "images/background/BlueRock_Forest/blue-middle.jpg")
      (image-bottom "images/background/BlueRock_Forest/blue-bottom.jpg")
    )
    (bonusblock
      (type "purple")
      (z-pos 51)
      (x 3072)
      (y 224)
    )
    (camera
      (name "Camera")
      (mode "normal")
    )
    (firefly
      (z-pos 0)
      (x 4416)
      (y 416)
    )
    (fish-jumping
      (z-pos 50)
      (x 1797)
      (y 650)
      (glinting #f)
    )
    (fish-jumping
      (z-pos 50)
      (x 2697)
      (y 670)
      (glinting #f)
    )
    (fish-jumping
      (z-pos 50)
      (x 9042.092)
      (y 674.4388)
      (glinting #f)
    )
    (fish-jumping
      (z-pos 50)
      (x 9234.092)
      (y 676.4388)
      (glinting #f)
    )
    (fish-jumping
      (z-pos 50)
      (x 6968.067)
      (y 676.5808)
      (glinting #f)
    )
    (fish-jumping
      (z-pos 50)
      (x 5568)
      (y 640)
      (glinting #f)
    )
    (haywire
      (z-pos 50)
      (direction "left")
      (x 3237)
      (y 744)
      (glinting #f)
    )
    (igel
      (z-pos 50)
      (direction "left")
      (x 2080)
      (y 352)
      (glinting #f)
    )
    (igel
      (z-pos 50)
      (direction "left")
      (x 5058.1)
      (y 614.1)
      (glinting #f)
    )
    (igel
      (z-pos 50)
      (direction "left")
      (x 6914.1)
      (y 390.1)
      (glinting #f)
    )
    (mrtree
      (z-pos 50)
      (direction "left")
      (x 4288)
      (y 606)
      (glinting #f)
    )
    (mrtree
      (z-pos 50)
      (direction "left")
      (x 6208)
      (y 702)
      (glinting #f)
    )
    (music
      (file "music/forest.music")
    )
    (path
      (name "gen1772929264104989801024224")
      (path
        (adapt_speed #f)
        (node
          (x 3072)
          (y 384)
        )
      )
    )
    (secretarea
      (width 77)
      (height 144)
      (x 9)
      (y 244)
    )
    (secretarea
      (fade-tilemap "secret1")
      (width 220)
      (height 124)
      (x 3104)
      (y 416)
    )
    (sequencetrigger
      (sequence "stoptux")
      (width 40)
      (height 104)
      (x 9812)
      (y 596)
    )
    (sequencetrigger
      (sequence "endsequence")
      (width 444)
      (height 64)
      (x 9408)
      (y 608)
    )
    (spawnpoint
      (name "main")
      (x 144)
      (y 515)
    )
    (tilemap
      (solid #f)
      (z-pos -100)
      (width 310)
      (height 30)
      (tiles -2736 0 1240 1241 -99 0 1240 1241 -67 0 1604 1605 -35 0 1287 1288 -93 0 1287 1288 -5 0 1243 1244 1245 1246 -97 0 1243 1244 1245 1246 -66 0 1606 1607 -35 0 1289 1290 -2 0 1240 1241 -61 0 1240 1241 -26 0 1289 1290 -5 0 1247 1248 1249 1250 -16 0 1240 1241 -79 0 1247 1248 1249 1250 -82 0 1240 1241 -19 0 1291 1292 0 1243 1244 1245 1246 -59 0 1243 1244 1245 1246 -25 0 1291 1292 -5 0 1251 1252 1253 1254 -15 0 1243 1244 1245 1246 -78 0 1251 1252 1253 1254 -12 0 211 212 -4 0 212 211 -61 0 1243 1244 1245 1246 -18 0 1293 1294 0 1247 1248 1249 1250 1287 1288 0 1240 1241 -29 0 1240 1241 -18 0 322 -4 0 1247 1248 1249 1250 -25 0 1293 1294 -5 0 1255 1256 1257 1258 -15 0 1247 1248 1249 1250 -78 0 1255 1256 1257 1258 -12 0 1348 -6 0 1348 -61 0 1247 1248 1249 1250 -18 0 1295 1296 0 1251 1252 1253 1254 1289 1290 1243 1244 1245 1246 -20 0 1240 1241 -6 0 1244 1245 1246 -22 0 1251 1252 1253 1254 -25 0 1295 1296 -5 0 1259 1260 1261 1262 -15 0 1251 1252 1253 1254 -41 0 1240 1241 -35 0 1259 1260 1261 1262 -12 0 79 -6 0 79 -61 0 1251 1252 1253 1254 -18 0 1301 1302 0 1255 1256 1257 1258 1291 1292 1247 1248 1249 1250 -19 0 1243 1244 1245 1246 -4 0 1247 1248 1249 1250 -22 0 1255 1256 1257 1258 -25 0 1301 1302 -5 0 1263 1264 1265 1266 -15 0 1255 1256 1257 1258 -40 0 1243 1244 1245 1246 -24 0 1287 1288 -8 0 1263 1264 1265 1266 -12 0 1349 -6 0 1349 -61 0 1255 1256 1257 1258 -18 0 1307 1308 0 1259 1260 1261 1262 1293 1294 1251 1252 1253 1254 -19 0 1247 1248 1249 1250 -4 0 1251 1252 1253 1254 -22 0 1259 1260 1261 1262 -14 0 402 403 404 405 -7 0 1307 1308 -5 0 1267 1268 1269 1270 -15 0 1259 1260 1261 1262 -33 0 323 324 -5 0 1247 1248 1249 1250 -24 0 1289 1290 -8 0 1267 1268 1269 1270 -53 0 322 -27 0 1259 1260 1261 1262 -18 0 1309 1310 0 1263 1264 1265 1266 1295 1296 1255 1256 1257 1258 -19 0 1251 1252 1253 1254 0 1287 1288 0 1255 1256 1257 1258 -22 0 1263 1264 1265 1266 -14 0 406 407 408 409 -7 0 1309 1310 -6 0 1280 1281 -16 0 1263 1264 1265 1266 -33 0 325 326 -5 0 1251 1252 1253 1254 -24 0 1291 1292 -9 0 1280 1281 -2 0 1628 1629 -78 0 1263 1264 1265 1266 -21 0 1267 1268 1269 1270 1301 1302 1259 1260 1261 1262 -19 0 1255 1256 1257 1258 0 1289 1290 0 1259 1260 1261 1262 -22 0 1267 1268 1269 1270 -33 0 1284 1285 -2 0 322 -3 0 402 403 404 405 -6 0 1267 1268 1269 1270 -25 0 1633 1634 -6 0 327 328 -5 0 1255 1256 1257 1258 -24 0 1293 1294 -9 0 1284 1285 -2 0 1630 1631 -78 0 1267 1268 1269 1270 -22 0 1280 1281 0 1307 1308 1263 1264 1265 1266 -19 0 1259 1260 1261 1262 0 1291 1292 0 1263 1264 1265 1266 -17 0 323 324 -4 0 1272 1273 -42 0 406 407 408 409 -7 0 1280 1281 -2 0 1628 1629 -21 0 1639 1640 1641 1642 -12 0 1259 1260 1261 1262 -24 0 1295 1296 -80 0 323 324 -12 0 1280 1281 0 402 403 404 -18 0 322 1284 1285 0 1309 1310 1267 1268 1269 1270 -19 0 1263 1264 1265 1266 0 1293 1294 0 1267 1268 1269 1270 -17 0 325 326 -4 0 1276 1277 -53 0 1284 1285 -2 0 1630 1631 -21 0 1646 1647 1648 1649 -12 0 1263 1264 1265 1266 -24 0 1301 1302 -80 0 325 326 -12 0 1284 1285 0 406 407 408 -25 0 1272 1273 -20 0 1267 1268 1269 1270 0 1295 1296 -2 0 1272 1273 -18 0 327 328 -4 0 1280 1281 -80 0 1653 1654 1655 1656 -12 0 1267 1268 1269 1270 -24 0 1307 1308 -80 0 327 328 -43 0 1276 1277 -21 0 1276 1277 1620 1621 1301 1302 -2 0 1276 1277 -24 0 1284 1285 -80 0 1660 1661 1662 1663 -5 0 402 403 404 405 -4 0 1280 1281 -25 0 1309 1310 -73 0 1620 1621 -5 0 329 330 -43 0 1280 1281 0 141 142 -14 0 2400 2401 -2 0 1280 1281 1622 1623 1307 1308 -2 0 1280 1281 402 403 404 405 -96 0 402 403 404 405 -2 0 1667 1735 1669 1670 -5 0 406 407 408 409 -2 0 322 0 1284 1285 -79 0 -2 1002 1003 -2 0 322 -11 0 1725 1724 -2 0 1622 1623 -5 0 360 329 -43 0 1284 1285 0 143 144 -14 0 2402 2403 -2 0 1284 1285 -2 1002 1309 1310 -2 0 1284 1285 406 407 408 409 -94 0 1001 0 406 407 408 409 -2 0 1674 1736 1676 1677 -96 0 1007 -269 0 -9 76 -10 0 -18 76 -50 0 -8 76 -23 0 -9 76 -34 0 -8 76 -59 0 -13 76 -69 0 -9 75 -10 0 -18 75 -50 0 -8 75 -23 0 -9 75 -34 0 -8 75 -59 0 -13 75 -947 0)
    )
    (tilemap
      (solid #t)
      (z-pos 0)
      (width 310)
      (height 30)
      (tiles -2265 0 77 0 -2 77 -262 0 85 86 87 88 -141 0 44 -164 0 89 90 91 92 -70 0 -3 44 -273 0 1051 -7 1002 1001 -7 1002 1003 -2 0 44 0 1000 1001 -5 1002 1061 -72 0 44 -118 0 128 -22 0 -2 1311 -65 0 1053 1005 -5 1006 1005 -8 1006 1007 -4 0 1004 1005 -5 1006 1065 1066 1061 -121 0 -3 44 -79 0 -2 1311 -16 0 -2 1311 -26 0 27 -8 28 29 -19 0 1051 1055 -5 1009 -2 1018 1017 1018 -2 1017 1018 1009 1020 1022 1015 0 44 -2 0 1008 -7 1009 1070 1065 1066 1061 -24 0 -4 83 -50 0 1000 -16 1002 1003 -97 0 -2 1311 -81 0 1053 1057 -3 1009 1014 1015 -7 0 1008 1026 1028 1011 -4 0 1008 -9 1009 1070 1065 1066 1061 -76 0 1004 -16 1006 1007 -14 0 -2 83 102 83 -26 0 -4 44 -42 0 -2 1002 1003 -60 0 -6 44 -19 0 1000 1002 1055 -5 1009 1011 0 128 83 -4 0 1012 -2 1009 1015 -2 0 44 0 1008 -11 1009 1070 1065 1066 1061 -74 0 1008 -16 1009 1011 -90 0 1006 1005 1007 -37 0 -4 83 -16 0 1000 1001 -9 1002 1003 -16 0 1004 1005 1057 1020 1021 1022 1009 1014 1015 -7 0 1008 -2 1009 1011 -4 0 1012 -13 1009 1070 1065 1066 1003 -7 0 1000 1001 1003 -6 0 1000 1001 -6 1002 1003 -35 0 44 -7 0 1000 1001 -2 1002 1034 -4 1009 1020 -3 1021 1022 -7 1009 1019 -90 0 -2 1009 1019 -57 0 1004 1005 -9 1006 1007 -16 0 1008 -2 1009 1023 1024 1025 -2 1009 1820 -3 1724 1726 -2 0 1723 1817 -2 1009 1019 0 44 -2 0 1016 -15 1009 1070 1007 -7 0 1004 1005 1007 -6 0 1004 1005 -6 1006 1007 -43 0 1004 1005 -2 1006 1040 -4 1009 1023 -3 1024 1025 -5 1009 1018 1019 -11 0 1060 -21 1002 1061 -57 0 1009 1015 -58 0 1008 -10 1009 1011 -16 0 1016 1017 1009 1026 1027 1028 -6 1009 1011 -2 0 1008 -2 1009 1011 -6 0 1016 -6 1009 1533 1534 1535 -6 1009 1011 -6 0 102 1008 1009 1015 -6 0 1008 -7 1009 1011 0 -5 44 -37 0 1008 -8 1009 1026 -3 1027 1028 -4 1009 1019 -11 0 1060 1063 1064 -21 1006 1065 1066 -7 1002 1061 -26 0 -3 44 -12 0 1633 1634 -5 0 1009 1015 -21 0 1060 -8 1002 1003 -5 0 1000 1001 -12 1002 1003 -7 0 1012 1009 1020 -3 1021 1022 -4 1009 1011 -18 0 1016 1017 -3 1009 1018 1017 1018 1017 1018 1019 -2 0 1016 -2 1017 1019 -3 0 44 -3 0 1016 1018 -4 1009 1536 1537 1538 -6 1009 1011 -7 0 1012 1009 1011 -6 0 1012 1020 1022 -5 1009 1015 -43 0 1008 -16 1009 1019 -10 0 1060 1063 1064 1067 -23 1009 1070 -7 1006 1065 1066 -5 1002 1061 -33 0 1639 1640 1641 1642 -4 0 1009 1011 -19 0 1060 1063 1064 -8 1006 1007 102 -3 0 83 1004 1005 -12 1006 1007 -7 0 1008 1009 1023 -3 1024 1025 -4 1009 1015 -20 0 1008 1009 1019 -21 0 1016 -2 1018 -10 1009 1015 -7 0 1012 1009 1011 -6 0 1008 1026 1028 -5 1009 1035 1001 -5 1002 1003 -36 0 1008 -15 1009 1019 -9 0 1060 1063 1064 1067 -34 1009 1070 -5 1006 1065 1066 -10 1002 1003 -13 0 133 -7 0 1646 1647 1648 1649 -4 0 1009 1011 -17 0 1060 1063 1064 1067 -9 1009 1011 -5 0 1008 1020 1022 -11 1009 1011 -7 0 1008 1009 1026 -3 1027 1028 -4 1009 1015 -20 0 1016 1019 -25 0 1016 -9 1009 1035 1001 -6 1002 1034 1009 1011 -6 0 1012 -7 1009 1041 1005 -5 1006 1007 -36 0 1008 -14 1009 1011 -8 0 1060 1063 1064 1067 -14 1009 1010 -28 1009 1070 -10 1006 1007 -13 0 133 -7 0 1653 132 1655 1656 -4 0 1009 1011 -15 0 1060 1063 1064 1067 -11 1009 1015 -5 0 1012 1026 1028 -11 1009 1015 -7 0 1008 -10 1009 1011 -16 0 -3 44 -29 0 1012 -3 1009 1020 1022 -3 1009 1041 1005 -6 1006 1040 1009 1011 -6 0 1008 -14 1009 1011 -27 0 44 -8 0 1008 -5 1009 1020 1022 -7 1009 1011 -6 0 1000 1063 1064 1067 -26 1009 1020 1021 1022 -27 1009 1011 -13 0 133 -7 0 1660 132 1662 1663 1664 1665 -2 0 1009 1015 -13 0 1060 1063 1064 1067 -13 1009 1035 1001 -4 1002 1034 -13 1009 1015 -7 0 1008 -7 1009 1020 1022 1009 1015 -3 0 -4 44 -11 0 317 318 -15 0 313 314 -10 0 1723 1817 -3 1009 1026 1028 -13 1009 1015 -6 0 1008 -10 1009 1010 -3 1009 1015 -26 0 317 318 -8 0 1008 -5 1009 1026 1028 -4 1009 1010 -2 1009 1011 -6 0 1004 1067 -28 1009 1023 1024 1025 -27 1009 1011 -13 0 133 -8 0 132 -3 0 1672 1673 0 1009 1035 1001 -11 1002 1063 1064 1067 -3 1009 1020 1022 -10 1009 1041 1005 -4 1006 1040 -13 1009 1015 -7 0 1012 -7 1009 1026 1028 1009 1015 -16 0 1000 1001 319 320 1723 -2 1724 1725 1724 1725 -3 1724 1725 1724 1725 1724 1725 1724 315 316 1725 1724 1725 -2 1724 -5 1725 1817 -19 1009 1015 -6 0 1008 -14 1009 1035 1001 -7 1002 1003 -7 0 1000 1001 -8 1002 319 320 -8 1002 1034 -14 1009 1015 -6 0 1008 -29 1009 1026 1027 1028 -27 1009 1011 -11 0 1000 1001 133 -7 1002 0 132 -3 0 1679 1680 0 1009 1041 1005 -11 1006 1067 -5 1009 1026 1028 -18 1009 1533 1534 1535 -9 1009 1015 -7 0 1012 -10 1009 1011 -16 0 1004 1005 -2 1006 1817 -36 1009 1010 -9 1009 1011 -6 0 1012 -14 1009 1041 1005 -7 1006 1007 -7 0 1004 1005 -18 1006 1040 -14 1009 1015 -6 0 1012 -6 1009 1010 -34 1009 1010 -17 1009 1015 -11 0 1004 1005 -8 1006 1005 -7 1006 -40 1009 1536 1537 1538 -9 1009 1015 -7 76 1008 -10 1009 1015 76 27 -6 28 29 -7 76 1008 -50 1009 1015 -6 76 1012 -23 1009 1011 -7 76 1008 -8 1009 1010 -25 1009 1011 -6 76 1012 -59 1009 1011 -11 76 1008 -7 1009 1010 -13 1009 1010 -47 1009 1011 -7 75 1012 -10 1009 1015 -16 75 1008 -50 1009 1015 -6 75 1012 -23 1009 1015 -7 75 1012 -34 1009 1015 -6 75 1012 -59 1009 1015 -11 75 1012 -17 1009 -52 1013 1011 -7 75 1012 -10 1014 1015 -16 75 1012 -50 1069 1015 -6 75 1012 -23 1068 1015 -7 75 1817 -34 1068 1011 -6 75 1817 -59 1069 1015 -11 75 1817 -17 1069 -52 1013 1011 -7 75 1012 -10 1014 1015 -16 75 1012 -50 1069 1015 -6 75 1012 -23 1068 1015 -7 75 1817 -34 1068 1011 -6 75 1817 -59 1069 1015 -11 75 1817 -17 1069 -52 1013 1011 -7 75 1012 -10 1014 1015 -16 75 1012 -50 1069 1015 -6 75 1012 -23 1068 1015 -7 75 1817 -34 1068 1011 -6 75 1817 -59 1069 1015 -11 75 1817 -17 1069)
    )
    (tilemap
      (solid #f)
      (z-pos 100)
      (width 310)
      (height 30)
      (tiles -3123 0 85 86 87 88 -297 0 85 86 87 88 -5 0 89 90 91 92 -5 0 85 86 87 88 -280 0 85 86 87 88 -4 0 89 90 91 92 -14 0 89 90 91 92 -280 0 89 90 91 92 -2292 0 360 -171 0 1655 1656 -96 0 323 324 -126 0 360 -81 0 1650 1651 1662 1663 1664 1665 -39 0 360 -54 0 325 326 -208 0 1657 1658 1659 1670 1671 1672 1673 -93 0 327 328 -210 0 1666 1677 1678 1679 1680 1002 -303 0 -6 1006 -1551 0)
    )
    (tilemap
      (solid #f)
      (z-pos -101)
      (name "CaveBackground")
      (width 310)
      (height 30)
      (tiles -3207 0 2005 -4 1351 2010 -304 0 2006 -4 1352 2011 -291 0 -13 1353 1354 1353 1354 -3 1353 -291 0 -19 1353 -291 0 -19 1353 -291 0 -17 1353 -2 1354 -291 0 -16 1353 1354 -3 1353 -2 1354 -5 1353 -283 0 -27 1353 -283 0 -24 1353 -3 1354 -282 0 -19 1353 1354 -8 1353 -282 0 2007 -4 1353 1354 -3 1353 1354 -18 1353 -282 0 2008 1353 1354 -15 1353 1354 -9 1353 -282 0 2007 -15 1353 -7 1354 -5 1353 -282 0 2008 -27 1353 -282 0 2008 -27 1353 -1739 0)
    )
    (tilemap
      (handle
        (scale_x 0)
        (scale_y 0)
        (offset_x 0)
        (offset_y 0)
      )
      (solid #f)
      (z-pos 101)
      (name "secret1")
      (path-ref "gen1772929264104989801024224")
      (width 9)
      (height 5)
      (tiles 1009 1020 -3 1021 1022 1013 -3 1009 1023 -3 1024 1031 1022 1013 -2 1009 1026 1030 -3 1024 1031 1022 -3 1009 1026 -4 1027 1028 -6 1009 1017 1018 -2 1009)
    )
    (trampoline
      (z-pos 50)
      (x 3504)
      (y 736)
    )
    (trampoline
      (z-pos 50)
      (x 5888)
      (y 736)
    )
    (viciousivy
      (z-pos 50)
      (direction "left")
      (x 898)
      (y 580)
      (glinting #f)
    )
    (viciousivy
      (z-pos 50)
      (direction "left")
      (x 1538)
      (y 580)
      (glinting #f)
    )
    (viciousivy
      (z-pos 50)
      (direction "left")
      (x 8162)
      (y 548)
      (glinting #f)
    )
    (viciousivy
      (z-pos 50)
      (direction "left")
      (x 8770)
      (y 612)
      (glinting #f)
    )
    (viciousivy
      (z-pos 50)
      (direction "left")
      (x 7810)
      (y 516)
      (glinting #f)
    )
  )
)
