(supertux-level
  (version 3)
  (name (_ "Crumbling Path"))
  (author "Wolfgang Becker")
  (license "GPL 2+ / CC-by-sa 3.0")
  (allow-item-pocket "inherit")
  (icon "")
  (icon-locked "")
  (statistics
    (enable-coins #t)
    (enable-secrets #t)
  )
  (sector
    (name "main")
    (ambient-light
      (color 1 1 1)
    )
    (background
      (color 1 1 1)
      (speed 0.5)
      (image-top "images/background/BlueRock_Forest/blue-top.jpg")
      (image "images/background/BlueRock_Forest/blue-middle.jpg")
      (image-bottom "images/background/BlueRock_Forest/blue-bottom.jpg")
    )
    (camera
      (name "Camera")
      (mode "normal")
    )
    (door
      (z-pos -99)
      (sector "main")
      (locked #f)
      (spawnpoint "exit")
      (x 6432)
      (y 1148)
    )
    (firefly
      (z-pos 0)
      (x 4384)
      (y 960)
    )
    (fish-jumping
      (z-pos 50)
      (x 8000)
      (y 1056)
      (glinting #f)
    )
    (haywire
      (z-pos 50)
      (direction "left")
      (x 8229)
      (y 1000)
      (glinting #f)
    )
    (haywire
      (z-pos 50)
      (direction "left")
      (x 4037)
      (y 1032)
      (glinting #f)
    )
    (jumpy
      (z-pos 50)
      (x 6304)
      (y 704)
      (glinting #f)
    )
    (jumpy
      (z-pos 50)
      (x 9223)
      (y 1032)
      (glinting #f)
    )
    (mrbomb
      (z-pos 50)
      (direction "left")
      (x 7269)
      (y 728)
      (glinting #f)
    )
    (music
      (file "music/forest2.ogg")
    )
    (path
      (name "gen1772929467104989804939744")
      (path
        (adapt_speed #f)
        (node
          (x 6368)
          (y 1024)
        )
      )
    )
    (secretarea
      (fade-tilemap "Secret")
      (width 32)
      (height 192)
      (x 6688)
      (y 1024)
    )
    (snail
      (z-pos 50)
      (direction "left")
      (x 2306)
      (y 707)
      (glinting #f)
    )
    (spawnpoint
      (name "main")
      (x 96)
      (y 1152)
    )
    (spawnpoint
      (name "exit")
      (x 6640)
      (y 128)
    )
    (tilemap
      (solid #f)
      (z-pos -100)
      (width 300)
      (height 40)
      (tiles -1405 0 2005 -4 1351 2010 -294 0 2006 -4 1352 2011 -294 0 2009 -4 1821 2014 -1244 0 1073 1074 1075 -98 0 1287 1288 -185 0 1073 1074 1075 -9 0 1081 1082 1083 1084 -97 0 1289 1290 -146 0 1287 1288 -37 0 1081 1082 1083 1084 -7 0 1088 1089 1090 1091 1092 1093 -8 0 1073 1074 1075 -85 0 1291 1292 -146 0 1289 1290 -36 0 1088 1089 1090 1091 1092 1093 -5 0 1095 1096 1097 1098 1099 1100 1101 -8 0 1081 1082 1083 1084 -84 0 1293 1294 -52 0 1073 1074 1075 -91 0 1291 1292 -35 0 1095 1096 1097 1098 1099 1100 1101 -5 0 1103 1104 1105 1106 1107 1108 1109 1110 -6 0 1088 1089 1090 1091 1092 1093 -83 0 1295 1296 -52 0 1081 1082 1083 1084 -90 0 1293 1294 -35 0 1103 1104 1105 1106 1107 1108 1109 1110 -4 0 1111 1112 1113 1114 1115 1116 1117 1118 -5 0 1095 1096 1097 1098 1099 1100 1101 -56 0 1287 1288 -25 0 1297 1298 -51 0 1088 1089 1090 1091 1092 1093 -89 0 1295 1296 -35 0 1111 1112 1113 1114 1115 1116 1117 1118 -4 0 1103 1104 1105 1106 1107 1108 1109 1110 -5 0 1103 1104 1105 1106 1107 1108 1109 1110 -55 0 1289 1290 -25 0 1299 1300 -50 0 1095 1096 1097 1098 1099 1100 1101 -89 0 1297 1298 -35 0 1103 1104 1105 1106 1107 1108 1109 1110 -4 0 1111 1112 1113 1114 1115 1116 1117 1118 -5 0 1111 1112 1113 1114 1115 1116 1117 1118 -55 0 1291 1292 -25 0 1301 1302 -38 0 1168 1169 1170 -9 0 1103 1104 1105 1106 1107 1108 1109 1110 -88 0 1299 1300 -35 0 1111 1112 1113 1114 1115 1116 1117 1118 -4 0 1103 1104 1105 1106 1107 1108 1109 1110 -5 0 1103 1104 1105 1106 1107 1108 1109 1110 -55 0 1293 1294 -25 0 1303 1304 -19 0 402 403 434 435 436 437 404 405 -11 0 1174 1175 1176 1177 -8 0 1111 1112 1113 1114 1115 1116 1117 1118 -88 0 1301 1302 -35 0 1119 1120 1121 1122 1123 1124 1125 1126 -4 0 1111 1112 1113 1114 1115 1116 1117 1118 -5 0 1111 1112 1113 1114 1115 1116 1117 1118 -6 0 1287 1288 -47 0 1295 1296 -25 0 1305 1306 -19 0 406 407 438 439 440 441 408 409 -10 0 1179 1180 1181 1182 1183 -8 0 1103 1104 1105 1106 1123 1124 1125 1126 -17 0 1168 1169 1170 -32 0 1168 1169 1170 -33 0 1303 1304 -35 0 1127 1128 1129 1130 1131 1132 1133 1134 -4 0 1119 1120 1121 1122 1123 1124 1125 1126 -2 0 1287 1288 0 1119 1120 1121 1122 1123 1124 1125 1126 -6 0 1289 1290 -47 0 1297 1298 -5 0 402 403 404 405 -16 0 1307 1308 -19 0 418 419 450 451 452 453 420 421 -10 0 1185 1186 1187 1188 1189 1190 0 1287 1288 -4 0 1111 1112 1113 1114 1115 1116 1117 1118 -17 0 1174 1175 1176 1177 -31 0 1174 1175 1176 1177 -32 0 1305 1306 -37 0 1137 1138 1139 1140 -6 0 1127 1128 1129 1130 1131 1132 1133 1134 -2 0 1289 1290 0 1127 1128 1129 1130 1131 1132 1133 1134 -6 0 1291 1292 -47 0 1299 1300 -5 0 406 407 408 409 -16 0 1309 1310 -19 0 422 423 454 455 456 457 424 425 -10 0 1191 1192 1193 1194 1195 1196 0 1289 1290 -4 0 1119 1120 1121 1122 1123 1124 1125 1126 -16 0 1179 1180 1181 1182 1183 -6 0 1287 1288 -20 0 1287 1288 1179 1180 1181 1182 1183 -2 0 1287 1288 -28 0 1307 1308 -37 0 1145 1146 1147 1148 -8 0 1137 1138 1139 1140 -4 0 1291 1292 -3 0 1137 1138 1139 1140 -8 0 1293 1294 -47 0 1301 1302 -5 0 410 411 412 413 -37 0 418 419 450 451 452 453 420 421 -10 0 1197 1198 1199 1200 1201 1202 0 1291 1292 -4 0 1127 1128 1129 1130 1131 1132 1133 1134 -16 0 1185 1186 1187 1188 1189 1190 -5 0 1289 1290 -20 0 1289 1290 1185 1186 1187 1188 1189 1190 0 1289 1290 -28 0 1309 1310 -37 0 1137 1138 1139 1140 -8 0 1145 1146 1147 1148 -4 0 1293 1294 -3 0 1145 1146 1147 1148 -8 0 1295 1296 -47 0 1303 1304 -5 0 414 415 416 417 -37 0 422 423 454 455 456 457 424 425 -4 0 1003 -5 0 1203 1204 1205 1206 1207 1208 0 1293 1294 -6 0 1137 1138 1139 1140 -18 0 1191 1192 1193 1194 1195 1196 -5 0 1291 1292 -20 0 1291 1292 1191 1192 1193 1194 1195 1196 0 1291 1292 -53 0 1000 -11 0 1600 1601 1145 1146 1147 1148 -8 0 1137 1138 1139 1140 -4 0 1295 1296 -3 0 1137 1138 1139 1140 -8 0 1297 1298 -47 0 1305 1306 -64 0 1209 1210 1211 1212 1213 1214 0 1295 1296 -6 0 1145 1146 1147 1148 -18 0 1197 1198 1199 1200 1201 1202 -5 0 1293 1294 -20 0 1293 1294 1197 1198 1199 1200 1201 1202 0 1293 1294 -65 0 1602 1603 1137 1138 1139 1140 -8 0 1145 1146 1147 1148 -4 0 1297 1298 -3 0 1145 1146 1147 1148 -8 0 1299 1300 -115 0 1217 1220 -3 0 1297 1298 -6 0 1137 1138 1139 1140 -18 0 1203 1204 1205 1206 1207 1208 -5 0 1295 1296 -20 0 1295 1296 1203 1204 1205 1206 1207 1208 0 1295 1296 -67 0 1145 1146 1147 1148 -8 0 1137 1138 1139 1140 -4 0 1299 1300 -3 0 1137 1138 1139 1140 -8 0 1301 1302 -47 0 1045 -67 0 1223 1226 -3 0 1299 1300 -6 0 1145 1146 1147 1148 -18 0 1209 1210 1211 1212 1213 1214 -5 0 1297 1298 -20 0 1297 1298 1209 1210 1211 1212 1213 1214 0 1297 1298 -67 0 1137 1138 1139 1140 -8 0 1145 1146 1147 1148 -4 0 1301 1302 -3 0 1145 1146 1147 1148 -8 0 1303 1304 -40 0 2005 -6 1351 -68 0 1217 1218 -3 0 1301 1302 -6 0 1137 1138 1139 1140 -19 0 2045 1219 1220 -7 0 1299 1300 -20 0 1299 1300 -2 0 1217 1220 -3 0 1299 1300 -67 0 1145 1146 1147 1148 -8 0 1137 1138 1139 1140 -4 0 1303 1304 -3 0 1137 1138 1139 1140 -8 0 1305 1306 -12 0 1633 1634 -24 0 1052 0 2006 -6 1352 -68 0 1223 1224 -3 0 1303 1304 -6 0 1145 1146 1147 1148 -19 0 2046 1225 1226 -7 0 1301 1302 -20 0 1301 1302 -2 0 1223 1226 -3 0 1301 1302 -67 0 1153 1154 1155 1156 -8 0 1145 1146 1147 1148 -4 0 1305 1306 -3 0 1145 1146 1147 1148 -8 0 1307 1308 -11 0 1639 1640 1641 1642 -25 0 -7 1353 -67 0 1228 1229 1230 1060 -2 0 1305 1306 -6 0 1137 1138 1139 1140 -20 0 1217 1218 -7 0 1303 1304 -20 0 1303 1304 -2 0 1217 1218 -3 0 1303 1304 -67 0 1161 1162 1163 1164 -8 0 1153 1154 1155 1156 -4 0 1307 1308 -3 0 1153 1154 1155 1156 -8 0 1309 1310 1001 1003 -9 0 1646 1647 1648 1649 -22 0 1046 -2 0 -3 1353 1354 -2 1353 1354 -67 0 1234 1235 1236 -11 0 1145 1146 1147 1148 -20 0 1223 1224 -7 0 1305 1306 -20 0 1305 1306 -2 0 1223 1224 -3 0 1305 1306 -79 0 1161 1162 1163 1164 -4 0 1309 1310 -3 0 1161 1162 1163 1164 -4 0 1045 -3 0 1309 -12 0 1653 1654 1655 1656 -20 0 1045 -4 0 -3 1354 -2 1353 1354 1353 -74 0 1046 -6 0 1153 1154 1155 1156 -19 0 1228 1229 1230 -7 0 1307 1308 -23 0 1228 1229 1230 -3 0 1307 1308 -23 0 -11 1353 -73 0 1051 -9 0 1660 1661 1662 1663 1664 1665 -23 0 1353 -6 1354 -81 0 1161 1162 1163 1164 -19 0 1234 1235 1236 0 360 -5 0 1309 1310 -21 0 1046 0 1234 1235 1236 0 360 0 1309 1310 -23 0 -11 1354 -83 0 1667 1668 1669 1670 1671 1672 1673 -22 0 -5 1353 1354 1353 -170 0 -11 1353 -37 0 76 -6 0 76 -38 0 1674 1675 1676 1677 1678 1679 1680 -13 0 2007 -8 1353 -2 1354 1353 -2 1354 1353 1354 -15 0 76 -11 0 -2 76 -14 0 76 -109 0 76 -10 0 76 -5 0 -10 1354 1353 -37 0 75 -6 0 75 -58 0 2008 1354 -2 1353 1354 -2 1353 -3 1354 -6 1353 -15 0 75 -11 0 -2 75 -14 0 75 -109 0 75 -10 0 75 -5 0 -10 1353 1354 -37 0 75 -6 0 75 -58 0 2007 1354 1353 1354 -2 1353 -2 1354 -3 1353 1354 -2 1353 1354 1353 -15 0 75 -11 0 -2 75 -14 0 75 -39 0 76 -18 0 76 -50 0 75 -10 0 75 -5 0 -10 1354 1353 -37 0 75 -6 0 75 -58 0 2008 -2 1354 1353 -2 1354 -2 1353 -8 1354 -15 0 75 -11 0 -2 75 -14 0 75 -39 0 75 -18 0 75 -11 0 76 -19 0 76 -18 0 75 -10 0 75 -5 0 -11 1353 76 -19 0 76 -16 0 75 -6 0 75 -89 0 75 -11 0 -2 75 -14 0 75 -39 0 75 -18 0 75 -11 0 75 -19 0 75 -18 0 75 -10 0 75 -5 0 -11 1354 75 -19 0 75 -16 0 75 -6 0 75 -45 0)
    )
    (tilemap
      (solid #t)
      (z-pos 0)
      (width 300)
      (height 40)
      (tiles -506 0 27 -2 28 29 -296 0 47 -2 0 47 -296 0 47 -2 0 47 -296 0 47 -2 0 47 -4354 0 2947 -229 0 1311 -204 0 -2 77 102 104 77 -90 0 1311 -87 0 102 -211 0 1311 -48 0 1060 1003 -11 0 1000 1003 -14 0 1000 1003 -156 0 1051 1001 1002 1003 -60 0 1311 -43 0 1060 1002 1001 1002 1063 1064 1007 -11 0 1004 1007 -14 0 1004 1037 1001 1002 1001 1002 1003 -10 0 313 314 -104 0 1060 1001 1002 1001 1002 1001 1002 1001 1002 1001 1002 1001 1002 1001 1002 1003 -19 0 1053 1005 1006 1037 1001 1002 1001 1002 1061 -6 0 1752 1753 -47 0 1311 -39 0 1060 1001 1002 1063 1064 1006 1005 1006 1067 1068 1011 -11 0 1008 1011 -14 0 1008 1041 1005 1006 1005 1006 1037 1001 1002 1001 1002 1001 1002 1001 1002 1001 1002 315 316 -101 0 44 1000 1063 1064 1005 1006 1005 1006 1005 1006 1005 1006 1005 1006 1005 1006 1005 1006 1007 -18 0 337 338 -2 1013 1041 1005 1006 1005 1006 1065 1066 1061 -4 0 1754 1755 1756 1757 -8 0 1752 1753 -35 0 1311 -37 0 1060 1063 1064 1005 1006 1067 1068 -5 1013 1015 -11 0 1012 1015 -14 0 1012 -5 1013 1041 1005 1006 1005 1006 1005 1006 1005 1006 1005 1006 1007 211 -99 0 44 -2 0 1004 1067 1068 -14 1013 1011 -18 0 1004 1057 -7 1013 1069 1070 1065 1066 1061 -2 0 1758 1759 -10 0 1754 1755 1756 1757 -33 0 1311 -35 0 1060 1063 1064 1067 1068 -2 1013 1020 1021 1022 -4 1013 1011 -11 0 1008 1011 -14 0 1008 -10 1013 1009 1013 1009 1013 1009 1013 1035 212 -3 0 -3 44 -91 0 44 -4 0 1008 -13 1013 1533 1534 1535 1015 -18 0 1008 -4 1013 1020 1021 1022 -3 1013 1069 1070 1065 1066 1052 -10 0 1746 1747 1758 1759 -9 0 1746 1747 -24 0 1311 -33 0 1000 1001 1047 1067 1068 1013 1020 -2 1021 1032 1024 1031 1022 -3 1013 1015 -11 0 1012 1015 -14 0 1012 -16 1013 1041 212 -13 0 -3 44 -5 0 1752 1753 -72 0 44 -6 0 1012 -3 1013 1010 -2 1013 1010 -6 1013 1536 1537 1538 1011 -18 0 1012 -4 1013 1023 1024 1025 -5 1013 1069 1070 1054 -8 0 1760 1761 1748 1749 -10 0 1760 1748 1749 -24 0 1311 -26 0 1060 1003 -5 0 1004 1005 1049 -3 1013 1023 1029 1030 1029 1030 1029 1028 -3 1013 1011 -11 0 1008 1011 -14 0 1008 -13 1013 -3 1009 1013 212 1046 -20 0 1754 1755 1756 1757 -68 0 44 -8 0 1008 -11 1013 1010 -4 1013 1015 -18 0 1008 -4 1013 1026 1027 1028 -7 1013 1056 1052 -9 0 1750 1751 -11 0 1750 1751 -24 0 1311 -24 0 1051 1063 1064 1007 -5 0 1008 -5 1013 1023 1031 1032 1031 1032 1025 -4 1013 1015 -11 0 1012 1015 -14 0 1012 -12 1013 -4 1009 1013 1058 1048 1046 -7 0 211 1052 -10 0 1758 1759 -79 0 1012 -2 1013 1010 -13 1013 1011 -18 0 1012 1013 1010 -12 1013 1058 1054 -15 0 -5 44 -16 0 313 314 -10 0 1311 -19 0 -2 83 -3 0 1053 1067 1068 1011 -5 0 1012 -5 1013 1026 -2 1027 1030 1029 1028 1013 1009 1010 1013 1011 -11 0 1008 1011 -14 0 1008 -2 1013 1014 -14 1013 1009 1050 1065 1066 1061 -4 0 1045 212 1054 -8 0 211 -29 0 -2 83 -27 0 83 -2 0 83 -20 0 1008 -16 1013 1015 -18 0 1012 -10 1013 1010 -4 1013 1056 1052 -30 0 1060 1001 1002 1001 1002 315 316 -10 0 1311 -23 0 1045 1055 -2 1013 1011 -5 0 1008 -2 1013 1009 1010 -3 1013 1009 1026 1028 -3 1013 1014 1013 1015 -11 0 1012 1015 -14 0 1012 -10 1013 1014 -7 1013 1009 1069 1070 1065 1066 1001 1002 1063 1064 1049 1056 1046 -6 0 1060 212 -50 0 1000 1002 1061 -13 0 1051 1001 1002 1001 1002 1003 -10 0 1012 -16 1013 1011 -18 0 1016 -15 1013 1058 1054 -7 0 1000 1001 1002 1001 1002 1001 1002 1001 1002 1001 1002 1001 1002 1001 1002 1001 1002 1001 1002 1001 1002 1001 1002 1047 1005 1006 1005 1006 1005 1007 -10 0 1311 -22 0 1060 1047 1057 -2 1013 1015 -5 0 1012 -3 1013 1014 -4 1013 1014 -6 1013 1011 -11 0 1008 1011 -14 0 1008 -6 1013 1010 -9 1013 -2 1009 -2 1013 1009 1069 1070 1005 1006 1067 1068 1009 1058 1048 1061 -3 0 1060 1063 1064 212 1046 -49 0 1004 1006 1065 1066 1061 -11 0 1053 1005 1006 1005 1006 1007 -10 0 1008 -4 1013 1010 1014 1017 1018 1017 1013 1014 1013 1017 1018 1017 1018 1019 -19 0 1008 -4 1013 1010 -10 1013 1056 1003 -6 0 1004 1005 1006 1005 1006 1005 1006 1005 1006 1005 1006 1005 1006 1005 1006 1005 1006 1005 1006 1005 1006 1005 1006 1049 -5 1013 1035 1052 -9 0 133 -18 0 1000 1001 1002 1063 1064 1049 -3 1013 1011 -5 0 1008 -12 1013 1009 1010 1013 1015 -11 0 1012 1015 -14 0 1012 -5 1013 1010 -12 1013 -3 1009 -2 1013 1009 1010 -2 1013 1010 1013 1050 1065 1066 1001 1063 1064 1067 1068 1050 1065 1066 1003 -8 0 67 27 -7 28 29 1001 1002 1001 1002 1001 1002 1001 1002 1001 1002 1001 1002 1001 1003 -15 0 1008 1010 1069 1070 1048 1002 1001 1002 1001 1002 1001 1002 1001 1002 1001 1002 1055 1013 1068 1009 1010 1011 -10 0 1012 -5 1013 1011 -3 0 1012 1013 1015 -24 0 1012 -10 1013 1020 1021 1022 -2 1013 1058 1007 -6 0 1008 -20 1013 1009 1010 -5 1013 1069 1041 1054 -9 0 133 -18 0 1004 1005 1006 1067 1068 -4 1013 1015 -5 0 1012 -7 1013 1009 1010 -4 1013 1014 1013 1011 -11 0 1008 1011 -14 0 1008 -2 1013 1010 -6 1013 1014 -20 1013 1069 1070 1005 1067 1068 -2 1013 1009 1069 1070 1007 -7 0 340 341 342 -7 0 1004 1005 1006 1005 1006 1005 1006 1005 1006 1005 1006 1005 1006 1005 1007 -15 0 1008 -3 1013 1050 1006 1005 1006 1005 1006 1005 1006 1005 1006 1005 1006 1057 1068 -2 1013 1009 1011 -10 0 1008 1013 1020 1021 1022 1013 1015 -3 0 1016 1017 1019 -24 0 1008 -10 1013 1023 1024 1025 -3 1013 1011 -6 76 1012 -2 1013 1010 -16 1013 1010 -9 1013 1056 1001 1002 1001 1002 1001 1002 1001 1002 0 133 -2 0 132 -15 0 1016 1017 1018 1017 1018 1017 1018 1017 1018 1019 -5 0 1008 -8 1013 1014 -6 1013 1015 -11 76 1012 1015 -14 76 1012 -4 1013 -2 1014 -3 1013 1014 -4 1013 1014 -15 1013 1009 1010 1068 -7 1013 1019 -8 0 321 -8 0 1012 -13 1013 1015 -15 0 1012 -3 1013 1020 1021 1022 -4 1013 1020 -2 1021 1022 -6 1013 1015 -10 76 1012 1013 1023 1024 1025 1013 1011 103 -2 0 -3 83 -24 0 1012 -10 1013 1026 1027 1028 -3 1013 1015 -6 75 1008 -8 1013 1020 1022 1013 1020 1021 1022 -15 1013 1058 1005 1006 1005 1006 1005 1006 1005 -2 1006 1005 1006 1005 1006 1005 1006 1002 1001 1002 1001 1002 1001 1002 1001 1002 1001 1061 -17 0 1012 -9 1013 1009 1010 -4 1013 1011 -11 75 1008 1011 -14 75 1008 -3 1013 -2 1014 -4 1013 1014 -5 1013 -3 1014 -21 1013 1011 321 -8 0 321 -8 0 1008 -6 1013 1010 -2 1013 1010 -3 1013 1019 -15 0 1016 -3 1013 1023 1024 1025 -3 1013 1020 1032 -2 1024 1031 1022 -5 1013 1015 -10 75 1008 1013 1026 1027 1028 1013 1015 -9 0 1723 1726 -19 0 1008 -16 1013 1011 -6 75 1012 -2 1013 -2 1010 -3 1013 1020 1032 1031 1021 1032 1024 1025 -25 1013 1009 1010 1009 1013 1009 1010 1006 1005 1006 1005 1006 1005 1006 1005 1006 1005 1065 1066 1061 -15 0 1008 1013 1009 1010 -7 1013 1014 -4 1013 1015 -11 75 1008 1015 -14 75 1012 -3 1013 -6 1014 -9 1013 -2 1014 -4 1013 1010 -14 1013 1015 67 -8 76 67 -8 76 1012 -3 1013 1010 -8 1013 1019 -17 0 1016 -2 1013 1026 1027 1028 -3 1013 1026 1027 1030 1024 1029 1028 -5 1013 1015 -10 75 1012 -5 1013 1011 -3 0 -3 44 -2 0 1723 1817 1820 -19 0 1012 1010 -15 1013 1015 -6 75 1008 -7 1013 1026 1030 1029 -3 1027 1028 -13 1013 1010 -10 1013 1014 1013 1014 1013 1010 1013 1014 1009 1010 1014 -4 1009 1014 -2 1009 1069 1070 1065 1066 1001 1002 1001 1002 1001 1002 1001 1002 1001 1002 1001 -2 1002 1001 1034 -2 1013 1014 -12 1013 1011 -11 75 1012 1011 -14 75 1008 -14 1013 1010 -4 1013 1014 -13 1013 1014 1013 1014 -3 1013 1011 67 -8 75 67 -8 75 1008 -7 1013 1010 -3 1013 1015 -19 76 1012 -9 1013 1026 1027 1028 -6 1013 1015 -10 75 1008 -5 1013 1015 1724 1725 1724 1725 1724 1725 1724 1725 1817 1010 1011 -19 76 1008 -16 1013 1011 -6 75 1012 -8 1013 1026 1028 -36 1013 1014 -10 1009 1069 1070 1005 1006 1005 1006 1005 1006 1005 1006 1005 1006 1005 -2 1006 1005 1040 -15 1013 1015 -11 75 1008 1015 -14 75 1012 -34 1013 -2 1014 -3 1013 1015 67 -8 75 67 -8 75 1012 -11 1013 1011 -19 75 1008 -17 1013 1010 1015 -10 75 1012 -7 1013 1014 1013 1014 1013 1014 1013 1014 -2 1013 1015 -19 75 1012 -16 1013 1015 -6 75 1008 -45 1013)
    )
    (tilemap
      (solid #f)
      (z-pos 100)
      (width 300)
      (height 40)
      (tiles -4461 0 1311 -3 0 1311 -3 0 -2 1311 -5 0 -3 1311 -3 0 1311 -2 0 1311 -3 0 1311 -3 0 1311 -3 0 1311 -263 0 1311 0 1311 0 1311 -3 0 1311 0 1311 -6 0 1311 -2 0 -2 1311 0 1311 0 1311 0 1311 0 1311 0 1311 0 1311 0 1311 -264 0 1311 0 1311 0 1311 -3 0 -2 1311 -6 0 1311 -3 0 1311 -4 0 1311 0 1311 0 1311 0 1311 0 1311 0 -2 1311 -263 0 -5 1311 -3 0 1311 0 1311 -5 0 1311 -2 0 1311 -4 0 1311 -2 0 1311 0 1311 0 1311 0 1311 0 1311 0 1311 -263 0 1311 0 1311 -2 0 1311 0 -2 1311 -2 0 1311 -3 0 1311 -2 0 1311 -3 0 -3 1311 -2 0 1311 -3 0 1311 -3 0 1311 -1731 0 1000 1055 -298 0 323 324 -145 0 317 318 -11 0 1035 1052 -138 0 325 326 -145 0 319 320 -11 0 1041 1054 -138 0 327 328 -150 0 317 318 -3 0 317 318 0 1013 1056 1046 -137 0 329 330 -63 0 1633 1634 -85 0 319 320 -3 0 319 320 0 1013 1058 1048 1046 -7 0 1060 1052 -127 0 1358 1359 1360 -61 0 1639 1640 1641 1642 -92 0 1013 0 1050 1065 1066 1061 -4 0 1045 1047 1054 -127 0 1361 1362 1363 -50 0 1001 1003 -9 0 1646 1647 1648 1649 -92 0 1013 0 1009 1069 1070 1065 1066 1001 1002 1063 1064 1049 1056 1046 -6 0 1060 1061 -97 0 1358 1359 1360 -18 0 1364 1365 1366 -50 0 1005 1007 -9 0 1643 1644 1645 1656 -92 0 1009 0 -2 1013 1009 1069 1070 1005 1006 1067 1068 1009 1058 1048 1061 -3 0 1060 1063 1064 1048 1046 -96 0 1361 1362 1363 -18 0 325 326 -52 0 1035 1052 -8 0 1650 1651 1652 1663 1664 1665 -74 0 1358 1359 1360 -25 0 1013 1050 1065 1066 1001 1063 1064 1067 1068 1050 1065 1066 1003 -17 0 1000 -76 0 1361 1362 1363 -18 0 327 328 -48 0 317 318 -2 0 1041 1054 -8 0 1657 1658 1659 1670 1671 1672 1673 -73 0 1361 1362 1363 -11 0 317 318 -8 0 317 318 -2 0 -2 1013 1069 1070 1005 1067 1068 -2 1013 1009 1069 1070 1007 -8 0 322 323 324 -83 0 1361 1362 1363 -18 0 329 330 -14 0 1358 1359 1360 -31 0 319 320 -2 0 1013 1056 1001 1002 1001 1002 1001 1002 1001 1002 1001 1002 1001 1002 1001 1002 1001 -73 0 1364 1365 1366 -2 1359 1360 -8 0 319 320 -8 0 319 320 -10 0 319 320 0 1013 1019 -8 0 322 325 326 -6 0 1358 1359 1360 -74 0 1361 1362 1363 -34 0 1361 1362 1363 -35 0 1013 1058 1005 1006 1005 1006 1005 1006 1005 -2 1006 1005 1006 1005 1006 1005 1006 -75 0 1361 -2 1362 1363 -33 0 1011 -9 0 321 327 328 -6 0 1364 1365 1366 1359 1360 -72 0 1361 1362 1363 -34 0 1361 1362 1363 -40 0 317 318 -85 0 1358 1359 1360 1366 -33 0 1015 -9 0 201 329 330 -6 0 1358 1359 1361 1362 1363 -72 0 1361 1362 1363 -32 0 1358 1359 1360 1362 1363 -40 0 319 320 -85 0 1361 1362 1363 -34 0 1011 -9 0 200 -8 0 1361 1362 1364 1365 1366 -72 0 1361 1362 1363 -32 0 1361 1362 1363 1365 1366 -127 0 1364 1365 1366 -34 0 1015 -9 0 200 -8 0 1364 1365 1366 -74 0 1361 1362 1363 -32 0 1364 1365 1366 -54 0)
    )
    (tilemap
      (solid #f)
      (z-pos 99)
      (width 300)
      (height 40)
      (tiles -9090 0 1009 -299 0 1013 -299 0 1009 -804 0 1666 1677 1678 1679 1680 -75 0 1358 -36 0 323 324 -298 0 325 326 -19 0 1358 -241 0 1364 -2 1365 -34 0 327 328 -19 0 1360 -111 0 1361 -166 0 329 330 -19 0 1363 -111 0 1364 -354 0)
    )
    (tilemap
      (handle
        (scale_x 0)
        (scale_y 0)
        (offset_x 0)
        (offset_y 0)
      )
      (solid #f)
      (z-pos 90)
      (name "Secret")
      (path-ref "gen1772929467104989804939744")
      (width 11)
      (height 8)
      (tiles 1014 1013 1009 1013 1009 1013 1009 1013 1009 -2 1013 1009 -9 1013 1011 1009 -6 1013 1010 -2 1013 1015 1009 -2 1013 1010 1013 1014 -4 1013 1011 1009 -7 1013 1009 1014 1015 1009 -4 1013 1010 -5 1013 1009 -9 1013 0 -2 1013 1014 1013 1014 1013 1014 1013 1014 -2 1013)
    )
    (tilemap
      (solid #f)
      (z-pos -101)
      (name "Background2")
      (width 300)
      (height 40)
      (tiles -507 0 -2 2908 -297 0 2906 -2 131 2907 -296 0 2906 -2 131 2907 -295 0 1045 2906 -2 131 2907 1046 -6418 0 1307 1308 -298 0 1309 1310 -1271 0 1307 1308 -298 0 1309 1310 -61 0 1307 1308 -298 0 1309 1310 -1933 0)
    )
    (unstable_tile
      (type "brick")
      (z-pos 0)
      (x 4704)
      (y 1088)
    )
    (unstable_tile
      (type "brick")
      (z-pos 0)
      (x 768)
      (y 928)
    )
    (unstable_tile
      (type "brick")
      (z-pos 0)
      (x 6816)
      (y 1120)
    )
    (unstable_tile
      (type "brick")
      (z-pos 0)
      (x 6880)
      (y 1088)
    )
    (unstable_tile
      (type "brick")
      (z-pos 0)
      (x 6912)
      (y 1088)
    )
    (unstable_tile
      (type "brick")
      (z-pos 0)
      (x 6912)
      (y 768)
    )
    (unstable_tile
      (type "brick")
      (z-pos 0)
      (x 736)
      (y 928)
    )
    (unstable_tile
      (type "brick")
      (z-pos 0)
      (x 864)
      (y 928)
    )
    (unstable_tile
      (type "brick")
      (z-pos 0)
      (x 800)
      (y 928)
    )
    (unstable_tile
      (type "brick")
      (z-pos 0)
      (x 832)
      (y 928)
    )
    (unstable_tile
      (type "brick")
      (z-pos 0)
      (x 5088)
      (y 1024)
    )
    (unstable_tile
      (type "brick")
      (z-pos 0)
      (x 4736)
      (y 1088)
    )
    (unstable_tile
      (type "brick")
      (z-pos 0)
      (x 4800)
      (y 1088)
    )
    (unstable_tile
      (type "brick")
      (z-pos 0)
      (x 4768)
      (y 1088)
    )
    (unstable_tile
      (type "brick")
      (z-pos 0)
      (x 4832)
      (y 1088)
    )
    (unstable_tile
      (type "brick")
      (z-pos 0)
      (x 4864)
      (y 1088)
    )
    (unstable_tile
      (type "brick")
      (z-pos 0)
      (x 4896)
      (y 1088)
    )
    (unstable_tile
      (type "brick")
      (z-pos 0)
      (x 4928)
      (y 1056)
    )
    (unstable_tile
      (type "brick")
      (z-pos 0)
      (x 4992)
      (y 1056)
    )
    (unstable_tile
      (type "brick")
      (z-pos 0)
      (x 4960)
      (y 1056)
    )
    (unstable_tile
      (type "brick")
      (z-pos 0)
      (x 5056)
      (y 1024)
    )
    (unstable_tile
      (type "brick")
      (z-pos 0)
      (x 6752)
      (y 1184)
    )
    (unstable_tile
      (type "brick")
      (z-pos 0)
      (x 5888)
      (y 960)
    )
    (unstable_tile
      (type "brick")
      (z-pos 0)
      (x 5952)
      (y 928)
    )
    (unstable_tile
      (type "brick")
      (z-pos 0)
      (x 6016)
      (y 896)
    )
    (unstable_tile
      (type "brick")
      (z-pos 0)
      (x 6080)
      (y 864)
    )
    (unstable_tile
      (type "brick")
      (z-pos 0)
      (x 6144)
      (y 832)
    )
    (unstable_tile
      (type "brick")
      (z-pos 0)
      (x 6816)
      (y 768)
    )
    (unstable_tile
      (type "brick")
      (z-pos 0)
      (x 6848)
      (y 1088)
    )
    (unstable_tile
      (type "brick")
      (z-pos 0)
      (x 6784)
      (y 1152)
    )
    (unstable_tile
      (type "brick")
      (z-pos 0)
      (x 5120)
      (y 1024)
    )
    (unstable_tile
      (type "brick")
      (z-pos 0)
      (x 4672)
      (y 1088)
    )
    (unstable_tile
      (type "brick")
      (z-pos 0)
      (x 1760)
      (y 736)
    )
    (unstable_tile
      (type "brick")
      (z-pos 0)
      (x 1728)
      (y 736)
    )
    (unstable_tile
      (type "brick")
      (z-pos 0)
      (x 1696)
      (y 736)
    )
    (unstable_tile
      (type "brick")
      (z-pos 0)
      (x 1664)
      (y 736)
    )
    (unstable_tile
      (type "brick")
      (z-pos 0)
      (x 1632)
      (y 736)
    )
    (unstable_tile
      (type "brick")
      (z-pos 0)
      (x 1600)
      (y 736)
    )
    (unstable_tile
      (type "brick")
      (z-pos 0)
      (x 1568)
      (y 736)
    )
    (unstable_tile
      (type "brick")
      (z-pos 0)
      (x 1536)
      (y 736)
    )
    (unstable_tile
      (type "brick")
      (z-pos 0)
      (x 1504)
      (y 736)
    )
    (unstable_tile
      (type "brick")
      (z-pos 0)
      (x 1472)
      (y 736)
    )
    (unstable_tile
      (type "brick")
      (z-pos 0)
      (x 1440)
      (y 736)
    )
    (unstable_tile
      (type "brick")
      (z-pos 0)
      (x 1856)
      (y 736)
    )
    (unstable_tile
      (type "brick")
      (z-pos 0)
      (x 1888)
      (y 736)
    )
    (unstable_tile
      (type "brick")
      (z-pos 0)
      (x 1920)
      (y 736)
    )
    (unstable_tile
      (type "brick")
      (z-pos 0)
      (x 1952)
      (y 736)
    )
    (unstable_tile
      (type "brick")
      (z-pos 0)
      (x 1984)
      (y 736)
    )
    (unstable_tile
      (type "brick")
      (z-pos 0)
      (x 2016)
      (y 736)
    )
    (unstable_tile
      (type "brick")
      (z-pos 0)
      (x 2048)
      (y 736)
    )
    (unstable_tile
      (type "brick")
      (z-pos 0)
      (x 2080)
      (y 736)
    )
    (unstable_tile
      (type "brick")
      (z-pos 0)
      (x 2112)
      (y 736)
    )
    (unstable_tile
      (type "brick")
      (z-pos 0)
      (x 2144)
      (y 736)
    )
    (unstable_tile
      (type "brick")
      (z-pos 0)
      (x 2176)
      (y 736)
    )
    (unstable_tile
      (type "brick")
      (z-pos 0)
      (x 2208)
      (y 736)
    )
    (unstable_tile
      (type "brick")
      (z-pos 0)
      (x 2240)
      (y 736)
    )
    (unstable_tile
      (type "brick")
      (z-pos 0)
      (x 2272)
      (y 736)
    )
    (unstable_tile
      (type "brick")
      (z-pos 0)
      (x 5024)
      (y 1056)
    )
    (unstable_tile
      (type "brick")
      (z-pos 0)
      (x 6944)
      (y 768)
    )
    (unstable_tile
      (type "brick")
      (z-pos 0)
      (x 6976)
      (y 768)
    )
    (unstable_tile
      (type "brick")
      (z-pos 0)
      (x 7008)
      (y 768)
    )
    (unstable_tile
      (type "brick")
      (z-pos 0)
      (x 7040)
      (y 768)
    )
    (unstable_tile
      (type "brick")
      (z-pos 0)
      (x 7072)
      (y 768)
    )
    (unstable_tile
      (type "brick")
      (z-pos 0)
      (x 7104)
      (y 768)
    )
    (unstable_tile
      (type "brick")
      (z-pos 0)
      (x 7136)
      (y 768)
    )
    (unstable_tile
      (type "brick")
      (z-pos 0)
      (x 7168)
      (y 768)
    )
    (unstable_tile
      (type "brick")
      (z-pos 0)
      (x 7200)
      (y 768)
    )
    (unstable_tile
      (type "brick")
      (z-pos 0)
      (x 7232)
      (y 768)
    )
    (unstable_tile
      (type "brick")
      (z-pos 0)
      (x 7296)
      (y 768)
    )
    (unstable_tile
      (type "brick")
      (z-pos 0)
      (x 7264)
      (y 768)
    )
    (unstable_tile
      (type "brick")
      (z-pos 0)
      (x 6784)
      (y 768)
    )
    (unstable_tile
      (type "brick")
      (z-pos 0)
      (x 6752)
      (y 768)
    )
    (viciousivy
      (z-pos 50)
      (direction "left")
      (x 8770)
      (y 996)
      (glinting #f)
    )
    (viciousivy
      (z-pos 50)
      (direction "left")
      (x 5586)
      (y 1060)
      (glinting #f)
    )
    (viciousivy
      (z-pos 50)
      (direction "left")
      (x 5154)
      (y 996)
      (glinting #f)
    )
    (viciousivy
      (z-pos 50)
      (direction "left")
      (x 3426)
      (y 1028)
      (glinting #f)
    )
    (viciousivy
      (z-pos 50)
      (direction "left")
      (x 450)
      (y 1060)
      (glinting #f)
    )
    (viciousivy
      (z-pos 50)
      (direction "left")
      (x 898)
      (y 868)
      (glinting #f)
    )
    (viciousivy
      (z-pos 50)
      (direction "left")
      (x 3074)
      (y 996)
      (glinting #f)
    )
    (zeekling
      (z-pos 50)
      (direction "left")
      (x 7744)
      (y 576)
      (glinting #f)
    )
  )
)
