(supertux-level
  (version 3)
  (name (_ "Duct Ape"))
  (author "Christoph Sommer")
  (license "GPL 2+ / CC-by-sa 3.0")
  (allow-item-pocket "inherit")
  (icon "")
  (icon-locked "")
  (statistics
    (enable-coins #t)
    (enable-secrets #t)
  )
  (sector
    (name "main")
    (ambient-light
      (color 1 1 1)
    )
    (background
      (color 1 1 1)
      (speed 0.5)
      (image-top "images/background/bluemountain-top.png")
      (image "images/background/bluemountain-middle.png")
      (image-bottom "images/background/bluemountain-bottom.png")
    )
    (camera
      (name "Camera")
      (mode "normal")
    )
    (candle
      (z-pos -99)
      (x 512)
      (y 512)
    )
    (candle
      (z-pos -99)
      (x 544)
      (y 832)
    )
    (candle
      (z-pos -99)
      (x 96)
      (y 960)
    )
    (candle
      (z-pos -99)
      (x 704)
      (y 544)
    )
    (candle
      (z-pos -99)
      (x 1408)
      (y 576)
    )
    (candle
      (z-pos -99)
      (x 160)
      (y 1376)
    )
    (candle
      (z-pos -99)
      (x 320)
      (y 416)
    )
    (candle
      (z-pos -99)
      (x 800)
      (y 960)
    )
    (candle
      (z-pos -99)
      (x 1632)
      (y 544)
    )
    (candle
      (z-pos -99)
      (x 1760)
      (y 544)
    )
    (candle
      (z-pos -99)
      (x 1024)
      (y 416)
    )
    (firefly
      (z-pos 0)
      (x 1296)
      (y 704)
    )
    (flame
      (z-pos 150)
      (x 1216)
      (y 1472)
    )
    (flame
      (z-pos 150)
      (x 848)
      (y 1472)
    )
    (flame
      (z-pos 150)
      (x 752)
      (y 704)
    )
    (flame
      (z-pos 150)
      (x 2080)
      (y 1632)
    )
    (jumpy
      (type "wooden")
      (z-pos 50)
      (x 976)
      (y 1408)
      (glinting #f)
    )
    (jumpy
      (type "wooden")
      (z-pos 50)
      (x 1792)
      (y 1408)
      (glinting #f)
    )
    (jumpy
      (type "wooden")
      (z-pos 50)
      (x 1600)
      (y 992)
      (glinting #f)
    )
    (jumpy
      (type "wooden")
      (z-pos 50)
      (x 1920)
      (y 992)
      (glinting #f)
    )
    (mrbomb
      (z-pos 50)
      (x 608)
      (y 912)
      (glinting #f)
    )
    (mrbomb
      (z-pos 50)
      (x 896)
      (y 496)
      (glinting #f)
    )
    (mrbomb
      (z-pos 50)
      (direction "left")
      (x 1792)
      (y 592)
      (glinting #f)
    )
    (mrbomb
      (z-pos 50)
      (direction "right")
      (x 1568)
      (y 592)
      (glinting #f)
    )
    (music
      (file "music/fortress.music")
    )
    (path
      (name "gen17730100552846001429632")
      (path
        (adapt_speed #f)
        (node
          (x 1168)
          (y 1728)
          (time 8)
        )
        (node
          (x 1168)
          (y 1490)
          (time 8)
        )
      )
    )
    (path
      (name "gen17730100552846001428816")
      (path
        (adapt_speed #f)
        (node
          (x 3008)
          (y 1792)
          (time 3)
        )
        (node
          (x 3008)
          (y 1472)
          (time 2)
        )
        (node
          (x 3008)
          (y 1472)
          (time 3)
        )
      )
    )
    (path
      (name "gen17730100552846001429904")
      (path
        (adapt_speed #f)
        (node
          (x 1248)
          (y 544)
          (time 8)
        )
        (node
          (x 1248)
          (y 448)
          (time 8)
        )
      )
    )
    (path
      (name "gen17730100552846001429088")
      (path
        (adapt_speed #f)
        (node
          (x 160)
          (y 864)
          (time 8)
        )
        (node
          (x 160)
          (y 960)
          (time 8)
        )
      )
    )
    (platform
      (z-pos 50)
      (handle
        (scale_x 0)
        (scale_y 0)
        (offset_x 0)
        (offset_y 0)
      )
      (running #f)
      (name "lavalift1")
      (path-ref "gen17730100552846001429632")
    )
    (platform
      (z-pos 50)
      (handle
        (scale_x 0)
        (scale_y 0)
        (offset_x 0)
        (offset_y 0)
      )
      (running #f)
      (name "lift1")
      (path-ref "gen17730100552846001428816")
      (sprite "images/objects/platforms/big.sprite")
    )
    (platform
      (z-pos 50)
      (handle
        (scale_x 0)
        (scale_y 0)
        (offset_x 0)
        (offset_y 0)
      )
      (running #f)
      (name "lid1")
      (path-ref "gen17730100552846001429904")
      (sprite "images/objects/platforms/big.sprite")
    )
    (platform
      (z-pos 50)
      (handle
        (scale_x 0)
        (scale_y 0)
        (offset_x 0)
        (offset_y 0)
      )
      (running #f)
      (name "lid2")
      (path-ref "gen17730100552846001429088")
      (sprite "images/objects/platforms/big.sprite")
    )
    (pushbutton
      (z-pos -99)
      (script "lavalift1.goto_node(1);")
      (x 1569)
      (y 1746)
    )
    (pushbutton
      (z-pos -99)
      (script "lid1.goto_node(1);")
      (x 481)
      (y 500)
    )
    (pushbutton
      (z-pos -99)
      (script "lid2.goto_node(1);")
      (x 1697)
      (y 594)
    )
    (scripttrigger
      (script "lift1.goto_node(1);
lift1.goto_node(0);")
      (button #f)
      (width 92)
      (height 32)
      (x 3040)
      (y 1760)
    )
    (sequencetrigger
      (sequence "endsequence")
      (width 508)
      (height 252)
      (x 2720)
      (y 64)
    )
    (sequencetrigger
      (sequence "stoptux")
      (width 156)
      (height 252)
      (x 3072)
      (y 64)
    )
    (spawnpoint
      (name "main")
      (x 544)
      (y 1344)
    )
    (spiky
      (z-pos 50)
      (x 1648)
      (y 1424)
      (glinting #f)
    )
    (spiky
      (z-pos 50)
      (x 2784)
      (y 1744)
      (glinting #f)
    )
    (tilemap
      (solid #f)
      (z-pos -150)
      (name "BGTiles")
      (width 100)
      (height 64)
      (tiles -580 1478 1517 -6 1478 1517 -6 1478 1517 -85 1478 1518 -6 1478 1518 -6 1478 1518 -377 1478 1517 -99 1478 1518 -400 1478 1517 -99 1478 1518 -121 1478 1517 1478 1517 -97 1478 1518 1478 1518 -174 1478 1517 -99 1478 1518 -765 1478 1517 -6 1478 1517 -6 1478 1517 -6 1478 1517 -6 1478 1517 -6 1478 1517 -64 1478 1518 -6 1478 1518 -6 1478 1518 -6 1478 1518 -6 1478 1518 -6 1478 1518 -21 1478 1517 1478 1517 -97 1478 1518 1478 1518 -1019 1478 1517 -6 1478 1517 -6 1478 1517 -6 1478 1517 -6 1478 1517 -6 1478 1517 -6 1478 1517 -6 1478 1517 -6 1478 1517 -6 1478 1517 -6 1478 1517 -6 1478 1517 -22 1478 1518 -6 1478 1518 -6 1478 1518 -6 1478 1518 -6 1478 1518 -6 1478 1518 -6 1478 1518 -6 1478 1518 -6 1478 1518 -6 1478 1518 -6 1478 1518 -6 1478 1518 -371 1478 1517 -6 1478 1517 -6 1478 1517 -13 1478 1517 -71 1478 1518 -6 1478 1518 -6 1478 1518 -13 1478 1518 -385 1478 1517 -6 1478 1517 -6 1478 1517 -85 1478 1518 -6 1478 1518 -6 1478 1518 -1005 1478)
    )
    (tilemap
      (solid #t)
      (z-pos 0)
      (width 100)
      (height 64)
      (tiles -5 1372 1373 -2 0 1370 1368 -12 1372 1373 -2 0 1404 -42 1372 1373 -2 0 1404 -33 1372 1373 -2 0 1404 -13 1372 1373 -2 0 1404 -42 1372 1373 -2 0 1404 -33 1372 1373 -2 0 1404 -13 1372 1373 -2 0 1404 -42 1372 1373 -2 0 1374 -28 1376 -5 1372 1373 -2 0 1404 -13 1372 1373 -2 0 1404 -42 1372 1373 -31 0 -5 1372 1373 -2 0 1404 -13 1372 1373 -2 0 1404 -42 1372 1373 -31 0 -5 1372 1373 -2 0 1404 -13 1372 1373 -2 0 1404 -42 1372 1373 -31 0 -5 1372 1373 -2 0 1404 -13 1372 1373 -2 0 1404 -42 1372 1373 -31 0 -5 1372 1373 -2 0 1404 -13 1372 1373 -2 0 1404 -42 1372 1373 -31 0 -5 1372 1373 -2 0 1404 -13 1372 1373 -2 0 1404 -42 1372 1381 1412 1388 -29 0 -5 1372 1373 -2 0 1404 -13 1372 1373 -2 0 1404 -42 1372 1373 -8 0 1370 1368 -21 1379 -5 1372 1373 -2 0 1404 -13 1372 1373 -2 0 1404 -42 1372 1373 -8 0 1404 -27 1372 1373 -2 0 1404 -13 1372 1373 -2 0 1404 -42 1372 1373 -8 0 1404 -27 1372 1373 -2 0 1404 -13 1372 1373 -2 0 1404 -42 1372 1373 -8 0 1404 -26 1372 1406 1377 -2 0 1393 1394 1405 -2 1372 1406 -3 1376 1394 -3 1372 1406 1377 -2 0 1393 1394 -5 1372 1405 -5 1372 1406 -4 1376 1394 -2 1372 1406 -12 1376 1394 -8 1372 1373 -6 0 1408 1412 1396 -26 1372 1373 -4 0 1374 -3 1376 1377 -3 0 1404 -3 1372 1373 -4 0 1374 -11 1376 1407 -4 0 1374 -2 1376 1377 -12 0 1404 -8 1372 1373 -8 0 1404 -5 1372 1406 -4 1376 1394 -4 1372 1406 -5 1376 1394 -4 1372 1373 0 -2 44 -9 0 1404 -3 1372 1373 0 -2 44 -15 0 -2 44 -6 0 -10 44 0 1404 -8 1372 1373 -8 0 1404 -5 1372 1373 -4 0 1374 -4 1376 1377 -5 0 1404 -4 1372 1373 0 -2 44 -7 0 61 0 1404 -3 1372 1373 0 -2 44 -15 0 -2 44 -6 0 -10 44 0 1404 -8 1372 1373 -8 0 1404 -5 1372 1373 0 -2 44 -7 0 44 -3 128 44 1404 -4 1372 1373 -4 0 1400 -7 1368 1371 -3 1372 1373 -4 0 1400 -11 1368 1380 -4 0 1400 -2 1368 1384 -12 0 1404 -8 1372 1381 1412 1388 -6 0 1404 -5 1372 1373 0 -2 44 -7 0 -5 44 1404 -4 1372 1383 1384 -2 0 1370 1371 -11 1372 1383 1384 -2 0 1370 1371 -11 1372 1383 1384 -2 0 1370 1371 1405 1372 1373 -12 0 1404 -8 1372 1373 -8 0 1404 -5 1372 1373 -4 0 1400 -4 1368 1384 -5 44 1404 -5 1372 1373 -2 0 1404 -13 1372 1373 -2 0 1404 -13 1372 1373 -2 0 1404 -3 1372 1373 -6 0 61 -5 0 1404 -8 1372 1373 -8 0 1404 -5 1372 1383 1384 -2 0 1370 1371 -4 1372 1373 -5 44 1404 -5 1372 1373 -2 0 1404 -13 1372 1373 -2 0 1404 -13 1372 1373 -2 0 1404 -3 1372 1383 1368 -8 1379 1391 1379 1368 1371 -8 1372 1373 -8 0 1404 -6 1372 1373 -2 0 1404 -5 1372 1373 -5 0 1404 -5 1372 1373 -2 0 1404 -13 1372 1373 -2 0 1404 -13 1372 1373 -2 0 1404 -25 1372 1373 -5 0 1408 -2 1412 1396 -6 1372 1373 -2 0 1404 -5 1372 1383 1368 -4 1379 1371 -5 1372 1373 -2 0 1404 -13 1372 1373 -2 0 1404 -13 1372 1373 -2 0 1404 -25 1372 1373 -8 0 1404 -6 1372 1373 -2 0 1404 -17 1372 1373 -2 0 1404 -13 1372 1373 -2 0 1404 -13 1372 1373 -2 0 1404 -25 1372 1373 -8 0 1404 -6 1372 1373 -2 0 1404 -17 1372 1373 -2 0 1404 -6 1372 1406 -2 1376 1394 -3 1372 1373 -2 0 1404 -13 1372 1373 -2 0 1404 -25 1372 1381 1412 1388 -6 0 1404 -6 1372 1373 -2 0 1404 -17 1372 1373 -2 0 1404 -6 1372 1373 -2 0 1404 -3 1372 1373 -2 0 1404 -13 1372 1373 -2 0 1404 -25 1372 1373 -8 0 1404 -6 1372 1373 -2 0 1404 -16 1372 1406 1377 -2 0 1374 1394 -3 1372 1406 1376 1377 -2 0 1404 -2 1372 1406 1377 -2 0 1393 1394 -4 1372 1406 -7 1376 1377 -2 0 1374 -25 1376 1377 -8 0 1404 -6 1372 1373 -2 0 1404 -16 1372 1373 -4 0 1374 -3 1376 1407 -3 0 1408 1413 -2 1376 1377 -4 0 1404 -4 1372 1373 -45 0 1404 -5 1372 1406 1377 -2 0 1374 1394 -4 1372 1406 -5 1376 1394 -4 1372 1373 0 -2 44 -15 0 -2 44 0 1404 -4 1372 1373 -43 0 1408 1412 1396 -5 1372 1373 -4 0 1374 -4 1376 1377 -5 0 1404 -4 1372 1373 0 -2 44 -15 0 -2 44 0 1404 -4 1372 1373 -2 0 83 102 -2 83 -39 0 1404 -5 1372 1373 0 -2 44 -7 0 -5 44 1404 -3 1372 1405 1373 -4 0 1400 -11 1368 1392 -4 0 1404 -4 1372 1373 -45 0 1404 -5 1372 1373 0 -2 44 -7 0 -5 44 1404 -4 1372 1383 1384 -2 0 1370 1371 -11 1372 1383 1368 -3 1379 1371 -4 1372 1373 -45 0 1404 -5 1372 1373 -4 0 1400 -4 1368 1384 -5 44 1404 -5 1372 1373 -2 0 1404 -22 1372 1373 -45 0 1404 -5 1372 1383 1384 -2 0 1370 1371 -4 1372 1373 -5 44 1404 -5 1372 1373 -2 0 1404 -22 1372 1383 1368 -34 1379 1368 1384 -3 0 1370 1384 -3 0 1404 -6 1372 1373 -2 0 1404 -5 1372 1373 -5 0 1404 -5 1372 1373 -2 0 1404 -59 1372 1373 -3 0 1404 1373 -3 0 1404 -6 1372 1373 -2 0 1404 -5 1372 1383 1368 -4 1379 1371 -5 1372 1373 -2 0 1404 -59 1372 1373 -3 0 1404 1373 -3 0 1404 -6 1372 1373 -2 0 1404 -17 1372 1373 -2 0 1404 -59 1372 1383 -3 1368 1371 1383 -3 1368 1371 -6 1372 1373 -2 0 1404 -17 1372 1373 -2 0 1404 -75 1372 1373 -2 0 1404 -17 1372 1373 -2 0 1404 -23 1372 1406 -11 1376 1394 -39 1372 1373 -2 0 1404 -16 1372 1406 1377 -2 0 1393 1394 -2 1372 1406 -19 1376 1377 -11 0 1397 -39 1376 1377 -2 0 1374 -10 1376 1394 -5 1372 1373 -4 0 1374 -2 1376 1377 -85 0 1404 -5 1372 1373 0 -2 44 -90 0 1404 -5 1372 1373 0 -2 44 -2 0 340 -2 338 341 339 -4 0 -3 83 102 -75 0 1404 -5 1372 1373 -4 0 1400 -2 1368 1384 0 77 -83 0 1404 -5 1372 1383 1368 -3 1379 1371 -2 1372 1373 -2 77 -68 0 -2 77 -13 0 1404 -7 1372 1395 -5 1372 1373 -3 77 -38 0 1568 -27 0 -3 77 -3 0 -3 77 -7 0 1404 -13 1372 1383 -11 1368 1384 -4 0 1370 -3 1368 1384 -9 0 1370 -14 1368 1380 -22 0 1370 -10 1368 1384 -5 0 1404 -25 1372 1373 -4 0 1404 -3 1372 1373 -9 0 1404 -14 1372 1383 1368 1380 -20 0 1404 -10 1372 1373 -5 0 1404 -25 1372 1383 1368 -2 1379 1368 1371 -3 1372 1373 -9 0 1404 -16 1372 1383 1368 1380 -18 0 1404 -10 1372 1373 -5 0 1404 -34 1372 1373 -9 0 1404 -18 1372 1383 1368 1380 -16 0 1374 -10 1376 1377 -5 0 1404 -34 1372 1373 -9 0 1404 -2 1372 1406 -5 1376 1394 -11 1372 1383 1368 1380 -31 0 1404 -34 1372 1373 -9 0 1404 -2 1372 1373 -5 0 1397 -4 1376 1394 -8 1372 1383 1368 1380 -29 0 1404 -34 1372 1373 -9 0 1404 -2 1372 1373 -10 0 1397 -10 1376 1414 1412 1388 -12 0 83 102 -2 83 -11 0 1404 -34 1372 1373 -9 0 1404 -2 1372 1373 -51 0 1404 -34 1372 1373 -9 0 1404 -2 1372 1373 -26 0 1367 1380 -23 0 1404 -34 1372 1373 -9 0 1404 -2 1372 1373 -2 0 61 -2 0 1400 -20 1368 1371 1383 1368 1392 -12 0 1568 -8 0 1404 -34 1372 1383 1368 -7 1379 1368 1371 -2 1372 1383 -5 1368 1371 -23 1372 1383 -16 1368 1380 -4 0 1404 -94 1372 1383 -4 1368 1371 -601 1372)
    )
    (tilemap
      (solid #f)
      (z-pos 100)
      (width 100)
      (height 64)
      (tiles -69 0 1742 1743 -6329 0)
    )
    (tilemap
      (solid #f)
      (z-pos -100)
      (name "BG")
      (width 100)
      (height 64)
      (tiles -284 0 129 -99 0 129 -99 0 129 -99 0 129 -99 0 129 -99 0 129 -99 0 129 -99 0 129 -354 0 79 -2 0 79 -85 0 79 -10 0 79 -2 0 79 -85 0 79 -10 0 79 -2 0 79 -73 0 -2 1719 -10 0 79 -10 0 79 -2 0 79 -85 0 79 -10 0 79 -2 0 79 -96 0 79 -2 0 79 -8 0 1355 -3 0 1355 -62 0 1719 -16 0 -4 1719 -5 0 -2 1719 -5 0 1411 -3 0 1411 -649 0 79 -2 0 79 -96 0 79 -2 0 79 -2 0 79 -7 0 79 -85 0 79 -2 0 79 -2 0 79 -7 0 79 -85 0 79 -2 0 79 -2 0 79 -7 0 79 -85 0 79 -2 0 79 -2 0 79 -7 0 79 -85 0 79 -2 0 79 -196 0 -4 1719 -396 0 -4 1719 -285 0 79 -2 0 79 -13 0 79 -82 0 79 -2 0 79 -96 0 79 -2 0 79 -96 0 79 -2 0 79 -13 0 79 -82 0 79 -2 0 79 -83 0 1608 1609 -11 0 79 -2 0 79 -83 0 1610 1611 -11 0 1349 -2 0 1349 -96 0 79 -2 0 79 -96 0 79 -2 0 79 -96 0 79 -2 0 79 -96 0 79 -2 0 79 -96 0 79 -2 0 79 -96 0 79 -2 0 79 -96 0 79 -2 0 79 -96 0 79 -2 0 79 -40 0 1348 -55 0 79 -2 0 79 -40 0 2003 -10 1719 -45 0 79 -2 0 79 -40 0 79 -55 0 79 -2 0 79 -96 0 79 -2 0 79 -602 0)
    )
    (tilemap
      (solid #t)
      (z-pos 90)
      (name "Lava")
      (width 100)
      (height 64)
      (tiles -3368 0 -10 1708 -90 0 -10 1705 -90 0 -10 1700 -90 0 -10 1700 -946 0 -6 1708 -3 0 -11 1708 -80 0 -6 1705 -3 0 -11 1705 -80 0 -5 1700 1705 -3 0 -11 1700 -89 0 -11 1700 -89 0 -11 1700 -89 0 -11 1700 -89 0 -11 1700 -89 0 -11 1700 -89 0 -11 1700 -89 0 -11 1706 -856 0)
    )
    (tilemap
      (solid #f)
      (z-pos 95)
      (name "LavaBorder")
      (width 100)
      (height 64)
      (tiles -3368 0 1384 -3 0 1370 1384 -3 0 1404 -87 0 -3 1372 1373 -3 0 1404 1373 -3 0 1404 -87 0 -3 1372 1373 -3 0 1404 1373 -3 0 1404 -87 0 -3 1372 1383 -3 1368 1371 1383 -3 1368 1371 -87 0 -6 1372 -853 0 1384 -4 0 1370 -3 0 1384 -9 0 1370 -80 0 1373 -4 0 1404 -3 0 1373 -9 0 1404 -80 0 1383 1368 -2 1379 1368 1371 -3 0 1373 -9 0 1404 -89 0 1373 -9 0 1404 -89 0 1373 -9 0 1404 -89 0 1373 -9 0 1404 -89 0 1373 -9 0 1404 -89 0 1373 -9 0 1404 -89 0 1373 -9 0 1404 -89 0 1373 -9 0 1404 -89 0 1383 1368 -7 1379 1368 1371 -756 0)
    )
    (trampoline
      (z-pos 50)
      (x 752)
      (y 960)
    )
    (trampoline
      (z-pos 50)
      (x 2720)
      (y 1440)
    )
  )
)
