(supertux-level
  (version 3)
  (name (_ "A Short Visit to El Castillo"))
  (author "Christoph Sommer")
  (license "GPL 2+ / CC-by-sa 3.0")
  (allow-item-pocket "inherit")
  (icon "")
  (icon-locked "")
  (statistics
    (enable-coins #t)
    (enable-secrets #t)
  )
  (sector
    (name "main")
    (init-script "droptrap_fired <- false;")
    (ambient-light
      (color 1 1 1)
    )
    (background
      (scroll-offset-y -30)
      (color 1 1 1)
      (speed 0.5)
      (image-top "images/background/BlueRock_Forest/blue-top.jpg")
      (image "images/background/BlueRock_Forest/blue-middle.jpg")
      (image-bottom "images/background/BlueRock_Forest/blue-bottom.jpg")
    )
    (camera
      (name "Camera")
      (mode "normal")
    )
    (candle
      (z-pos -99)
      (x 2848)
      (y 1856)
    )
    (candle
      (z-pos -99)
      (x 3040)
      (y 1856)
    )
    (darttrap
      (z-pos -1)
      (initial-delay 0)
      (fire-delay 2)
      (ammo -1)
      (x 3508)
      (y 1053)
      (dart-sprite "images/creatures/darttrap/granito/root_dart.sprite")
    )
    (darttrap
      (z-pos -1)
      (initial-delay 0)
      (fire-delay 2)
      (ammo -1)
      (x 3508)
      (y 1137)
      (dart-sprite "images/creatures/darttrap/granito/root_dart.sprite")
    )
    (darttrap
      (z-pos -1)
      (initial-delay 0)
      (fire-delay 2)
      (ammo -1)
      (x 5364)
      (y 1280)
      (dart-sprite "images/creatures/darttrap/granito/root_dart.sprite")
    )
    (darttrap
      (type "skull")
      (z-pos -1)
      (initial-delay 0)
      (fire-delay 2)
      (ammo -1)
      (direction "right")
      (x 4993)
      (y 1392)
      (dart-sprite "images/creatures/darttrap/granito/root_dart.sprite")
    )
    (firefly
      (z-pos 0)
      (x 4256)
      (y 928)
    )
    (firefly
      (z-pos 0)
      (x 4448)
      (y 1792)
    )
    (firefly
      (z-pos 0)
      (x 4740.533)
      (y 1329.5)
    )
    (haywire
      (z-pos 50)
      (direction "right")
      (x 4069)
      (y 1864)
      (glinting #f)
    )
    (jumpy
      (z-pos 50)
      (x 2661.577)
      (y 858.8568)
      (glinting #f)
    )
    (mrbomb
      (z-pos 50)
      (x 4743.478)
      (y 944.7149)
      (glinting #f)
    )
    (mrbomb
      (z-pos 50)
      (direction "left")
      (x 2853)
      (y 1192)
      (glinting #f)
    )
    (mrtree
      (z-pos 50)
      (x 704)
      (y 1664)
      (glinting #f)
    )
    (music
      (file "music/fortress.music")
    )
    (path
      (name "gen1772929499104989813132304")
      (path
        (adapt_speed #f)
        (node
          (x 3648)
          (y 1440)
          (time 0.5)
        )
        (node
          (x 3648)
          (y 1504)
          (time 0.25)
        )
        (node
          (x 3392)
          (y 1504)
          (time 2)
        )
        (node
          (x 3392)
          (y 1504)
          (time 0.25)
        )
        (node
          (x 3648)
          (y 1504)
          (time 0.5)
        )
      )
    )
    (path
      (name "gen1772929499104989799490896")
      (path
        (adapt_speed #f)
        (node
          (x 3520)
          (y 1440)
          (time 0.5)
        )
        (node
          (x 3520)
          (y 1472)
          (time 0.25)
        )
        (node
          (x 3392)
          (y 1472)
          (time 2)
        )
        (node
          (x 3392)
          (y 1472)
          (time 0.25)
        )
        (node
          (x 3520)
          (y 1472)
          (time 0.5)
        )
      )
    )
    (path
      (name "gen1772929499104989819878272")
      (path
        (adapt_speed #f)
        (node
          (x 3904)
          (y 1440)
          (time 0.5)
        )
        (node
          (x 3904)
          (y 1472)
          (time 0.25)
        )
        (node
          (x 4032)
          (y 1472)
          (time 2)
        )
        (node
          (x 4032)
          (y 1472)
          (time 0.25)
        )
        (node
          (x 3904)
          (y 1472)
          (time 0.5)
        )
      )
    )
    (path
      (name "gen1772929499104989813909280")
      (path
        (adapt_speed #f)
        (node
          (x 3776)
          (y 1440)
          (time 0.5)
        )
        (node
          (x 3776)
          (y 1504)
          (time 0.25)
        )
        (node
          (x 4032)
          (y 1504)
          (time 2)
        )
        (node
          (x 4032)
          (y 1504)
          (time 0.25)
        )
        (node
          (x 3776)
          (y 1504)
          (time 0.5)
        )
      )
    )
    (path
      (name "gen1772929499104989822157776")
      (path
        (adapt_speed #f)
        (node
          (x 2208)
          (y 1760)
          (time 0.8)
        )
        (node
          (x 2208)
          (y 1696)
          (time 0.8)
        )
      )
    )
    (path
      (name "gen1772929499104989822158176")
      (path
        (adapt_speed #f)
        (node
          (x 3200)
          (y 1568)
        )
        (node
          (x 3200)
          (y 1664)
          (time 3)
        )
      )
    )
    (path
      (name "gen1772929499104989797377184")
      (path
        (adapt_speed #f)
        (node
          (x 2688)
          (y 1568)
        )
        (node
          (x 2688)
          (y 1664)
          (time 3)
        )
      )
    )
    (path
      (name "gen1772929499104989804838224")
      (path
        (adapt_speed #f)
        (node
          (x 2912)
          (y 1632)
        )
        (node
          (x 3008)
          (y 1632)
          (time 0.2)
        )
      )
    )
    (path
      (name "gen1772929499104989797369472")
      (path
        (adapt_speed #f)
        (node
          (x 4224)
          (y 1504)
        )
      )
    )
    (platform
      (z-pos 50)
      (handle
        (scale_x 0)
        (scale_y 0)
        (offset_x 0)
        (offset_y 0)
      )
      (running #f)
      (name "trapdoor2")
      (path-ref "gen1772929499104989813132304")
      (sprite "images/objects/platforms/big.sprite")
    )
    (platform
      (z-pos 50)
      (handle
        (scale_x 0)
        (scale_y 0)
        (offset_x 0)
        (offset_y 0)
      )
      (running #f)
      (name "trapdoor1")
      (path-ref "gen1772929499104989799490896")
      (sprite "images/objects/platforms/big.sprite")
    )
    (platform
      (z-pos 50)
      (handle
        (scale_x 0)
        (scale_y 0)
        (offset_x 0)
        (offset_y 0)
      )
      (running #f)
      (name "trapdoor4")
      (path-ref "gen1772929499104989819878272")
      (sprite "images/objects/platforms/big.sprite")
    )
    (platform
      (z-pos 50)
      (handle
        (scale_x 0)
        (scale_y 0)
        (offset_x 0)
        (offset_y 0)
      )
      (running #f)
      (name "trapdoor3")
      (path-ref "gen1772929499104989813909280")
      (sprite "images/objects/platforms/big.sprite")
    )
    (platform
      (z-pos 50)
      (handle
        (scale_x 0)
        (scale_y 0)
        (offset_x 0)
        (offset_y 0)
      )
      (running #f)
      (name "maindoor")
      (path-ref "gen1772929499104989822157776")
      (sprite "images/objects/platforms/vertical-wood.sprite")
    )
    (platform
      (z-pos 50)
      (handle
        (scale_x 0)
        (scale_y 0)
        (offset_x 0)
        (offset_y 0)
      )
      (running #f)
      (name "dropdoor1")
      (path-ref "gen1772929499104989822158176")
      (sprite "images/objects/platforms/vertical-wood.sprite")
    )
    (platform
      (z-pos 50)
      (handle
        (scale_x 0)
        (scale_y 0)
        (offset_x 0)
        (offset_y 0)
      )
      (running #f)
      (name "dropdoor2")
      (path-ref "gen1772929499104989797377184")
      (sprite "images/objects/platforms/vertical-wood.sprite")
    )
    (platform
      (z-pos 50)
      (handle
        (scale_x 0)
        (scale_y 0)
        (offset_x 0)
        (offset_y 0)
      )
      (running #f)
      (name "dropdoor3")
      (path-ref "gen1772929499104989804838224")
      (sprite "images/objects/platforms/big.sprite")
    )
    (scripttrigger
      (script "trapdoor1.goto_node(1);
trapdoor2.goto_node(1);
trapdoor3.goto_node(1);
trapdoor4.goto_node(1);
trapdoor1.goto_node(0);
trapdoor2.goto_node(0);
trapdoor3.goto_node(0);
trapdoor4.goto_node(0);
")
      (button #f)
      (width 32)
      (height 204)
      (x 3488)
      (y 1236)
    )
    (scripttrigger
      (script "if (!droptrap_fired) {
droptrap_fired <- true;
dropdoor1.goto_node(1);
dropdoor2.goto_node(1);
wait(2);
dropdoor3.goto_node(1);
}")
      (button #f)
      (width 72)
      (height 224)
      (x 3092)
      (y 1684)
    )
    (scripttrigger
      (script "maindoor.goto_node(1);")
      (button #f)
      (width 60)
      (height 124)
      (x 2496)
      (y 1760)
    )
    (secretarea
      (fade-tilemap "secret1")
      (width 307.9458)
      (height 178.6429)
      (x 4244)
      (y 1492)
    )
    (sequencetrigger
      (sequence "endsequence")
      (width 60)
      (height 156)
      (x 2496)
      (y 1760)
    )
    (sequencetrigger
      (sequence "stoptux")
      (width 0.5)
      (height 156)
      (x 2211.5)
      (y 1760)
    )
    (snail
      (z-pos 50)
      (x 2247.391)
      (y 1626.366)
      (glinting #f)
    )
    (snail
      (z-pos 50)
      (x 2541.547)
      (y 1395.849)
      (glinting #f)
    )
    (snail
      (z-pos 50)
      (x 3688.475)
      (y 502.0661)
      (glinting #f)
    )
    (snail
      (z-pos 50)
      (x 5060.145)
      (y 1564.259)
      (glinting #f)
    )
    (spawnpoint
      (name "main")
      (x 96)
      (y 1664)
    )
    (spawnpoint
      (x 5152)
      (y 1408)
    )
    (tilemap
      (solid #f)
      (z-pos -100)
      (name "Background")
      (width 224)
      (height 80)
      (tiles -827 0 85 86 87 88 -220 0 89 90 91 92 -442 0 85 86 87 88 -220 0 89 90 91 92 -2015 0 1608 1609 -191 0 -7 1478 -24 0 1610 1611 -158 0 85 86 87 88 -29 0 -7 1478 -16 0 402 403 404 405 -130 0 85 86 87 88 -12 0 85 86 87 88 -14 0 89 90 91 92 -29 0 -7 1478 -16 0 406 407 408 409 -77 0 85 86 87 88 -16 0 85 86 87 88 -12 0 85 86 87 88 -13 0 89 90 91 92 -12 0 89 90 91 92 -5 0 85 86 87 88 -38 0 -7 1478 -16 0 410 411 420 421 -77 0 89 90 91 92 -16 0 89 90 91 92 -12 0 89 90 91 92 0 85 86 87 88 -17 0 85 86 87 88 -12 0 89 90 91 92 -17 0 1000 1001 -2 1002 -17 0 -7 1478 -16 0 414 415 424 425 -87 0 85 86 87 88 -15 0 85 86 87 88 -8 0 89 90 91 92 -2 0 85 86 87 88 -11 0 89 90 91 92 -54 0 -7 1478 -107 0 89 90 91 92 -15 0 89 90 91 92 -14 0 89 90 91 92 -69 0 -7 1478 -217 0 -7 1478 -195 0 -48 1478 -176 0 -48 1478 -176 0 -48 1478 -176 0 -48 1478 -176 0 -34 1478 1628 1629 -12 1478 -149 0 1348 -7 0 1348 -18 0 -34 1478 1630 1631 -12 1478 -13 0 1009 -135 0 79 -7 0 79 -19 0 -6 1478 -3 0 -12 1478 -14 0 -7 1510 -18 0 1009 -135 0 79 -7 0 79 -11 0 -14 1478 -3 0 -11 1478 -15 0 -7 1478 -9 0 -10 1478 -135 0 79 -7 0 79 -11 0 -14 1478 -3 0 -11 1478 -15 0 -7 1478 -9 0 -10 1478 -135 0 79 -7 0 79 -11 0 -14 1478 -3 0 -11 1478 -15 0 -7 1478 -9 0 -10 1478 -135 0 79 -7 0 79 -11 0 -14 1478 -3 0 -11 1478 -15 0 -7 1478 -9 0 -9 1478 -128 0 1348 -7 0 79 -7 0 79 -11 0 -14 1478 -3 0 -11 1478 -15 0 -7 1478 -9 0 -8 1478 -129 0 1348 -7 0 1348 -7 0 1349 -11 0 -14 1478 -3 0 -11 1478 -15 0 -7 1478 -9 0 -8 1478 -129 0 79 -7 0 79 -19 0 -9 1478 -51 0 -6 1478 -130 0 79 -7 0 79 -18 0 -56 1478 -5 0 -12 1478 -124 0 79 -7 0 79 -18 0 -56 1478 -5 0 -12 1478 -66 0 1073 1074 1075 -23 0 1073 1074 1075 -29 0 79 -7 0 79 -18 0 -56 1478 -5 0 -12 1478 -66 0 1081 1082 1083 1084 -22 0 1081 1082 1083 1084 -28 0 79 -7 0 79 -18 0 -56 1478 -5 0 -12 1478 -65 0 1088 1089 1090 1091 1092 1093 -20 0 1088 1089 1090 1091 1092 1093 -27 0 79 -7 0 79 -18 0 -56 1478 -5 0 -12 1478 -64 0 1095 1096 1097 1098 1099 1100 1101 -19 0 1095 1096 1097 1098 1099 1100 1101 -19 0 1348 -7 0 79 -7 0 1349 -18 0 -56 1478 -5 0 -12 1478 -57 0 402 403 404 405 -3 0 1103 1104 1105 1106 1107 1108 1109 1110 -18 0 1103 1104 1105 1106 1107 1108 1109 1110 -18 0 79 -7 0 79 -39 0 -20 1478 -15 0 -8 1478 -5 0 -12 1478 -11 0 -2 1014 -44 0 406 407 408 409 -3 0 1111 1112 1113 1114 1115 1116 1117 1118 -18 0 1111 1112 1113 1114 1115 1116 1117 1118 -18 0 79 -7 0 79 -37 0 -36 1478 0 -18 1478 -2 0 -11 1478 -6 0 1014 -43 0 405 418 419 412 413 -3 0 1119 1120 1121 1122 1123 1124 1125 1126 -2 0 402 403 404 405 -12 0 1119 1120 1121 1122 1123 1124 1125 1126 -18 0 79 -7 0 79 -37 0 -30 1478 -3 0 -3 1478 0 -18 1478 -2 0 -11 1478 -50 0 409 422 423 416 417 -3 0 1127 1128 1129 1130 1131 1132 1133 1134 -2 0 406 407 408 409 -12 0 1127 1128 1129 1130 1131 1132 1133 1134 -12 0 1073 1074 1075 -3 0 79 -7 0 79 -41 0 -18 1478 -2 0 -31 1478 -2 0 -11 1478 -6 0 200 -43 0 427 428 429 412 413 402 403 404 405 0 1137 1138 1139 1140 -4 0 410 411 412 413 402 403 404 405 0 402 403 404 405 402 403 436 437 404 405 1138 1139 1140 -4 0 402 403 404 405 -6 0 1081 1082 1083 1084 -2 0 79 -7 0 79 -41 0 -18 1478 -6 0 -27 1478 -2 0 -11 1478 -6 0 200 -43 0 431 432 433 416 417 406 407 408 409 0 1145 1146 1147 1148 -4 0 414 415 416 417 406 407 408 409 0 406 407 408 409 406 407 440 441 408 409 1146 1147 1148 -4 0 406 407 408 409 -5 0 1088 1089 1090 1091 1092 1093 0 79 -7 0 79 -41 0 -18 1478 -6 0 -24 1478 -2 0 1478 -2 0 1478 0 -9 1478 -50 0 443 444 445 426 427 428 429 412 413 0 1153 1154 1155 1156 402 403 404 405 410 411 426 427 428 429 420 421 0 410 411 426 427 428 429 442 443 412 413 1154 1155 1156 402 403 404 405 410 411 420 421 -4 0 1095 1096 1097 1098 1099 1100 1101 0 79 -7 0 1349 -41 0 -18 1478 -6 0 -23 1478 -3 0 1478 -2 0 1478 -3 0 -7 1478 -50 0 447 448 449 430 431 432 433 416 417 0 1161 1162 1163 1164 406 407 408 409 414 415 430 431 432 433 424 425 0 414 415 430 431 432 433 446 447 416 417 1162 1163 1164 406 407 408 409 414 415 424 425 -4 0 1103 1104 1105 1106 1107 1108 1109 1110 79 -95 0 1478 -11 0 -6 1478 -2 0 1017 1018 -60 0 410 411 426 427 428 429 442 443 444 445 412 413 -14 0 410 411 426 427 428 429 412 413 402 403 404 405 1111 1112 1113 1114 1115 1116 1117 1118 79 -7 0 -111 1478 -59 0 414 415 430 431 432 433 446 447 448 449 416 417 -14 0 414 415 430 431 432 433 416 417 406 407 408 409 1119 1120 1121 1122 1123 1124 1125 1126 79 -7 0 -111 1478 -85 0 418 419 442 443 444 445 426 427 428 429 412 413 1127 1128 1129 1130 1131 1132 1133 1134 79 -7 0 -111 1478 -85 0 422 423 446 447 448 449 430 431 432 433 416 417 -2 0 1137 1138 1139 1140 -2 0 79 -7 0 -111 1478 -99 0 1145 1146 1147 1148 -2 0 79 -7 0 -111 1478 -9 0 1482 -89 0 1153 1154 1155 1156 -2 0 1349 -7 0 -111 1478 -8 0 1482 -90 0 1161 1162 1163 1164 -12 0 -17 1478 -4 0 -3 1478 -201 0 -2 1009 -4407 0)
    )
    (tilemap
      (solid #t)
      (z-pos 0)
      (name "Interactive")
      (width 224)
      (height 80)
      (tiles -162 0 1000 1034 -60 1009 -162 0 1004 1040 -60 1009 -162 0 1008 -61 1009 -162 0 1008 -61 1009 -162 0 1008 -4 1009 1013 -56 1009 -162 0 1012 1013 -4 1009 1014 -55 1009 -161 0 1000 1034 -61 1009 -116 0 44 -23 0 44 -20 0 1004 1040 -61 1009 -160 0 1000 1034 -62 1009 -115 0 -2 84 83 -21 0 83 2947 83 -18 0 1004 1040 -62 1009 -159 0 1000 1034 -63 1009 -159 0 1004 1040 -2 1009 1014 -60 1009 -158 0 1000 1034 -64 1009 -112 0 -2 83 102 83 0 -3 84 83 -15 0 -4 83 0 -4 83 -13 0 1004 1040 -3 1009 1013 -60 1009 -118 0 77 -39 0 1008 -65 1009 -117 0 -3 77 -38 0 1008 -65 1009 -117 0 340 -6 338 341 -4 338 342 -28 0 1008 -12 1009 1013 -52 1009 -108 0 -17 1503 -7 0 -17 1503 -5 0 1000 -3 1001 1034 -65 1009 -108 0 1503 1479 1480 -2 1481 1482 1481 1482 1481 1482 1481 1482 1481 1482 1481 1482 1503 -7 0 1503 -12 1482 1483 1484 1482 1503 -5 0 1004 -3 1005 1040 -65 1009 -108 0 1503 1486 1487 1488 1481 1482 1481 1482 1481 1482 1481 1482 1481 1482 1481 1482 1503 -7 0 1503 -12 1482 1490 1491 1492 1503 -5 0 1012 1009 1013 -67 1009 -106 0 317 318 1503 1493 1494 1495 1481 1482 1481 1482 1481 1482 1481 1482 1481 1482 1481 1482 1503 -7 0 1503 -12 1482 1497 1498 1499 1503 -4 0 1000 1034 -3 1009 1014 -65 1009 -106 0 319 320 1503 1500 1501 1502 1481 1482 1481 1482 1481 1482 1481 1482 1481 1482 1481 1482 1503 -7 0 1503 -12 1482 1504 1505 1506 1503 -4 1002 1036 1040 -7 1009 1014 -61 1009 -103 0 1000 1036 1005 -2 1006 1503 1507 1508 1509 -2 1482 1481 1482 1481 1482 1481 1482 1481 1482 1481 1482 1503 -7 0 1503 -15 1482 1503 -4 1006 1040 1009 1013 -68 1009 -103 0 1004 1040 1014 1013 1009 1503 1482 1481 1482 1481 1482 1481 1482 1481 1482 1481 1482 1481 1482 1481 1482 1503 -7 0 1503 -15 1482 1503 -6 1009 1013 -68 1009 -100 0 -25 1503 -7 0 -25 1503 -3 1009 1013 -63 1009 -100 0 1503 1482 1503 -48 0 1503 -4 1482 1503 -67 1009 -100 0 1503 1482 1503 -48 0 1503 -4 1482 1503 -18 1009 1013 -48 1009 -78 0 77 -16 0 -2 84 -3 0 1503 1482 1503 -48 0 1503 -4 1482 1503 -67 1009 -77 0 -2 77 44 -20 0 1503 1482 1503 -44 0 -3 44 0 1503 -4 1482 1503 -2 1009 1013 -16 1009 1014 -47 1009 -76 0 27 -7 28 29 -15 0 1503 1482 1503 -44 0 -3 44 0 1503 -4 1482 1503 -67 1009 -100 0 1503 1482 1503 -48 0 1503 -4 1482 1503 -25 1009 1014 -41 1009 -92 0 -11 1503 1568 -3 0 -3 1568 -3 1503 -2 1568 -7 0 -2 1568 -15 1503 -7 0 -18 1503 1568 -59 1009 -92 0 1503 -2 1482 1503 -14 0 1503 1482 1503 -7 0 295 -3 0 1503 -13 1482 1503 -7 0 1503 -4 1482 -2 1496 1482 1503 -9 0 1008 -28 1009 1014 -30 1009 -73 0 104 -18 0 1503 1485 1482 1503 -14 0 1503 1482 1503 -7 0 212 -3 0 1503 -13 1482 1503 -7 0 1503 -4 1482 -2 1496 1482 1503 0 -7 44 0 1012 -59 1009 -72 0 -2 77 -2 44 -16 0 1503 -2 1482 1503 -14 0 1503 1482 1503 -3 0 295 -3 0 212 0 295 0 1503 -13 1482 1503 1568 -6 0 1503 -4 1482 -2 1496 1482 1503 0 -5 44 -2 0 1726 1008 -59 1009 -69 0 77 0 -4 77 -2 44 -15 0 1503 -2 1482 1503 -13 0 44 1503 1482 1503 -3 0 212 0 295 0 212 0 212 0 1503 -13 1482 1503 1568 -6 0 1503 -4 1482 -2 1496 1482 1503 0 -3 44 -3 0 1723 -61 1009 -68 0 27 -7 28 29 -15 0 1503 -2 1482 1503 -12 0 -2 44 1503 1482 1503 0 295 0 212 0 212 0 212 0 212 0 1503 -13 1482 1503 -7 0 1503 -4 1482 -3 1496 1503 0 -2 44 -2 0 1819 0 1008 -47 1009 -2 1014 -12 1009 -92 0 1503 1482 1485 1503 -11 0 -3 44 1503 1482 1503 0 212 0 212 0 212 0 212 0 212 0 1503 -13 1482 1503 -7 0 1503 -4 1482 -3 1496 1503 -5 0 1818 0 1012 -48 1009 -2 1014 -11 1009 -84 0 -12 1503 -2 1568 -3 0 -3 1568 -52 1503 -3 0 -3 1568 -11 1503 -51 1009 -84 0 1503 -4 1482 1483 1484 -3 1482 1503 -56 0 1503 -3 1496 1503 -12 0 1503 -3 1496 1503 -51 1009 -83 0 211 1503 1482 1479 1480 1481 1490 1491 1492 -2 1482 1503 -56 0 1503 -3 1496 1503 -12 0 1503 -3 1496 1503 -2 1009 1014 -48 1009 -62 0 77 44 -19 0 212 1503 1482 1486 1487 1488 1497 1498 1499 -2 1482 1503 -9 0 -2 83 102 83 -43 0 1503 1496 1482 1496 1503 1568 -11 0 1503 -3 1496 1503 -51 1009 -61 0 -3 77 44 -18 0 212 1503 1482 1493 1494 1495 1504 1505 1506 -2 1482 1503 44 -55 0 1503 1496 1482 1496 1503 -12 0 1503 -3 1496 1503 -9 1009 1014 -41 1009 -60 0 27 -7 28 29 -14 0 212 1503 1482 1500 1501 1502 1496 -4 1482 1503 -2 44 -53 0 44 1503 -3 1496 1503 -12 0 1503 -3 1496 1503 -51 1009 -83 0 212 1503 1482 1507 1508 1509 1496 1482 1485 -2 1482 1503 -3 44 -51 0 -2 44 1503 -3 1496 1503 -12 0 1503 -3 1496 1503 -51 1009 -76 0 -32 1503 -2 1568 -16 0 -2 1568 -15 1503 -2 1568 -3 0 -3 1568 -5 1503 -2 1568 -3 0 1510 1568 -3 0 -2 1568 -8 1503 -3 1009 -2 1568 -43 1009 -76 0 1503 -8 1482 1503 -4 0 1503 -3 0 1503 -4 0 1503 -5 1482 1503 -36 0 1503 -18 0 -2 1510 -11 0 1503 1496 -4 1009 1568 -43 1009 -27 0 -3 44 -46 0 1503 1482 1483 1484 -2 1482 1485 -2 1482 1503 -4 0 1503 -3 0 1503 -4 0 1503 -5 1482 1503 -28 0 -8 2818 1503 -18 0 -2 1510 -11 0 1503 1496 -4 1009 1503 -43 1009 -75 0 48 1503 1482 1490 1491 1492 -2 1482 -3 1503 -4 0 1503 -3 0 1503 -4 0 -3 1503 -3 1482 -5 1503 -18 0 -2 1503 2829 2825 0 2820 -8 44 -18 0 1568 -2 1510 -11 0 1503 -5 1009 1008 -43 1009 -27 0 -2 83 102 -44 0 50 49 1503 1482 1497 1498 1499 -2 1482 1503 0 1503 -4 0 1503 -3 0 1503 -4 0 1503 0 1503 -7 1482 1503 -18 0 1503 1469 1477 -2 1482 1503 -8 44 -15 0 1723 1724 1725 1818 1503 1510 1568 1724 1726 -8 0 1503 -5 1009 1012 -43 1009 -74 0 51 52 1503 1482 1504 1505 1506 1485 1482 1503 0 -6 1503 -3 0 -6 1503 0 1503 -7 1482 1503 -7 0 -2 1568 -6 0 -3 1568 1503 1467 1468 -2 1482 1503 -8 44 -14 0 1723 1817 1013 1014 1011 -2 1503 1817 1013 1820 1725 1726 -5 0 44 1503 1496 1014 -3 1009 1503 -35 1009 1014 -7 1009 -73 0 50 49 48 1503 -6 1482 1503 0 1503 -4 0 1503 -7 0 -2 1503 0 1503 -7 1482 1503 -7 0 -2 1568 -6 0 -3 1568 1503 1471 1472 -2 1482 1503 -8 44 1568 -13 0 1817 -3 1009 1015 -2 1503 1008 -2 1009 1014 1820 -4 0 -2 44 1503 1496 -3 1009 1482 1503 -43 1009 -14 1002 1003 -10 0 1000 -13 1002 1003 -28 0 -16 1503 2818 -6 1503 -3 2818 -6 1503 2818 -67 1503 1568 -3 0 -2 1568 -2 1503 -2 1568 -11 1503 -16 1009 1014 -18 1009 -14 1006 1037 -5 1002 1003 -4 0 1004 -13 1006 1037 1001 -2 1002 1003 -24 0 1503 0 1503 1482 1485 -7 1482 1503 -25 0 212 -5 0 212 -4 0 -2 1503 -32 0 212 -4 0 212 -22 0 1503 -8 1482 1503 -49 1009 1041 -5 1006 1037 1001 -3 1002 1034 -13 1009 1041 1005 -2 1006 1037 -2 1002 1003 -21 0 1503 0 1503 -9 1482 1503 -25 0 212 -5 0 297 -4 0 -2 1510 -32 0 212 0 -2 44 0 212 -22 0 1503 -8 1482 1503 -55 1009 1041 1005 -3 1006 1040 -17 1009 1041 1037 1001 1002 1003 -16 0 102 84 -2 0 1503 0 -11 1503 -25 0 297 -44 0 212 0 -2 44 0 212 -22 0 1503 -8 1482 1503 -67 1009 1014 -11 1009 1041 1005 1006 1037 1001 -3 1002 1003 -31 0 1568 -7 0 1568 -7 0 1568 -33 0 1568 -9 0 295 -6 0 212 -4 0 297 -4 0 295 -8 0 295 -8 0 1503 -8 1482 1503 -75 1009 1014 -6 1009 1041 1005 -3 1006 1037 1003 -13 0 44 -16 0 1510 -15 0 1510 -33 0 1510 -9 0 212 -6 0 297 -9 0 212 -7 0 295 212 -8 0 1503 -8 1482 1008 -87 1009 1041 1037 1002 1001 -3 1002 1003 -6 0 -2 44 -16 0 1503 -15 0 1503 -16 0 -2 1568 -15 0 1503 -9 0 212 -16 0 212 -7 0 -2 212 -8 0 1503 -7 1482 1012 -89 1009 1041 -2 1005 -3 1006 1037 -31 1503 -3 1568 -95 1503 -94 1009 1041 1005 -10 1006 1007 1817 1014 1013 1014 1013 1014 1013 1014 1013 1014 1013 1014 1013 1014 1013 1014 1013 1014 1013 1014 1013 1014 1013 1014 1013 1014 1013 1014 1013 1014 1013 1014 1013 1014 1013 1014 1013 1014 1013 1014 1013 1014 1013 1014 1013 1014 1013 1014 1013 1014 1013 1014 1013 1014 1013 1014 1013 1014 1013 1014 1013 1014 1013 1014 1013 1014 1013 1014 1013 1014 1013 1014 1013 1014 1013 1014 1013 1014 1013 1014 1013 1014 1013 1014 1013 1014 1013 1014 1013 1014 1013 1014 1013 1014 1013 1014 1013 1014 1013 1014 1013 1014 1013 1014 1013 1014 1013 1014 1013 1014 1013 1014 1013 1014 1013 1014 -29 1009 1014 -9 1009 1014 -18 1009 -2 1014 -2 1009 1013 -204 1009 1013 -264 1009 1013 -118 1009 1014 -93 1009 1013 -3 1009 1013 -87 1009 1013 -50 1009 1014 -63 1009 1013 -52 1009 1014 -41 1009 1014 -64 1009 1013 -79 1009 1013 -60 1009 1014 -233 1009 1013 -21 1009 1014 -112 1009 1013 -40 1009 1014 -100 1009 1013 -89 1009 1014 -93 1009 1013 -142 1009 1014 -396 1009 1014 -60 1009 1013 -51 1009 1013 -77 1009 1014 -32 1009 1014 -15 1009 1014 -8 1009 1013 -3 1009 1014 -156 1009 1013 -90 1009 1013 -74 1009 1014 -17 1009 1014 -117 1009 1013 -20 1009 1014 -15 1009 1014 -27 1009 1014 -136 1009 1013 -71 1009 1014 -180 1009 1014 -201 1009 1014 -43 1009 1014 -390 1009)
    )
    (tilemap
      (solid #f)
      (z-pos 100)
      (name "Foreground")
      (width 224)
      (height 80)
      (tiles -5487 0 1503 -23 0 1503 -199 0 1355 -23 0 1355 -199 0 1356 -23 0 1356 -199 0 1356 -23 0 1356 -199 0 1356 -23 0 1356 -199 0 1356 -23 0 1356 -199 0 1411 -23 0 1411 -199 0 1503 -23 0 1503 -2 0 1568 -7 0 1568 -215 0 1568 -7 0 1568 -215 0 1568 -7 0 1568 -215 0 -2 1568 -6 0 1568 -215 0 -2 1568 -6 0 1568 -215 0 1568 -7 0 1568 -215 0 1568 -7 0 1568 -179 0 1568 -31 0 1503 -3 0 -9 1568 -12 0 -3 1568 -7 1503 -157 0 1355 -31 0 1355 -26 0 1355 -164 0 1356 -31 0 1356 -26 0 1356 -164 0 1356 -31 0 1356 -26 0 1356 -164 0 1356 -31 0 1356 -26 0 1356 -92 0 1240 1241 -70 0 1356 -31 0 1356 -26 0 1356 -91 0 1243 1244 1245 1246 -69 0 1411 -31 0 1411 -26 0 1411 -75 0 1287 1288 -14 0 1247 1248 1249 1250 -69 0 1503 -23 0 -2 1568 -17 1503 -3 0 -3 1568 -10 0 1510 1568 -74 0 1289 1290 -14 0 1251 1252 1253 1254 -52 0 1503 -13 1482 1503 -5 0 1503 -24 0 1503 -11 1482 1503 -6 0 1355 -26 0 -4 200 -57 0 1291 1292 -14 0 1255 1256 1257 1258 -52 0 1503 -13 1482 1503 -5 0 1503 -24 0 1503 -2 1482 -10 1503 -6 0 1356 -26 0 -4 200 -57 0 1293 1294 -14 0 1259 1260 1261 1262 -50 0 -3 1503 -13 1482 -3 1503 -3 0 -5 1503 -18 0 -3 1503 -2 1482 1503 -15 0 1356 -10 0 1819 -2 1510 -12 0 -5 200 -57 0 1295 1296 -14 0 1263 1264 1265 1266 -50 0 1503 1482 1503 -13 1482 1503 1482 1503 -7 0 1503 -18 1708 1503 -4 1482 1503 -15 0 1356 -7 0 1723 1724 1725 1818 1503 1510 1723 1725 1726 -9 0 -5 200 -57 0 1301 1302 -14 0 1267 1268 1269 1270 -50 0 1503 1482 1503 -13 1482 1503 1482 1503 -7 0 1503 -7 0 -2 1568 -6 0 -3 1568 1503 -4 0 1503 -15 0 1356 -6 0 1723 1817 1013 1014 1011 -2 1503 1817 1013 1820 1725 1726 -8 0 -4 200 -53 0 402 403 404 405 1307 1308 -10 0 402 403 404 405 0 1280 1281 -3 0 402 403 404 405 -15 0 1287 1288 -27 0 1503 1482 1503 -13 1482 1503 1482 1503 -7 0 1503 -7 0 -2 1568 -6 0 -3 1568 -5 0 1503 -15 0 1411 -6 0 1817 -3 1009 1015 -2 1503 1008 -2 1009 1014 1820 -8 0 -3 200 -54 0 406 407 408 409 1309 1310 -2 0 402 403 404 405 -4 0 406 407 408 409 0 1284 1285 -3 0 406 407 408 409 -15 0 1289 1290 -24 0 -4 1503 1482 -6 1503 -3 1482 -6 1503 1482 -6 1503 -2 0 -18 1503 -22 0 1503 -6 0 -12 1503 1568 -55 0 1005 1006 1005 1006 1005 1006 1005 1006 1005 1006 1005 1006 1005 1006 1037 -2 0 406 407 408 409 -5 0 1005 1006 -11 0 1037 -14 0 1291 1292 -13 0 1482 -17 0 1355 -9 0 1355 -23 0 1355 -116 0 1041 1005 1006 1005 1006 1005 1037 -4 0 1034 -13 0 1041 1005 -2 1006 1037 -10 0 1293 1294 -13 0 1482 -17 0 1356 -9 0 1356 -23 0 1356 -122 0 1041 1005 1006 1005 1006 1040 -17 0 1041 1005 1006 1037 -2 0 402 403 404 405 0 1295 1296 -13 0 1482 -17 0 1356 -9 0 1356 -23 0 1356 -145 0 -3 1009 1041 1037 0 406 407 408 409 0 1301 1302 -24 0 129 -6 0 1356 -9 0 1356 -23 0 1356 -149 0 1041 1005 -3 1006 1037 0 1307 1308 -2 0 402 403 404 405 -18 0 129 -6 0 1356 -9 0 1356 -16 0 1356 -6 0 1356 -65 0 1723 -88 0 1041 1037 1309 1310 -2 0 406 407 408 409 -18 0 129 -6 0 1411 -9 0 1411 -16 0 1411 -6 0 1411 -155 0 1041 -2 1005 -3 1006 1037 -31 1503 -3 1568 -4 1503 -16 0 1503 -6 0 1503 -63 0 1724 1725 1724 1725 -97 0 1005 1006 1005 1006 1005 1006 1005 1006 1005 -4409 0)
    )
    (tilemap
      (handle
        (scale_x 0)
        (scale_y 0)
        (offset_x 0)
        (offset_y 0)
      )
      (solid #f)
      (z-pos 101)
      (name "secret1")
      (path-ref "gen1772929499104989797369472")
      (width 11)
      (height 6)
      (tiles 0 -9 1481 -2 0 -9 1481 1510 0 -9 1481 1568 -10 1481 1510 -10 1481 -12 1503)
    )
    (tilemap
      (solid #f)
      (z-pos -101)
      (width 224)
      (height 80)
      (tiles -6633 0 -2 1478 -222 0 -2 1478 -4073 0 1009 -79 0 1137 -143 0 1013 -79 0 1145 -223 0 1153 -223 0 1161 -139 0 -2 1478 -6094 0)
    )
    (tilemap
      (solid #f)
      (z-pos 101)
      (name "Foreground2")
      (width 224)
      (height 80)
      (tiles -10480 0 1017 1018 1017 1009 -223 0 1016 -224 0 1568 -218 0 1726 -4 0 1568 -221 0 1723 1724 -220 0 1724 1725 1817 -45 0 -14 1002 1003 -10 0 1000 -13 1002 1003 -199 0 -5 1002 1003 -5 0 1005 1006 1005 1006 1005 1006 1005 1006 1005 1006 1005 1006 1005 0 1001 -2 1002 1003 -201 0 1001 -3 1002 -17 0 1005 0 -2 1002 1003 -224 0 1003 -224 0 1001 -3 1002 1003 -135 0 1723 -85 0 1005 -2 0 1003 -224 0 1002 1001 -3 1002 1003 -224 0 1001 1002 1001 1002 1001 1002 1001 1002 1001 -2 1002 1003 1723 1724 1725 1724 1725 1724 1725 1724 1725 1724 1725 1724 1725 1724 1725 1724 1725 1724 1725 1724 1725 1724 1725 1724 1725 1724 1725 1724 1725 1724 1725 1724 1725 1724 1725 1724 1725 1724 1725 1724 1725 1724 1725 1724 1725 1724 1725 1724 1725 1724 1725 1724 1725 1724 1725 1724 1725 1724 1725 1724 1725 1724 1725 1724 1725 1724 1725 1724 1725 1724 1725 1724 1725 1724 1725 1724 1725 1724 1725 1724 1725 1724 1725 1724 1725 1724 1725 1724 1725 1724 1725 1724 1725 1724 1725 1724 1725 1724 1725 1724 1725 1724 1725 1724 1725 1724 1725 1724 1725 1724 1725 1724 1725 1724 1725 1016 1017 -4515 0)
    )
    (tilemap
      (solid #t)
      (z-pos 99)
      (name "Lava")
      (width 224)
      (height 80)
      (tiles -7307 0 -7 1708 -217 0 -7 1705 -217 0 -2 1700 1705 1700 1705 -2 1700 -217 0 1700 1705 -3 1700 1705 1700 -217 0 -3 1700 1705 1700 1705 1700 -217 0 -7 1706 -2876 0 1700 1705 -2 1700 -2 1705 -2 1700 -2 1705 -3 1700 1705 1700 1705 -2 1700 -206 0 -18 1706 -6368 0)
    )
    (toad
      (z-pos 50)
      (dead-script "dropdoor1.goto_node(0);
dropdoor2.goto_node(0);")
      (x 2945)
      (y 1601)
      (glinting #f)
    )
  )
)
