(supertux-level
  (version 3)
  (name (_ "Forest Intro"))
  (author "Sophie \"Vaesea\" Ball")
  (license "CC-BY-SA 4.0 International")
  (allow-item-pocket "inherit")
  (icon "")
  (icon-locked "")
  (statistics
    (enable-coins #t)
    (enable-secrets #t)
  )
  (sector
    (name "main")
    (init-script "Tux.deactivate();
Effect.sixteen_to_nine(2);
Text.set_font(\"normal\");
Text.set_text(\"Tux had reached a Forest Island.\");
Text.fade_in(1);
wait(3);
Text.fade_out(1);
wait(1.5);
Tux.walk(230);")
    (ambient-light
      (color 1 1 1)
    )
    (background
      (color 1 1 1)
      (speed 0.25)
      (image-top "/images/background/BlueRock_Forest/blue-top.jpg")
      (image "/images/background/BlueRock_Forest/blue-middle.jpg")
      (image-bottom "/images/background/BlueRock_Forest/blue-bottom.jpg")
    )
    (camera
      (name "Camera")
      (mode "normal")
    )
    (music
      (file "/music/forest/forestmap.music")
    )
    (scriptedobject
      (z-pos 50)
      (name "Granito")
      (sprite "/images/creatures/granito/granito.sprite")
      (x 1920)
      (y 512)
    )
    (scripttrigger
      (oneshot #t)
      (script "Granito.set_velocity(-100, 0);
Granito.set_action(\"walk-left\");")
      (button #f)
      (width 32)
      (height 32)
      (x 384)
      (y 832)
    )
    (scripttrigger
      (oneshot #t)
      (script "Tux.walk(0);
wait(4);
Granito.set_velocity(0, 0);
Granito.set_action(\"lookdown-left\");
Text.set_font(\"normal\");
Text.set_text(\"Granito: Welcome to the Forest Island!\");
Text.fade_in(1);
wait(3);
Text.fade_out(1);
wait(1.5);
Text.set_text(\"Unfortunately, a creature named Nolok has turned one of the once interesting ruins here into his home, along with corrupting the area around it...\");
Text.fade_in(1);
wait(5);
Text.fade_out(1);
wait(1.5);
Text.set_text(\"Tux: I can help defeat him! He captured my friend!\");
Text.fade_in(1);
wait(3);
Text.fade_out(1);
wait(1.5);
Text.set_text(\"Granito: You can? That's good. Just be careful, this forest has been turned into a dangerous place...\");
Text.fade_in(1);
wait(4);
Text.fade_out(1);
wait(1.5);
Granito.set_velocity(100, 0);
Granito.set_action(\"walk-right\");
Effect.fade_out(2);
wait(3);
Level.finish(true);")
      (button #f)
      (width 32)
      (height 32)
      (x 928)
      (y 896)
    )
    (spawnpoint
      (name "main")
      (x 320)
      (y 800)
    )
    (tilemap
      (solid #f)
      (z-pos -100)
      (width 100)
      (height 35)
      (tiles -1155 0 1168 1169 1170 -12 0 1168 1169 1170 -82 0 1174 1175 1176 1177 -11 0 1174 1175 1176 1177 -80 0 1179 1180 1181 1182 1183 -10 0 1179 1180 1181 1182 1183 -80 0 1185 1186 1187 1188 1189 1190 -9 0 1185 1186 1187 1188 1189 1190 -79 0 1191 1192 1193 1194 1195 1196 -9 0 1191 1192 1193 1194 1195 1196 -17 0 360 -61 0 1197 1198 1199 1200 1201 1202 -9 0 1197 1198 1199 1200 1201 1202 -79 0 1203 1204 1205 1206 1207 1208 -9 0 1203 1204 1205 1206 1207 1208 -20 0 402 403 404 405 -55 0 1209 1210 1211 1212 1213 1214 -9 0 1209 1210 1211 1212 1213 1214 -20 0 406 407 408 409 -56 0 2045 1219 1220 -3 0 402 403 434 435 436 437 404 405 -2 0 1217 1218 -7 0 402 403 404 405 -4 0 402 403 404 405 -3 0 410 411 412 413 -35 0 360 -20 0 2046 1225 1226 -3 0 406 407 438 439 440 441 408 409 -2 0 1223 1224 -7 0 406 407 408 409 -4 0 406 407 408 409 -3 0 414 415 416 417 -37 0 402 403 404 405 -16 0 1217 1218 -3 0 410 411 442 443 444 445 412 413 -2 0 1217 1218 -7 0 410 411 426 427 404 405 -2 0 410 411 412 413 -3 0 418 419 420 421 -37 0 406 407 408 409 -16 0 1223 1224 -3 0 414 415 446 447 448 449 416 417 -2 0 1223 1224 -7 0 414 415 430 431 408 409 -2 0 414 415 416 417 -3 0 422 423 424 425 -21 0 402 403 404 405 -8 0 402 403 404 405 410 411 412 413 -7 0 402 403 404 405 -4 0 1228 1229 1230 -3 0 418 419 450 451 452 453 420 421 0 1228 1229 1230 -7 0 418 419 442 443 412 413 -2 0 418 419 420 421 -3 0 418 419 420 421 -11 0 402 403 404 405 -6 0 406 407 408 409 -8 0 406 407 408 409 414 415 416 417 -7 0 406 407 408 409 -4 0 1234 1235 1236 -3 0 422 423 454 455 456 457 424 425 322 1234 1235 1236 402 403 404 405 360 -2 0 422 423 446 447 416 417 -2 0 422 423 424 425 -2 0 322 422 423 424 425 -11 0 406 407 408 409 -4 0 402 403 428 429 420 421 -8 0 410 411 426 427 428 429 420 421 -7 0 410 411 412 413 -59 0 410 411 412 413 0 360 -2 0 406 407 432 433 424 425 -8 0 414 415 430 431 432 433 424 425 -7 0 414 415 416 417 -81 0 418 419 442 443 444 445 420 421 -7 0 410 411 412 413 -49 0 2141 2142 2019 2140 2141 2142 2019 2140 2141 2142 -20 0 322 0 422 423 446 447 448 449 424 425 0 360 -2 0 322 -2 0 414 415 416 417 -49 0 -10 2020 -90 0 -10 2020 -90 0 -10 2020 -90 0 -10 2020 -90 0 -10 2020 -90 0 -10 2020 -90 0)
    )
    (tilemap
      (solid #f)
      (z-pos 100)
      (width 100)
      (height 35)
      (tiles -1692 0 323 324 -98 0 325 326 -98 0 327 328 -98 0 329 330 -139 0 323 324 -98 0 325 326 -98 0 327 328 -98 0 329 330 -1065 0)
    )
    (tilemap
      (solid #t)
      (z-pos 0)
      (width 100)
      (height 35)
      (tiles -1591 0 1752 1753 -98 0 1754 1755 1756 1757 -96 0 1758 1759 -239 0 1752 1753 -23 0 1746 1747 -73 0 1754 1755 1756 1757 -19 0 1760 1761 1748 1749 -73 0 1758 1759 -23 0 1750 1751 -194 0 1060 1001 1002 1001 1002 1001 1002 1001 1002 1001 1002 1001 1002 1001 1002 1001 1002 1001 1002 1001 1002 1001 1002 1001 1002 1001 1002 1001 1002 1001 1002 1001 1002 1001 1002 1001 1002 1001 1002 1001 1002 1001 1002 1001 1002 1001 1002 -51 0 1060 1063 1064 1005 1006 1005 1006 1005 1006 1005 1006 1005 1006 1005 1006 1005 1006 1005 1006 1005 1006 1005 1006 1005 1006 1005 1006 1005 1006 1005 1006 1005 1006 1005 1006 1005 1006 1005 1006 1005 1006 1005 1006 1005 1006 1005 1006 1005 1006 -9 0 1000 1001 1002 1001 1002 1001 1002 1001 1002 1001 1002 1001 1002 1001 1002 1061 -24 0 1060 1063 1064 1067 1068 -46 1009 -9 0 1004 1005 1006 1005 1006 1005 1006 1005 1006 1005 1006 1005 1006 1005 1006 1065 1066 1061 -20 0 1060 1063 1064 1067 1068 -48 1009 -9 0 1008 -14 1009 1069 1070 1065 1066 1001 1002 1001 1002 1001 1002 1001 1002 1001 1002 1001 1002 1001 1002 1001 1002 1001 1002 1063 1064 1067 1068 -50 1009 -9 0 1012 -16 1009 1069 1070 1005 1006 1005 1006 1005 1006 1005 1006 1005 1006 1005 1006 1005 1006 1005 1006 1005 1006 1067 1068 -52 1009 -9 0 1008 -90 1009 -9 0 1012 -90 1009 -9 0 1008 -90 1009 -9 0 1012 -90 1009 -9 0 1008 -90 1009)
    )
    (tilemap
      (solid #f)
      (z-pos -101)
      (width 100)
      (height 35)
      (tiles -765 0 1240 1241 1242 -14 0 1240 1241 1242 -79 0 1243 1244 1245 1246 -13 0 1243 1244 1245 1246 -79 0 1247 1248 1249 1250 -10 0 1240 1241 1242 1247 1248 1249 1250 -8 0 1168 1169 1170 -68 0 1251 1252 1253 1254 -9 0 1243 1244 1245 1246 1251 1252 1253 1254 -8 0 1174 1175 1176 1177 -67 0 1255 1256 1257 1258 -9 0 1247 1248 1249 1250 1255 1256 1257 1258 0 1240 1241 1242 -3 0 1179 1180 1181 1182 1183 -67 0 1259 1260 1261 1262 -9 0 1251 1252 1253 1254 1259 1260 1261 1262 1243 1244 1245 1246 -3 0 1185 1186 1187 1188 1189 1190 -23 0 1168 1169 1170 -10 0 1168 1169 1170 -27 0 1263 1264 1265 1266 -9 0 1255 1256 1257 1258 1263 1264 1265 1266 1247 1248 1249 1250 -3 0 1191 1192 1193 1194 1195 1196 -23 0 1174 1175 1176 1177 -9 0 1174 1175 1176 1177 -26 0 1267 1268 1269 1270 -9 0 1259 1260 1261 1262 1267 1268 1269 1270 1251 1252 1253 1254 -3 0 1197 1198 1199 1200 1201 1202 -17 0 1168 1169 1170 -2 0 1179 1180 1181 1182 1183 -8 0 1179 1180 1181 1182 1183 -26 0 1271 1272 1273 1274 -9 0 1263 1264 1265 1266 1271 1272 1273 1274 1255 1256 1257 1258 -3 0 1203 1204 1205 1206 1207 1208 -17 0 1174 1175 1176 1177 0 1185 1186 1187 1188 1189 1190 -7 0 1185 1186 1187 1188 1189 1190 -25 0 1275 1276 1277 1278 -9 0 1267 1268 1269 1270 1275 1276 1277 1278 1259 1260 1261 1262 -3 0 1209 1210 1211 1212 1213 1214 -16 0 1179 1180 1181 1182 1183 0 1191 1192 1193 1194 1195 1196 -7 0 1191 1192 1193 1194 1195 1196 -3 0 1240 1241 1242 -19 0 1271 1272 1273 1274 -9 0 1271 1272 1273 1274 1271 1272 1273 1274 1263 1264 1265 1266 -5 0 3646 3647 -18 0 1185 1186 1187 1188 1189 1190 1197 1198 1199 1200 1201 1202 -7 0 1197 1198 1199 1200 1201 1202 -2 0 1243 1244 1245 1246 -19 0 1275 1276 1277 1278 -9 0 1275 1276 1277 1278 1275 1276 1277 1278 1267 1268 1269 1270 -5 0 3650 3651 -18 0 1191 1192 1193 1194 1195 1196 1203 1204 1205 1206 1207 1208 -7 0 1203 1204 1205 1206 1207 1208 -2 0 1247 1248 1249 1250 -19 0 1271 1272 1273 1274 -9 0 1271 3679 3680 1274 1271 1272 1273 1274 1271 1272 1273 1274 -5 0 1217 1218 -18 0 1197 1198 1199 1200 1201 1202 1209 1210 1211 1212 1213 1214 -7 0 1209 1210 1211 1212 1213 1214 -2 0 1251 1252 1253 1254 -19 0 1275 1276 1277 1278 -9 0 1275 3681 3682 1278 1275 1276 1277 1278 1275 1276 1277 1278 -5 0 1223 1224 -18 0 1203 1204 1205 1206 1207 1208 0 2045 1219 1220 -11 0 1217 1218 -4 0 1255 1256 1257 1258 -19 0 1271 1272 1273 1274 -9 0 1271 1272 1273 1274 1271 1272 1273 1274 1271 1272 1273 1274 -5 0 1217 1218 -18 0 1209 1210 1211 1212 1213 1214 0 2046 1225 1226 -11 0 1223 1224 -4 0 1259 1260 1261 1262 -4 0 402 403 404 405 -11 0 1275 1276 1277 1278 -9 0 1275 1276 1277 1278 1275 1276 1277 1278 1275 1276 1277 1278 -5 0 1223 1224 -20 0 1217 1218 -4 0 1217 1218 -11 0 3638 3639 -4 0 1263 1264 1265 1266 -4 0 406 407 408 409 -11 0 1279 1280 1281 1282 -9 0 1279 1280 1281 1282 1279 1280 1281 1282 1279 1280 1281 1282 -4 0 1228 1229 1230 -20 0 1223 1224 -4 0 1223 1224 -11 0 3642 3643 -4 0 1267 1268 1269 1270 -4 0 410 411 412 413 -11 0 1283 1284 1285 1286 -9 0 1283 1284 1285 1286 1283 1284 1285 1286 1283 1284 1285 1286 -4 0 1234 1235 1236 -19 0 1228 1229 1230 -3 0 1228 1229 1230 -11 0 1217 1218 -4 0 1271 3675 3676 1274 -4 0 414 415 416 417 -62 0 1234 1235 1236 -3 0 1234 1235 1236 -11 0 1223 1224 -4 0 1275 3677 3678 1278 -4 0 410 411 412 413 -81 0 1228 1229 1230 -4 0 1279 1280 1281 1282 -4 0 414 415 416 417 -81 0 1234 1235 1236 -4 0 1283 1284 1285 1286 -655 0)
    )
    (tilemap
      (solid #f)
      (z-pos -102)
      (width 100)
      (height 35)
      (tiles -597 0 1073 1074 1075 -97 0 1081 1082 1083 -89 0 1073 1074 1075 -4 0 1088 1089 1090 1091 -89 0 1081 1082 1083 1084 -2 0 1095 1096 1097 1098 1099 -57 0 1073 1074 1075 -7 0 1073 1074 1075 -18 0 1088 1089 1090 1091 1092 1093 0 1103 1104 1105 1106 1107 -57 0 1081 1082 1083 1084 -6 0 1081 1082 1083 1084 -16 0 1095 1096 1097 1098 1099 1100 1101 0 1111 1112 1113 1114 1115 -30 0 1073 1074 1075 -23 0 1088 1089 1090 1091 1092 1093 -4 0 1088 1089 1090 1091 1092 1093 -15 0 1103 1104 1105 1106 1107 1108 1109 1110 1119 1120 1121 1122 1123 -30 0 1081 1082 1083 1084 -21 0 1095 1096 1097 1098 1099 1100 1101 -3 0 1095 1096 1097 1098 1099 1100 1101 -15 0 1111 1112 1113 1114 1115 1116 1117 1118 1127 1128 1129 1130 1131 -13 0 1073 1074 1075 -13 0 1088 1089 1090 1091 1092 1093 -20 0 1103 1104 1105 1106 1107 1108 1109 1110 -2 0 1103 1104 1105 1106 1107 1108 1109 1110 -14 0 1119 1120 1121 1122 1123 1124 1125 1126 -2 0 1137 1138 1139 -13 0 1081 1082 1083 1084 -11 0 1095 1096 1097 1098 1099 1100 1101 -20 0 1111 1112 1113 1114 1115 1116 1117 1118 -2 0 1111 1112 1113 1114 1115 1116 1117 1118 -14 0 1127 1128 1129 1130 1131 1132 1133 1134 -2 0 1145 1146 1147 -12 0 1088 1089 1090 1091 1092 1093 -10 0 1103 1104 1105 1106 1107 1108 1109 1110 -19 0 1119 1120 1121 1122 1123 1124 1125 1126 -2 0 1119 1120 1121 1122 1123 1124 1125 1126 -16 0 1137 1138 1139 1140 1141 -3 0 1137 1138 1139 -11 0 1095 1096 1097 1098 1099 1100 1101 -10 0 1111 1112 1113 1114 1115 1116 1117 1118 -19 0 1127 1128 1129 1130 1131 1132 1133 1134 -2 0 1127 1128 1129 1130 1131 1132 1133 1134 -16 0 1145 1146 1147 1148 -4 0 1145 1146 1147 -11 0 1103 1104 1105 1106 1107 1108 1109 1110 -9 0 1119 1120 1121 1122 1123 1124 1125 1126 -21 0 1137 1138 1139 1140 1141 -5 0 1137 1138 1139 1140 1141 -17 0 1137 1138 1139 1140 1141 -3 0 1137 1138 1139 -11 0 1111 1112 1113 1114 1115 1116 1117 1118 -9 0 1127 1128 1129 1130 1131 1132 1133 1134 -21 0 1145 1146 1147 1148 -6 0 1145 1146 1147 1148 -18 0 1145 1146 1147 1148 -4 0 1145 1146 1147 -11 0 1119 1120 1121 1122 1123 1124 1125 1126 -11 0 1137 1138 1139 1140 1141 -22 0 1137 1138 1139 1140 1141 -5 0 1137 1138 1139 1140 1141 -17 0 1137 1138 1139 1140 1141 -3 0 1137 1138 1139 -11 0 1127 1128 1129 1130 1131 1132 1133 1134 -11 0 1145 1146 1147 1148 -23 0 1145 1146 1147 1148 -6 0 1145 1146 1147 1148 -18 0 1145 1146 1147 1148 -4 0 1145 1146 1147 -13 0 1137 1138 1139 1140 1141 -12 0 1137 1138 1139 1140 1141 -16 0 402 403 404 405 -2 0 1137 1138 1139 1140 1141 -5 0 1137 1138 1139 1140 1141 -17 0 1137 1138 1139 1140 1141 -3 0 1137 1138 1139 -13 0 1145 1146 1147 1148 -13 0 1145 1146 1147 1148 -17 0 406 407 408 409 -2 0 1145 1146 1147 1148 -6 0 1145 1146 1147 1148 -18 0 1145 1146 1147 1148 -4 0 1145 1146 1147 -13 0 1137 1138 1139 1140 1141 -12 0 1137 1138 1139 1140 1141 -16 0 410 411 412 413 -2 0 1153 1154 1155 1156 -6 0 1153 1154 1155 1156 -4 0 402 403 404 405 -10 0 1153 1154 1155 1156 -4 0 1153 1154 1155 -13 0 1145 1146 1147 1148 -13 0 1145 1146 1147 1148 -17 0 414 415 416 417 -2 0 1161 1162 1163 1164 -6 0 1161 1162 1163 1164 -4 0 406 407 408 409 -10 0 1161 1162 1163 1164 -4 0 1161 1162 1163 -13 0 1153 1154 1155 1156 -13 0 1137 1138 1139 1140 1141 -16 0 410 411 412 413 -58 0 1161 1162 1163 1164 -13 0 1145 1146 1147 1148 -17 0 414 415 416 417 -75 0 1153 1154 1155 1156 -96 0 1161 1162 1163 1164 -666 0)
    )
  )
)
