(supertux-level
  (version 3)
  (name (_ "Run Towards The Ghost Tree"))
  (author "Sophie \"Vaesea\" Ball")
  (contact "Unfinished Boss Fight")
  (license "CC-BY-SA 4.0 International")
  (target-time 58)
  (allow-item-pocket "inherit")
  (icon "")
  (icon-locked "")
  (statistics
    (enable-coins #t)
    (enable-secrets #t)
  )
  (sector
    (name "main")
    (ambient-light
      (color 1 1 1)
    )
    (background
      (color 1 1 1)
      (speed 0.5)
      (speed-y 0)
      (image-top "/images/background/ghostforest.jpg")
      (image "/images/background/ghostforest.jpg")
      (image-bottom "/images/background/ghostforest.jpg")
    )
    (camera
      (name "Camera")
      (mode "normal")
    )
    (corrupted_granito
      (type "skullyhop")
      (z-pos 50)
      (direction "left")
      (x 6720)
      (y 928)
      (glinting #f)
    )
    (corrupted_granito
      (type "skullyhop")
      (z-pos 50)
      (direction "left")
      (x 6400)
      (y 928)
      (glinting #f)
    )
    (decal
      (z-pos -100)
      (sprite "/images/decal/ghost/tree1.png")
      (x 192)
      (y 448)
    )
    (decal
      (z-pos -100)
      (sprite "/images/decal/ghost/tree1.png")
      (x 64)
      (y 448)
    )
    (decal
      (z-pos -100)
      (sprite "/images/decal/ghost/tree1.png")
      (x -64)
      (y 448)
    )
    (decal
      (z-pos -100)
      (sprite "/images/decal/ghost/tree1.png")
      (x 1120)
      (y 448)
    )
    (decal
      (z-pos -100)
      (sprite "/images/decal/ghost/tree1.png")
      (x 544)
      (y 448)
    )
    (decal
      (z-pos -100)
      (sprite "/images/decal/ghost/tree1.png")
      (x 1696)
      (y 448)
    )
    (decal
      (z-pos -100)
      (sprite "/images/decal/ghost/tree1.png")
      (x 2016)
      (y 448)
    )
    (decal
      (z-pos -100)
      (sprite "/images/decal/ghost/tree1.png")
      (x 2528)
      (y 448)
    )
    (decal
      (z-pos -100)
      (sprite "/images/decal/ghost/tree1.png")
      (x 2976)
      (y 448)
    )
    (decal
      (z-pos -100)
      (sprite "/images/decal/ghost/tree1.png")
      (x 3360)
      (y 448)
    )
    (decal
      (z-pos -100)
      (sprite "/images/decal/ghost/tree1.png")
      (x 3616)
      (y 128)
    )
    (decal
      (z-pos -100)
      (sprite "/images/decal/ghost/tree1.png")
      (x 4192)
      (y 352)
    )
    (decal
      (z-pos -100)
      (sprite "/images/decal/ghost/tree1.png")
      (x 4512)
      (y 352)
    )
    (decal
      (z-pos -100)
      (sprite "/images/decal/ghost/tree1.png")
      (x 4896)
      (y 544)
    )
    (decal
      (z-pos -100)
      (sprite "/images/decal/ghost/tree1.png")
      (x 5280)
      (y 672)
    )
    (decal
      (z-pos -100)
      (sprite "/images/decal/ghost/tree1.png")
      (x 5728)
      (y 576)
    )
    (decal
      (z-pos -100)
      (sprite "/images/decal/ghost/tree1.png")
      (x 6144)
      (y 576)
    )
    (decal
      (z-pos -100)
      (sprite "/images/decal/ghost/tree1.png")
      (x 6560)
      (y 576)
    )
    (decal
      (z-pos -100)
      (sprite "/images/decal/ghost/tree1.png")
      (x 7904)
      (y 640)
    )
    (decal
      (z-pos -100)
      (sprite "/images/decal/ghost/tree1.png")
      (x 8448)
      (y 640)
    )
    (decal
      (z-pos -100)
      (sprite "/images/decal/ghost/tree1.png")
      (x 9344)
      (y 640)
    )
    (decal
      (z-pos -100)
      (sprite "/images/decal/ghost/tree2.png")
      (x 768)
      (y 448)
    )
    (decal
      (z-pos -100)
      (sprite "/images/decal/ghost/tree2.png")
      (x 1472)
      (y 448)
    )
    (decal
      (z-pos -100)
      (sprite "/images/decal/ghost/tree2.png")
      (x 2304)
      (y 448)
    )
    (decal
      (z-pos -100)
      (sprite "/images/decal/ghost/tree2.png")
      (x 2816)
      (y 448)
    )
    (decal
      (z-pos -100)
      (sprite "/images/decal/ghost/tree2.png")
      (x 3904)
      (y 128)
    )
    (decal
      (z-pos -100)
      (sprite "/images/decal/ghost/tree2.png")
      (x 4384)
      (y 352)
    )
    (decal
      (z-pos -100)
      (sprite "/images/decal/ghost/tree2.png")
      (x 4800)
      (y 544)
    )
    (decal
      (z-pos -100)
      (sprite "/images/decal/ghost/tree2.png")
      (x 5984)
      (y 576)
    )
    (decal
      (z-pos -100)
      (sprite "/images/decal/ghost/tree2.png")
      (x 6400)
      (y 576)
    )
    (decal
      (z-pos -100)
      (sprite "/images/decal/ghost/tree2.png")
      (x 8128)
      (y 640)
    )
    (decal
      (z-pos -100)
      (sprite "/images/decal/ghost/tree2.png")
      (x 8288)
      (y 640)
    )
    (decal
      (z-pos -100)
      (sprite "/images/decal/ghost/tree2.png")
      (x 8704)
      (y 640)
    )
    (decal
      (z-pos -100)
      (sprite "/images/decal/ghost/tree2.png")
      (x 9152)
      (y 640)
    )
    (decal
      (z-pos -100)
      (sprite "/images/decal/ghost/tree2.png")
      (x 9504)
      (y 640)
    )
    (decal
      (z-pos -100)
      (sprite "/images/decal/ghost/mushroom-1.png")
      (x 448)
      (y 768)
    )
    (decal
      (z-pos -100)
      (sprite "/images/decal/ghost/mushroom-1.png")
      (x 992)
      (y 768)
    )
    (decal
      (z-pos -100)
      (sprite "/images/decal/ghost/mushroom-1.png")
      (x 1664)
      (y 768)
    )
    (decal
      (z-pos -100)
      (sprite "/images/decal/ghost/mushroom-1.png")
      (x 2272)
      (y 768)
    )
    (decal
      (z-pos -100)
      (sprite "/images/decal/ghost/mushroom-1.png")
      (x 2752)
      (y 768)
    )
    (decal
      (z-pos -100)
      (sprite "/images/decal/ghost/mushroom-1.png")
      (x 3200)
      (y 768)
    )
    (decal
      (z-pos -100)
      (sprite "/images/decal/ghost/mushroom-1.png")
      (x 3616)
      (y 448)
    )
    (decal
      (z-pos -100)
      (sprite "/images/decal/ghost/mushroom-1.png")
      (x 3840)
      (y 448)
    )
    (decal
      (z-pos -100)
      (sprite "/images/decal/ghost/mushroom-1.png")
      (x 4736)
      (y 672)
    )
    (decal
      (z-pos -100)
      (sprite "/images/decal/ghost/mushroom-1.png")
      (x 4608)
      (y 864)
    )
    (decal
      (z-pos -100)
      (sprite "/images/decal/ghost/mushroom-1.png")
      (x 4960)
      (y 992)
    )
    (decal
      (z-pos -100)
      (sprite "/images/decal/ghost/mushroom-1.png")
      (x 4480)
      (y 992)
    )
    (decal
      (z-pos -100)
      (sprite "/images/decal/ghost/mushroom-1.png")
      (x 5696)
      (y 896)
    )
    (decal
      (z-pos -100)
      (sprite "/images/decal/ghost/mushroom-1.png")
      (x 6144)
      (y 896)
    )
    (decal
      (z-pos -100)
      (sprite "/images/decal/ghost/mushroom-1.png")
      (x 6560)
      (y 896)
    )
    (decal
      (z-pos -100)
      (sprite "/images/decal/ghost/mushroom-1.png")
      (x 7904)
      (y 960)
    )
    (decal
      (z-pos -100)
      (sprite "/images/decal/ghost/mushroom-1.png")
      (x 8672)
      (y 960)
    )
    (decal
      (z-pos -100)
      (sprite "/images/decal/ghost/mushroom-1.png")
      (x 9344)
      (y 960)
    )
    (decal
      (z-pos -100)
      (sprite "/images/decal/ghost/mushroom-2.png")
      (x 512)
      (y 768)
    )
    (decal
      (z-pos -100)
      (sprite "/images/decal/ghost/mushroom-2.png")
      (x 896)
      (y 768)
    )
    (decal
      (z-pos -100)
      (sprite "/images/decal/ghost/mushroom-2.png")
      (x 1376)
      (y 768)
    )
    (decal
      (z-pos -100)
      (sprite "/images/decal/ghost/mushroom-2.png")
      (x 2464)
      (y 768)
    )
    (decal
      (z-pos -100)
      (sprite "/images/decal/ghost/mushroom-2.png")
      (x 3328)
      (y 768)
    )
    (decal
      (z-pos -100)
      (sprite "/images/decal/ghost/mushroom-2.png")
      (x 4000)
      (y 448)
    )
    (decal
      (z-pos -100)
      (sprite "/images/decal/ghost/mushroom-2.png")
      (x 4672)
      (y 864)
    )
    (decal
      (z-pos -100)
      (sprite "/images/decal/ghost/mushroom-2.png")
      (x 4576)
      (y 992)
    )
    (decal
      (z-pos -100)
      (sprite "/images/decal/ghost/mushroom-2.png")
      (x 5152)
      (y 992)
    )
    (decal
      (z-pos -100)
      (sprite "/images/decal/ghost/mushroom-2.png")
      (x 5920)
      (y 896)
    )
    (decal
      (z-pos -100)
      (sprite "/images/decal/ghost/mushroom-2.png")
      (x 6336)
      (y 896)
    )
    (decal
      (z-pos -100)
      (sprite "/images/decal/ghost/mushroom-2.png")
      (x 8064)
      (y 960)
    )
    (decal
      (z-pos -100)
      (sprite "/images/decal/ghost/mushroom-2.png")
      (x 7616)
      (y 800)
    )
    (decal
      (z-pos -100)
      (sprite "/images/decal/ghost/mushroom-2.png")
      (x 7168)
      (y 864)
    )
    (decal
      (z-pos -100)
      (sprite "/images/decal/ghost/mushroom-1.png")
      (x 6944)
      (y 864)
    )
    (decal
      (z-pos -100)
      (sprite "/images/decal/ghost/mushroom-1.png")
      (x 7392)
      (y 832)
    )
    (decal
      (z-pos -100)
      (sprite "/images/decal/ghost/mushroom-2.png")
      (x 8416)
      (y 960)
    )
    (decal
      (z-pos -100)
      (sprite "/images/decal/ghost/mushroom-2.png")
      (x 9024)
      (y 960)
    )
    (decal
      (z-pos -100)
      (sprite "/images/decal/ghost/mushroom-2.png")
      (x 9248)
      (y 960)
    )
    (decal
      (z-pos -100)
      (sprite "/images/decal/ghost/mushroom-3.png")
      (x 1088)
      (y 704)
    )
    (decal
      (z-pos -100)
      (sprite "/images/decal/ghost/mushroom-3.png")
      (x 4448)
      (y 800)
    )
    (decal
      (z-pos -100)
      (sprite "/images/decal/ghost/mushroom-3.png")
      (x 8256)
      (y 896)
    )
    (decal
      (z-pos -100)
      (sprite "/images/decal/ghost/mushroom-3.png")
      (x 8896)
      (y 896)
    )
    (dispenser
      (z-pos 55)
      (cycle 5)
      (objects
        (mrbomb
          (z-pos 50)
          (glinting #f)
        )
      )
      (direction "left")
      (limit-dispensed-badguys #t)
      (max-concurrent-badguys 2)
      (x 2368)
      (y 192)
    )
    (dispenser
      (z-pos 55)
      (cycle 2.5)
      (type "point")
      (objects
        (corrupted_granito
          (type "skullyhop")
          (z-pos 50)
          (glinting #f)
        )
      )
      (direction "left")
      (limit-dispensed-badguys #t)
      (max-concurrent-badguys 5)
      (x 8912)
      (y 864)
    )
    (hurting_platform
      (z-pos 50)
      (handle
        (scale_x 0)
        (scale_y 0)
        (offset_x 0)
        (offset_y 0)
      )
      (path-ref "gen17676551553038280489776")
    )
    (hurting_platform
      (z-pos 50)
      (handle
        (scale_x 0)
        (scale_y 0)
        (offset_x 0)
        (offset_y 0)
      )
      (path-ref "gen17676556652645913234432")
    )
    (hurting_platform
      (z-pos 50)
      (handle
        (scale_x 0)
        (scale_y 0)
        (offset_x 0)
        (offset_y 0)
      )
      (path-ref "gen17676556772645913237888")
    )
    (hurting_platform
      (z-pos 50)
      (handle
        (scale_x 0)
        (scale_y 0)
        (offset_x 0)
        (offset_y 0)
      )
      (path-ref "gen17676559602645913238464")
    )
    (hurting_platform
      (z-pos 50)
      (handle
        (scale_x 0)
        (scale_y 0)
        (offset_x 0)
        (offset_y 0)
      )
      (path-ref "gen17676559702645913282384")
    )
    (hurting_platform
      (z-pos 50)
      (handle
        (scale_x 0)
        (scale_y 0)
        (offset_x 0)
        (offset_y 0)
      )
      (path-ref "gen17676559712645913276768")
    )
    (hurting_platform
      (z-pos 50)
      (handle
        (scale_x 0)
        (scale_y 0)
        (offset_x 0)
        (offset_y 0)
      )
      (path-ref "gen17676559732645913284256")
    )
    (hurting_platform
      (z-pos 50)
      (handle
        (scale_x 0)
        (scale_y 0)
        (offset_x 0)
        (offset_y 0)
      )
      (running #f)
      (name "Root2")
      (path-ref "gen17676561712645913286272")
    )
    (hurting_platform
      (z-pos 50)
      (handle
        (scale_x 0)
        (scale_y 0)
        (offset_x 0)
        (offset_y 0)
      )
      (running #f)
      (name "Root1")
      (path-ref "gen17676566052645913292896")
    )
    (hurting_platform
      (z-pos 50)
      (handle
        (scale_x 0)
        (scale_y 0)
        (offset_x 0)
        (offset_y 0)
      )
      (path-ref "gen17676570782645913230976")
    )
    (hurting_platform
      (z-pos 50)
      (handle
        (scale_x 0)
        (scale_y 0)
        (offset_x 0)
        (offset_y 0)
      )
      (path-ref "gen17676570912645913234864")
    )
    (jumpy
      (z-pos 50)
      (sprite "/images/creatures/jumpy/wooden.sprite")
      (x 5760)
      (y 896)
      (glinting #f)
    )
    (music
      (file "/music/forest/treeboss.music")
    )
    (particles-ghosts
    )
    (path
      (name "gen17676551553038280489776")
      (path
        (mode "pingpong")
        (adapt_speed #f)
        (node
          (x 1056)
          (y 736)
        )
        (node
          (x 1056)
          (y 832)
        )
      )
    )
    (path
      (name "gen17676556652645913234432")
      (path
        (mode "pingpong")
        (adapt_speed #f)
        (node
          (x 1280)
          (y 736)
        )
        (node
          (x 1280)
          (y 832)
        )
      )
    )
    (path
      (name "gen17676556772645913237888")
      (path
        (mode "pingpong")
        (adapt_speed #f)
        (node
          (x 1504)
          (y 736)
        )
        (node
          (x 1504)
          (y 832)
        )
      )
    )
    (path
      (name "gen17676559602645913238464")
      (path
        (mode "pingpong")
        (adapt_speed #f)
        (node
          (x 3040)
          (y 736)
        )
        (node
          (x 3040)
          (y 832)
        )
      )
    )
    (path
      (name "gen17676559702645913282384")
      (path
        (mode "pingpong")
        (adapt_speed #f)
        (node
          (x 3104)
          (y 736)
        )
        (node
          (x 3104)
          (y 832)
        )
      )
    )
    (path
      (name "gen17676559712645913276768")
      (path
        (mode "pingpong")
        (adapt_speed #f)
        (node
          (x 3264)
          (y 736)
        )
        (node
          (x 3264)
          (y 832)
        )
      )
    )
    (path
      (name "gen17676559732645913284256")
      (path
        (mode "pingpong")
        (adapt_speed #f)
        (node
          (x 3328)
          (y 736)
        )
        (node
          (x 3328)
          (y 832)
        )
      )
    )
    (path
      (name "gen17676561712645913286272")
      (path
        (mode "oneshot")
        (adapt_speed #f)
        (node
          (x 5152)
          (y 864)
        )
        (node
          (x 5152)
          (y 832)
        )
      )
    )
    (path
      (name "gen17676566052645913292896")
      (path
        (mode "oneshot")
        (adapt_speed #f)
        (node
          (x 5152)
          (y 576)
        )
        (node
          (x 5152)
          (y 692)
        )
      )
    )
    (path
      (name "gen17676570782645913230976")
      (path
        (mode "pingpong")
        (adapt_speed #f)
        (node
          (x 8096)
          (y 928)
        )
        (node
          (x 8096)
          (y 1024)
        )
      )
    )
    (path
      (name "gen17676570912645913234864")
      (path
        (mode "pingpong")
        (adapt_speed #f)
        (node
          (x 8480)
          (y 928)
        )
        (node
          (x 8480)
          (y 1024)
        )
      )
    )
    (path
      (name "gen17805789232576102046304")
      (path
        (mode "oneshot")
        (adapt_speed #f)
        (node
          (x 6400)
          (y 672)
        )
      )
    )
    (path
      (name "gen17805789232576102045488")
      (path
        (mode "oneshot")
        (adapt_speed #f)
        (node
          (x 6688)
          (y 672)
        )
      )
    )
    (path
      (name "gen17805789232576103883632")
      (path
        (mode "oneshot")
        (adapt_speed #f)
        (node
          (x 6880)
          (y 608)
        )
      )
    )
    (path
      (name "gen17805789232576103884448")
      (path
        (mode "oneshot")
        (adapt_speed #f)
        (node
          (x 7072)
          (y 640)
        )
      )
    )
    (path
      (name "gen17805789232575943870064")
      (path
        (mode "oneshot")
        (adapt_speed #f)
        (node
          (x 7296)
          (y 576)
        )
      )
    )
    (path
      (name "gen17805789232575955394672")
      (path
        (mode "oneshot")
        (adapt_speed #f)
        (node
          (x 7680)
          (y 608)
        )
      )
    )
    (path
      (name "gen17805789232575955394944")
      (path
        (mode "oneshot")
        (adapt_speed #f)
        (node
          (x 8032)
          (y 640)
        )
      )
    )
    (path
      (name "gen17805789232575955395216")
      (path
        (mode "oneshot")
        (adapt_speed #f)
        (node
          (x 8608)
          (y 640)
        )
      )
    )
    (path
      (name "gen17805789232575955394400")
      (path
        (mode "oneshot")
        (adapt_speed #f)
        (node
          (x 8768)
          (y 576)
        )
      )
    )
    (path
      (name "gen17805789232575955395488")
      (path
        (mode "oneshot")
        (adapt_speed #f)
        (node
          (x 9184)
          (y 640)
        )
      )
    )
    (path
      (name "gen17805789232575955393856")
      (path
        (mode "oneshot")
        (adapt_speed #f)
        (node
          (x 9024)
          (y 576)
        )
      )
    )
    (pushbutton
      (z-pos -99)
      (script "GhostTree.set_action(\"dead\");
Tux.trigger_sequence(\"fireworks\");")
      (x 9440)
      (y 1008)
    )
    (scriptedobject
      (z-pos -101)
      (physic-enabled #f)
      (solid #f)
      (name "GhostTree")
      (sprite "/images/creatures/ghosttree/ghosttree.sprite")
      (x 8520)
      (y 496)
    )
    (scripttrigger
      (oneshot #t)
      (script "Tux.set_dir(true);
Tux.deactivate();
Root1.start_moving();
Root2.start_moving();
wait(1);
Tux.activate();")
      (button #f)
      (width 32)
      (height 224)
      (x 5088)
      (y 704)
    )
    (spawnpoint
      (name "main")
      (x 64)
      (y 768)
    )
    (spawnpoint
      (name "fun")
      (x 4928)
      (y 864)
    )
    (tilemap
      (solid #f)
      (z-pos -100)
      (width 300)
      (height 35)
      (tiles -7562 0 3828 -2937 0)
    )
    (tilemap
      (solid #f)
      (z-pos 100)
      (width 300)
      (height 35)
      (tiles -5260 0 -3 3836 -297 0 -3 3836 -297 0 -3 3836 -297 0 -3 3836 -297 0 -3 3840 -1069 0 -3 3828 -4 0 -3 3828 -4 0 -3 3828 -45 0 -12 3828 -226 0 -3 3832 -4 0 -3 3832 -4 0 -3 3832 -45 0 -12 3832 -226 0 -3 3836 -4 0 -3 3836 -4 0 -3 3836 -45 0 -12 3836 -226 0 -3 3836 -4 0 -3 3836 -4 0 -3 3836 -45 0 -12 3836 -54 0 -3 3828 -169 0 -3 3836 -4 0 -3 3836 -4 0 -3 3836 -45 0 -12 3836 -54 0 -3 3832 -297 0 -3 3840 -389 0 -3 3828 -9 0 -3 3828 -285 0 -3 3832 -9 0 -3 3832 -285 0 -3 3836 -9 0 -3 3836 -285 0 -3 3836 -9 0 -3 3836 -33 0)
    )
    (tilemap
      (solid #t)
      (z-pos 0)
      (width 300)
      (height 35)
      (tiles -159 0 3835 -8 3836 -291 0 3835 -8 3836 -291 0 3835 -8 3836 -291 0 3835 -8 3836 -291 0 3835 -8 3836 -186 0 27 -21 28 29 211 -81 0 3835 -8 3836 -186 0 211 -22 0 212 -81 0 3835 -8 3836 -186 0 212 -22 0 212 -81 0 3835 -8 3836 -186 0 212 -22 0 212 -81 0 3835 -8 3836 -186 0 212 -22 0 212 -81 0 3835 -8 3836 -186 0 212 -22 0 212 -81 0 3835 -8 3836 -186 0 212 -7 0 211 27 -11 28 29 0 212 -81 0 3835 -8 3836 -186 0 212 -7 0 212 -14 0 212 -81 0 3835 -8 3836 -186 0 212 -7 0 212 -14 0 212 -81 0 3835 -8 3836 -186 0 212 0 27 -4 28 29 212 -14 0 212 -81 0 3835 -8 3836 -186 0 212 -7 0 212 0 27 -11 28 29 212 -34 0 3827 -13 3828 3829 -32 0 3835 -8 3836 -186 0 212 -7 0 212 -14 0 212 -34 0 3831 -13 3832 3846 3829 -31 0 3835 -8 3836 -186 0 212 -7 0 212 -14 0 212 -34 0 3835 -13 3836 3851 3846 3829 -30 0 3835 -8 3836 -186 0 212 27 -4 28 29 0 212 -14 0 212 -34 0 3835 -14 3836 3851 3846 3829 -29 0 3835 -8 3836 -186 0 212 -7 0 212 27 -11 28 29 0 212 -34 0 3835 -15 3836 3851 3846 3829 -28 0 3835 -8 3836 -186 0 212 -7 0 212 -14 0 212 -34 0 3835 -16 3836 3851 3846 3829 -27 0 3835 -8 3836 -186 0 213 -7 0 212 -14 0 212 -34 0 3835 -17 3836 3851 3846 3829 -26 0 3839 -8 3840 -188 0 27 -4 28 29 212 -14 0 212 27 -11 28 29 -21 0 3835 -18 3836 3851 3846 -17 3828 3829 -211 0 212 0 27 -11 28 29 213 -34 0 3835 -19 3836 3851 -17 3832 3833 -211 0 212 -49 0 3835 -37 3836 3837 -149 0 -62 3828 213 -49 3828 3848 -22 3836 3843 -14 3840 3841 -149 0 -112 3832 3852 -22 3836 3837 -102 0 3827 3829 -60 0 -135 3836 3837 -95 0 3827 3829 -5 0 3831 3833 -60 0 -135 3836 3837 -2 0 3827 -24 3828 -54 0 3827 3829 -5 0 3827 3829 -5 0 3831 3833 -5 0 3839 3841 -60 0 -135 3836 3837 -2 0 3831 -24 3832 -14 0 3827 -33 3828 3829 -5 0 3831 3833 -5 0 3831 3833 -5 0 3839 3841 -67 0 -135 3836 3837 -2 0 3839 -24 3840 -14 0 3831 -33 3832 3833 -5 0 3839 3841 -5 0 3839 3841 -74 0 -135 3836 3837 -41 0 3835 -33 3836 3837 -34 0 3827 -53 3828 -135 3836 3847 -35 3828 3829 -5 0 3835 -33 3836 3837 -34 0 3831 -53 3832 -135 3836 3851 -35 3832 3833 -5 0 3835 -33 3836 3837 -34 0 3835 -224 3836 3837 -5 0 3835 -33 3836 3837 -34 0 3835 -53 3836)
    )
    (trampoline
      (z-pos 50)
      (x 2528)
      (y 672)
    )
    (willowisp
      (z-pos 150)
      (path-ref "gen17805789232576102046304")
      (adapt-speed #f)
      (handle
        (scale_x 0)
        (scale_y 0)
        (offset_x 0)
        (offset_y 0)
      )
      (flyspeed 128)
      (sector "main")
      (spawnpoint "fun")
      (color 0 1 0)
    )
    (willowisp
      (z-pos 150)
      (path-ref "gen17805789232576102045488")
      (adapt-speed #f)
      (handle
        (scale_x 0)
        (scale_y 0)
        (offset_x 0)
        (offset_y 0)
      )
      (flyspeed 128)
      (sector "main")
      (spawnpoint "fun")
      (color 0 1 0)
    )
    (willowisp
      (z-pos 150)
      (path-ref "gen17805789232576103883632")
      (adapt-speed #f)
      (handle
        (scale_x 0)
        (scale_y 0)
        (offset_x 0)
        (offset_y 0)
      )
      (flyspeed 128)
      (sector "main")
      (spawnpoint "fun")
      (color 0 1 0)
    )
    (willowisp
      (z-pos 150)
      (path-ref "gen17805789232576103884448")
      (adapt-speed #f)
      (handle
        (scale_x 0)
        (scale_y 0)
        (offset_x 0)
        (offset_y 0)
      )
      (flyspeed 128)
      (sector "main")
      (spawnpoint "fun")
      (color 0 1 0)
    )
    (willowisp
      (z-pos 150)
      (path-ref "gen17805789232575943870064")
      (adapt-speed #f)
      (handle
        (scale_x 0)
        (scale_y 0)
        (offset_x 0)
        (offset_y 0)
      )
      (flyspeed 128)
      (sector "main")
      (spawnpoint "fun")
      (color 0 1 0)
    )
    (willowisp
      (z-pos 150)
      (path-ref "gen17805789232575955394672")
      (adapt-speed #f)
      (handle
        (scale_x 0)
        (scale_y 0)
        (offset_x 0)
        (offset_y 0)
      )
      (flyspeed 128)
      (sector "main")
      (spawnpoint "fun")
      (color 0 1 0)
    )
    (willowisp
      (z-pos 150)
      (path-ref "gen17805789232575955394944")
      (adapt-speed #f)
      (handle
        (scale_x 0)
        (scale_y 0)
        (offset_x 0)
        (offset_y 0)
      )
      (flyspeed 128)
      (sector "main")
      (spawnpoint "fun")
      (color 0 1 0)
    )
    (willowisp
      (z-pos 150)
      (path-ref "gen17805789232575955395216")
      (adapt-speed #f)
      (handle
        (scale_x 0)
        (scale_y 0)
        (offset_x 0)
        (offset_y 0)
      )
      (flyspeed 128)
      (sector "main")
      (spawnpoint "fun")
      (color 0 1 0)
    )
    (willowisp
      (z-pos 150)
      (path-ref "gen17805789232575955394400")
      (adapt-speed #f)
      (handle
        (scale_x 0)
        (scale_y 0)
        (offset_x 0)
        (offset_y 0)
      )
      (flyspeed 128)
      (sector "main")
      (spawnpoint "fun")
      (color 0 1 0)
    )
    (willowisp
      (z-pos 150)
      (path-ref "gen17805789232575955395488")
      (adapt-speed #f)
      (handle
        (scale_x 0)
        (scale_y 0)
        (offset_x 0)
        (offset_y 0)
      )
      (flyspeed 128)
      (sector "main")
      (spawnpoint "fun")
      (color 0 1 0)
    )
    (willowisp
      (z-pos 150)
      (path-ref "gen17805789232575955393856")
      (adapt-speed #f)
      (handle
        (scale_x 0)
        (scale_y 0)
        (offset_x 0)
        (offset_y 0)
      )
      (flyspeed 128)
      (sector "main")
      (spawnpoint "fun")
      (color 0 1 0)
    )
  )
)
