(supertux-level
  (version 3)
  (name (_ "Ghosts Are Here"))
  (author "Vaesea")
  (license "CC-BY-SA 4.0 International")
  (target-time 44)
  (allow-item-pocket "inherit")
  (icon "")
  (icon-locked "")
  (statistics
    (enable-coins #t)
    (enable-secrets #t)
  )
  (sector
    (name "main")
    (ambient-light
      (color 1 1 1)
    )
    (background
      (scroll-offset-y 150)
      (color 1 1 1)
      (speed 0.5)
      (image-top "/images/background/ghostforest.jpg")
      (image "/images/background/ghostforest.jpg")
      (image-bottom "/images/background/ghostforest.jpg")
      (z-pos -350)
    )
    (camera
      (name "Camera")
      (mode "normal")
    )
    (decal
      (z-pos -100)
      (sprite "/images/decal/halloween/tree.png")
      (x 288)
      (y 1376)
    )
    (decal
      (z-pos -100)
      (sprite "/images/decal/halloween/tree.png")
      (x 1088)
      (y 1088)
    )
    (decal
      (z-pos -100)
      (sprite "/images/decal/halloween/tree.png")
      (x 640)
      (y 288)
    )
    (decal
      (z-pos -100)
      (sprite "/images/decal/halloween/tree.png")
      (x 2816)
      (y 1216)
    )
    (decal
      (z-pos -100)
      (sprite "/images/decal/halloween/tree.png")
      (x 3904)
      (y 1152)
    )
    (decal
      (z-pos -100)
      (sprite "/images/decal/halloween/tree.png")
      (x 4768)
      (y 1184)
    )
    (decal
      (z-pos -100)
      (sprite "/images/decal/halloween/tree.png")
      (x 5376)
      (y 640)
    )
    (decal
      (z-pos -100)
      (sprite "/images/decal/halloween/tree.png")
      (x 5696)
      (y 640)
    )
    (firefly
      (z-pos 0)
      (x 2976)
      (y 1472)
    )
    (gradient
      (top_color 0.5 0.7 1)
      (bottom_color 1 1 1)
      (z-pos -400)
    )
    (mrtree
      (z-pos 50)
      (x 1184)
      (y 1536)
      (glinting #f)
    )
    (mrtree
      (z-pos 50)
      (x 5152)
      (y 1408)
      (glinting #f)
    )
    (music
      (name "Music_Object")
      (file "/music/forest/ghostforest2.music")
    )
    (particles-ghosts
    )
    (particles-rain
    )
    (path
      (name "gen1772927312102028131903040")
      (path
        (mode "pingpong")
        (adapt_speed #f)
        (node
          (x 1696)
          (y 1664)
          (time 6)
        )
        (node
          (x 2784)
          (y 1536)
          (time 6)
        )
      )
    )
    (platform
      (z-pos 50)
      (handle
        (scale_x 0)
        (scale_y 0)
        (offset_x 0)
        (offset_y 0)
      )
      (running #f)
      (name "p")
      (path-ref "gen1772927312102028131903040")
    )
    (pushbutton
      (z-pos -99)
      (script "p.start_moving();")
      (x 192)
      (y 528)
    )
    (sequencetrigger
      (sequence "endsequence")
      (width 32)
      (height 960)
      (x 5280)
      (y 0)
    )
    (sequencetrigger
      (sequence "stoptux")
      (width 32)
      (height 32)
      (x 5792)
      (y 928)
    )
    (snail
      (z-pos 50)
      (x 1088)
      (y 1600)
      (glinting #f)
    )
    (sound-object
      (sample "/sounds/rain.wav")
      (volume 0.5)
    )
    (spawnpoint
      (name "main")
      (x 64)
      (y 1632)
    )
    (tilemap
      (solid #f)
      (z-pos -100)
      (name "MidGround_Tiles")
      (width 190)
      (height 60)
      (tiles -3048 0 322 360 -397 0 322 -196 0 360 -509 0 130 -189 0 129 -65 0 322 -123 0 129 -189 0 129 -189 0 129 -189 0 129 -189 0 129 -189 0 129 -187 0 322 0 129 -3 0 360 -8 0 322 -8 0 360 -2 0 322 -232 0 360 322 -495 0 2007 -5 1353 -184 0 2008 -5 1354 -184 0 2007 -5 1353 -184 0 2008 -5 1354 -184 0 2007 -5 1353 -184 0 2008 -5 1354 -45 0 360 -138 0 2007 -5 1353 -184 0 2008 -5 1354 -184 0 2007 -5 1353 -54 0 322 0 360 -127 0 2008 -5 1354 -184 0 2007 -5 1353 -184 0 2008 -5 1354 -169 0 322 -3 0 360 -10 0 2007 -5 1353 -72 0 322 -109 0 360 322 2008 -5 1354 -121 0 360 -2 0 322 -391 0 322 -2 0 360 -102 0 360 -206 0 322 -2 0 360 -142 0 360 -7 0 322 0 360 -9 0 322 -1499 0)
    )
    (tilemap
      (solid #f)
      (z-pos 100)
      (width 190)
      (height 60)
      (tiles -4156 0 130 -189 0 129 -189 0 129 -189 0 129 -189 0 129 -189 0 129 -12 0 1998 1999 2000 -174 0 129 -12 0 2023 2024 2025 -174 0 129 -12 0 2026 2027 2028 -174 0 129 -12 0 2029 2030 2031 -387 0 1996 -2639 0 1996 1997 -1256 0 1996 1997 -699 0 1996 1997 -151 0 1996 1997 -567 0)
    )
    (tilemap
      (solid #t)
      (z-pos 0)
      (name "Main_Tiles")
      (width 190)
      (height 60)
      (tiles -46 0 1435 1436 1438 -187 0 1431 1437 1434 -187 0 1435 1432 1438 -187 0 1435 1436 1438 -187 0 1431 1432 1434 -187 0 1435 1436 1438 -187 0 1431 1437 1434 -187 0 1435 1432 1438 -187 0 1435 1436 1438 -187 0 1431 1432 1434 -187 0 1435 1436 1438 -187 0 1431 1437 1434 -187 0 1435 1432 1438 -187 0 1435 1436 1438 -157 0 3159 -29 0 1431 1432 1434 -166 0 3160 3159 -19 0 1435 1436 1438 -146 0 1423 -2 1424 1425 1426 -25 0 3159 -10 0 1431 1437 1434 -146 0 1427 -2 1428 1429 1430 -5 0 1423 1424 1425 1426 -27 0 1435 1432 1438 -146 0 1439 1441 1440 1441 1442 -5 0 1427 1428 1429 1430 -5 0 1423 1424 1425 1426 -18 0 1435 1436 1438 -156 0 1439 1440 1441 1442 -5 0 1427 1428 1429 1430 -5 0 1423 1424 1425 1426 -9 0 1431 1432 1434 -165 0 1439 1440 1441 1442 -5 0 1427 1428 1429 1430 -9 0 1435 1436 1438 -174 0 1439 1440 1441 1442 -9 0 1431 1437 1434 -187 0 1435 1432 1438 -180 0 1423 1424 1425 1424 1425 1424 1425 3373 1436 1434 -180 0 1427 1428 1429 1428 1429 1428 1429 3379 1437 1438 -180 0 1439 1440 1441 1440 1441 1440 1441 3415 1432 1434 -187 0 1435 1436 1438 -175 0 1423 1426 -10 0 1431 1432 1434 -175 0 1427 1430 -8 0 83 102 1435 1436 1438 -175 0 1439 1442 -10 0 1431 1437 1434 -110 0 1423 -30 1424 -46 0 1435 1432 1438 -110 0 1427 -30 1428 -41 0 1423 1424 1425 1424 1425 3373 1436 1434 -110 0 1431 1436 1437 -2 1436 1437 -25 1436 -41 0 1427 1428 1429 1428 1429 3379 1437 1438 -107 0 27 28 29 1431 1436 1437 -2 1436 1437 -25 1436 -34 0 1423 1426 -5 0 1439 1440 1441 1440 1441 1440 3415 1438 -110 0 1439 1440 1441 1440 1441 3415 -25 1432 -32 0 1423 1426 1427 1430 -11 0 1431 1434 -115 0 1431 -25 1432 -30 0 1423 1426 1427 1430 1439 1442 -11 0 1435 1438 -113 0 128 0 1435 -25 1436 -28 0 1423 1426 1427 1430 1439 1442 -13 0 1431 1434 -115 0 1431 -25 1432 -28 0 1427 1430 1439 1442 -15 0 1435 3374 1426 -114 0 1435 -25 1432 -28 0 1439 1442 -17 0 1431 3380 1430 -114 0 1431 -25 1436 -19 0 1423 1424 1425 1426 -24 0 1435 1432 1438 -113 0 112 1435 -25 1432 -19 0 1427 1428 1429 1430 -24 0 1431 1432 1434 -114 0 1431 -25 1432 -19 0 1439 1440 1441 1442 -24 0 1439 3415 1438 -83 0 -4 83 -27 0 1435 -25 1436 -28 0 1423 1424 1425 1426 -16 0 1435 1434 -114 0 1431 -25 1432 -28 0 1427 1428 1429 1430 -5 0 1423 -2 1424 1425 1426 -6 0 1431 1438 -111 0 -3 83 1435 -25 1432 -28 0 1439 1440 1441 1442 -5 0 1427 -2 1428 1429 1430 -6 0 1435 1434 -48 0 -2 83 102 -2 83 -61 0 1431 -25 1432 -37 0 1439 1441 1440 1441 1442 -6 0 1431 1438 -75 0 1443 -25 1424 1426 -12 0 1435 -25 1436 -45 0 1423 -2 1424 3373 1434 -73 0 1443 1445 1446 -25 1428 3376 -12 1424 3373 -25 1432 -45 0 1427 -2 1428 3379 1438 -41 0 1423 -12 1424 1426 -16 0 1443 1445 1446 1449 1450 1432 1436 1437 1432 1436 1437 1432 1436 1437 1432 1436 1437 1432 1436 1437 1432 1436 1437 1432 1436 1437 1432 1436 1437 1432 3382 -12 1428 3379 -25 1432 -45 0 1439 1441 1440 1441 1442 -41 0 1427 -12 1428 1430 -14 0 1443 1445 1446 1449 1450 -11 1432 1433 -29 1432 -25 1436 -4 0 -5 83 -82 0 1431 -2 1436 1437 -2 1436 1437 -2 1436 1437 -2 1436 1437 3374 -13 1424 1445 1446 1449 1450 -2 1436 1437 -2 1436 1437 -2 1436 1437 -2 1436 1437 -2 1436 1437 -2 1436 1437 -2 1436 1437 -2 1436 1437 -2 1436 1437 -2 1436 1437 -2 1436 1437 -2 1436 1437 -2 1436 1437 -2 1436 1437 1436 -25 1432 -26 0 1443 -13 1424 1444 -50 0 1435 1437 1432 1436 1437 1432 1436 1433 1432 1436 1437 1432 1436 3380 -13 1428 1449 1450 1432 1436 1437 1432 1436 1437 1432 1436 1437 1432 1436 1437 1432 1436 1437 1432 1436 1437 1432 1436 1437 1432 1436 1437 1432 1436 1437 1432 1436 1437 1432 1436 1437 1432 1436 1437 1432 1436 1437 1432 1436 1437 1432 1436 1437 -25 1432 -24 0 1443 1445 1446 -13 1428 1447 1448 -10 1424 1426 -38 0 1431 -66 1432 1433 -31 1432 1424 1425 1424 -5 1425 1424 1425 -13 1424 1445 1446 1449 1450 -5 1432 -3 1437 -5 1432 1451 1452 -10 1428 1430 -38 0 1435 -2 1436 1437 -2 1436 1437 -2 1436 1437 -2 1436 1437 -2 1436 1437 -2 1436 1437 -2 1436 1437 -2 1436 1437 -2 1436 1437 -2 1436 1437 -2 1436 1437 -2 1436 1437 -2 1436 1437 -2 1436 1437 -2 1436 1437 -2 1436 1437 -2 1436 1437 -2 1436 1437 -2 1436 1437 -2 1436 1437 -2 1436 1437 -2 1436 1437 -2 1436 1437 -2 1436 1437 -26 1436 1428 1429 1428 -5 1429 1428 1429 -13 1428 1449 1450 -4 1432 -3 1436 1437 1436 -3 1437 1432 1433 -6 1432 -2 1436 1432 -2 1436 -2 1432 1434 -38 0 1431 1437 1432 1436 1437 1432 1436 1437 1432 1436 1437 1432 1436 1437 1432 1436 1437 1432 1436 1437 1432 1436 1437 1432 1436 1437 1432 1436 1437 1432 1436 1437 1433 1436 1437 1432 1436 1437 1432 1436 1437 1432 1436 1437 1432 1436 1437 1432 1436 1437 1432 1436 1437 1432 1436 1437 1432 1436 1437 1433 1436 1437 1432 1436 1437 1432 1436 1437 1432 1436 1437 1432 1436 1437 -27 1432 -6 1436 -10 1432 -3 1436 -4 1432 -5 1436 -8 1437 -13 1436 1437 1438 -38 0 1435 -72 1432 1433 -26 1432 1436 -2 1437 -3 1432 1436 1437 -4 1432 -2 1436 1433 -3 1436 1432 1436 -3 1432 -2 1436 -3 1432 -2 1437 1432 -3 1437 1436 1432 -2 1437 -2 1432 1436 -3 1437 -2 1432 1436 -4 1437 1434 -38 0 1431 -2 1436 1437 -2 1436 1437 -2 1436 1437 -2 1436 1437 -2 1436 1437 -2 1436 1437 -2 1436 1437 -2 1436 1437 -2 1436 1437 -2 1436 1437 -2 1436 1437 -2 1436 1437 -2 1436 1437 -2 1436 1437 -2 1436 1437 -2 1436 1437 -2 1436 1437 -2 1436 1437 -2 1436 1437 -2 1436 1437 -2 1436 1437 -2 1436 1437 -2 1436 1437 -2 1436 1437 -26 1436 1432 -3 1437 -4 1436 -2 1437 -4 1436 -14 1437 -2 1436 1433 1436 1437 1436 1432 1436 -2 1432 -5 1437 -2 1436 -4 1437 -3 1436 1438 -38 0 1435 1437 1432 1436 1437 1432 1436 1437 1432 1436 1437 1432 1436 1437 1432 1436 1437 1432 1436 1437 1432 1436 1437 1432 1436 1437 1432 1436 1437 1432 1436 1437 1432 1436 1437 1432 1436 1437 1432 1436 1437 1432 1436 1437 1432 1436 1437 1432 1436 1437 1432 1436 1437 1432 1436 1437 1432 1436 1437 1432 1436 1437 1432 1436 1437 1432 1436 1437 1432 1436 1437 1432 1436 1437 -25 1432 -2 1437 1436 -12 1437 -4 1436 -3 1432 -2 1436 -3 1437 -5 1436 1437 -2 1432 -3 1436 -3 1437 -2 1432 -2 1436 -2 1437 1432 1433 -2 1436 1432 1434 -38 0 1431 -14 1432 1433 -35 1432 1433 -47 1432 1437 -2 1432 -2 1436 1433 -3 1436 -4 1432 -4 1436 -2 1432 -6 1437 -5 1436 -2 1432 1437 -2 1432 1436 -4 1437 -3 1432 1436 1432 1437 -3 1432 1436 -2 1432 1438 -38 0 1435 -2 1436 1437 -2 1436 1437 -2 1436 1437 -2 1436 1437 -2 1436 1437 -2 1436 1437 -2 1436 1437 -2 1436 1437 -2 1436 1437 -2 1436 1437 -2 1436 1437 -2 1436 1437 -2 1436 1437 -2 1436 1437 -2 1436 1437 -2 1436 1437 -2 1436 1437 -2 1436 1437 -2 1436 1437 -2 1436 1437 -2 1436 1437 -2 1436 1437 -2 1436 1437 -2 1436 1437 -26 1436 -4 1432 -6 1436 -10 1437 -4 1436 -8 1432 -7 1437 -13 1432 1434 -38 0 1431 1437 1432 1436 1437 1432 1436 1437 1432 1436 1437 1432 1436 1437 1432 1436 1437 1432 1436 1437 1432 1436 1437 1432 1436 1433 1432 1436 1437 1432 1436 1437 1432 1436 1437 1432 1436 1437 1432 1436 1437 1432 1436 1437 1432 1436 1437 1432 1436 1437 1432 1436 1437 1432 1436 1437 1432 1436 1437 1432 1436 1437 1432 1436 1437 1432 1436 1437 1432 1436 1437 1432 1436 1437 -25 1432)
    )
    (tilemap
      (solid #t)
      (z-pos -1)
      (width 190)
      (height 60)
      (tiles -5507 0 317 318 -188 0 319 320 -2806 0 313 314 -172 0 27 -10 28 29 -4 0 315 316 -145 0 317 318 -188 0 319 320 -673 0 313 314 -188 0 315 316 -1501 0)
    )
    (unstable_tile
      (type "brick")
      (z-pos 0)
      (x 4640)
      (y 1312)
    )
    (unstable_tile
      (type "brick")
      (z-pos 0)
      (x 4672)
      (y 1280)
    )
    (unstable_tile
      (type "brick")
      (z-pos 0)
      (x 4704)
      (y 1248)
    )
    (unstable_tile
      (type "brick")
      (z-pos 0)
      (x 4736)
      (y 1216)
    )
    (unstable_tile
      (type "brick")
      (z-pos 0)
      (x 4768)
      (y 1184)
    )
    (unstable_tile
      (type "brick")
      (z-pos 0)
      (x 4800)
      (y 1152)
    )
    (unstable_tile
      (type "brick")
      (z-pos 0)
      (x 4832)
      (y 1120)
    )
    (unstable_tile
      (type "brick")
      (z-pos 0)
      (x 4864)
      (y 1088)
    )
    (walkingleaf
      (z-pos 50)
      (x 1280)
      (y 1376)
      (glinting #f)
    )
    (walkingleaf
      (z-pos 50)
      (x 1408)
      (y 736)
      (glinting #f)
    )
    (walkingleaf
      (z-pos 50)
      (x 4448)
      (y 1408)
      (glinting #f)
    )
  )
)
