(supertux-level
  (version 3)
  (name (_ "Ghostly Skulls"))
  (author "Sophie \"Vaesea\" Ball")
  (license "CC-BY-SA 4.0 International")
  (target-time 64)
  (allow-item-pocket "inherit")
  (icon "")
  (icon-locked "")
  (statistics
    (enable-coins #t)
    (enable-secrets #t)
  )
  (sector
    (name "main")
    (ambient-light
      (color 0.6 0.5 0.6)
    )
    (background
      (color 1 1 1)
      (alignment "bottom")
      (speed 0.25)
      (image "/images/background/halloween/mountain.png")
    )
    (background
      (color 1 1 1)
      (alignment "bottom")
      (speed 0.5)
      (image "/images/background/ghostforest_para.png")
      (z-pos -299)
    )
    (bouncingsnowball
      (z-pos 50)
      (direction "left")
      (sprite "/images/creatures/fatbat/fatbat.sprite")
      (x 3232)
      (y 544)
      (glinting #f)
    )
    (bouncingsnowball
      (z-pos 50)
      (direction "left")
      (sprite "/images/creatures/fatbat/fatbat.sprite")
      (x 3552)
      (y 544)
      (glinting #f)
    )
    (bouncingsnowball
      (z-pos 50)
      (direction "left")
      (sprite "/images/creatures/fatbat/fatbat.sprite")
      (x 4576)
      (y 736)
      (glinting #f)
    )
    (bouncingsnowball
      (z-pos 50)
      (direction "left")
      (sprite "/images/creatures/fatbat/fatbat.sprite")
      (x 5216)
      (y 736)
      (glinting #f)
    )
    (bouncingsnowball
      (z-pos 50)
      (direction "left")
      (sprite "/images/creatures/fatbat/fatbat.sprite")
      (x 5536)
      (y 544)
      (glinting #f)
    )
    (bouncingsnowball
      (z-pos 50)
      (direction "left")
      (sprite "/images/creatures/fatbat/fatbat.sprite")
      (x 6816)
      (y 704)
      (glinting #f)
    )
    (bouncingsnowball
      (z-pos 50)
      (direction "left")
      (sprite "/images/creatures/fatbat/fatbat.sprite")
      (x 8960)
      (y 864)
      (glinting #f)
    )
    (bouncingsnowball
      (z-pos 50)
      (direction "left")
      (sprite "/images/creatures/fatbat/fatbat.sprite")
      (x 10240)
      (y 864)
      (glinting #f)
    )
    (bouncingsnowball
      (z-pos 50)
      (direction "left")
      (sprite "/images/creatures/fatbat/fatbat.sprite")
      (x 9600)
      (y 864)
      (glinting #f)
    )
    (camera
      (name "Camera")
      (mode "normal")
    )
    (corrupted_granito
      (type "skullyhop")
      (z-pos 50)
      (direction "left")
      (x 832)
      (y 704)
      (glinting #f)
    )
    (corrupted_granito
      (type "skullyhop")
      (z-pos 50)
      (direction "left")
      (x 1856)
      (y 480)
      (glinting #f)
    )
    (corrupted_granito
      (type "skullyhop")
      (z-pos 50)
      (direction "left")
      (x 2784)
      (y 160)
      (glinting #f)
    )
    (corrupted_granito
      (type "skullyhop")
      (z-pos 50)
      (direction "left")
      (x 2656)
      (y 448)
      (glinting #f)
    )
    (corrupted_granito
      (type "skullyhop")
      (z-pos 50)
      (direction "left")
      (x 6496)
      (y 640)
      (glinting #f)
    )
    (corrupted_granito
      (type "skullyhop")
      (z-pos 50)
      (direction "left")
      (x 6720)
      (y 896)
      (glinting #f)
    )
    (corrupted_granito
      (type "skullyhop")
      (z-pos 50)
      (direction "left")
      (x 6432)
      (y 896)
      (glinting #f)
    )
    (corrupted_granito
      (type "skullyhop")
      (z-pos 50)
      (direction "left")
      (x 5344)
      (y 896)
      (glinting #f)
    )
    (corrupted_granito
      (type "skullyhop")
      (z-pos 50)
      (direction "left")
      (x 5504)
      (y 896)
      (glinting #f)
    )
    (corrupted_granito
      (type "skullyhop")
      (z-pos 50)
      (direction "left")
      (x 9920)
      (y 736)
      (glinting #f)
    )
    (corrupted_granito
      (type "skullyhop")
      (z-pos 50)
      (direction "left")
      (x 9280)
      (y 736)
      (glinting #f)
    )
    (corrupted_granito
      (type "skullyhop")
      (z-pos 50)
      (direction "left")
      (x 9600)
      (y 736)
      (glinting #f)
    )
    (corrupted_granito
      (type "skullyhop")
      (z-pos 50)
      (direction "left")
      (x 14912)
      (y 832)
      (glinting #f)
    )
    (corrupted_granito
      (type "skullyhop")
      (z-pos 50)
      (direction "left")
      (x 11072)
      (y 960)
      (glinting #f)
    )
    (corrupted_granito
      (type "skullyhop")
      (z-pos 50)
      (direction "left")
      (x 11616)
      (y 960)
      (glinting #f)
    )
    (corrupted_granito
      (type "skullyhop")
      (z-pos 50)
      (direction "left")
      (x 12416)
      (y 864)
      (glinting #f)
    )
    (decal
      (z-pos -100)
      (sprite "/images/decal/ghost/tree1.png")
      (x 7808)
      (y 480)
    )
    (decal
      (z-pos -100)
      (sprite "/images/decal/ghost/tree1.png")
      (x 7584)
      (y 480)
    )
    (decal
      (z-pos -100)
      (sprite "/images/decal/ghost/tree2.png")
      (x 8320)
      (y 640)
    )
    (decal
      (z-pos -100)
      (sprite "/images/decal/ghost/tree1.png")
      (x 96)
      (y 480)
    )
    (decal
      (z-pos -100)
      (sprite "/images/decal/ghost/tree1.png")
      (x 800)
      (y 480)
    )
    (decal
      (z-pos -100)
      (sprite "/images/decal/ghost/tree1.png")
      (x 2240)
      (y 224)
    )
    (decal
      (z-pos -100)
      (sprite "/images/decal/ghost/tree1.png")
      (x 2656)
      (y -192)
    )
    (decal
      (z-pos -100)
      (sprite "/images/decal/ghost/tree1.png")
      (x 3232)
      (y 224)
    )
    (decal
      (z-pos -100)
      (sprite "/images/decal/ghost/tree1.png")
      (x 4192)
      (y 544)
    )
    (decal
      (z-pos -100)
      (sprite "/images/decal/ghost/tree1.png")
      (x 4896)
      (y 544)
    )
    (decal
      (z-pos -100)
      (sprite "/images/decal/ghost/tree1.png")
      (x 5696)
      (y 160)
    )
    (decal
      (z-pos -100)
      (sprite "/images/decal/ghost/tree1.png")
      (x 6464)
      (y 544)
    )
    (decal
      (z-pos -100)
      (sprite "/images/decal/ghost/tree1.png")
      (x 5536)
      (y 544)
    )
    (decal
      (z-pos -100)
      (sprite "/images/decal/ghost/tree1.png")
      (x 8672)
      (y 640)
    )
    (decal
      (z-pos -100)
      (sprite "/images/decal/ghost/tree1.png")
      (x 9408)
      (y 256)
    )
    (decal
      (z-pos -100)
      (sprite "/images/decal/ghost/tree1.png")
      (x 9600)
      (y 640)
    )
    (decal
      (z-pos -100)
      (sprite "/images/decal/ghost/tree1.png")
      (x 10400)
      (y 640)
    )
    (decal
      (z-pos -100)
      (sprite "/images/decal/ghost/tree1.png")
      (x 11104)
      (y 480)
    )
    (decal
      (z-pos -100)
      (sprite "/images/decal/ghost/tree1.png")
      (x 11808)
      (y 576)
    )
    (decal
      (z-pos -100)
      (sprite "/images/decal/ghost/tree1.png")
      (x 12640)
      (y 480)
    )
    (decal
      (z-pos -100)
      (sprite "/images/decal/ghost/tree1.png")
      (x 13376)
      (y 544)
    )
    (decal
      (z-pos -100)
      (sprite "/images/decal/ghost/tree1.png")
      (x 14240)
      (y 512)
    )
    (decal
      (z-pos -100)
      (sprite "/images/decal/ghost/tree1.png")
      (x 15072)
      (y 544)
    )
    (decal
      (z-pos -100)
      (sprite "/images/decal/ghost/tree1.png")
      (x 15776)
      (y 544)
    )
    (decal
      (z-pos -100)
      (sprite "/images/decal/ghost/tree2.png")
      (x 544)
      (y 480)
    )
    (decal
      (z-pos -100)
      (sprite "/images/decal/ghost/tree2.png")
      (x 1184)
      (y 480)
    )
    (decal
      (z-pos -100)
      (sprite "/images/decal/ghost/tree2.png")
      (x 1632)
      (y 128)
    )
    (decal
      (z-pos -100)
      (sprite "/images/decal/ghost/tree2.png")
      (x 2464)
      (y 224)
    )
    (decal
      (z-pos -100)
      (sprite "/images/decal/ghost/tree2.png")
      (x 2880)
      (y 0)
    )
    (decal
      (z-pos -100)
      (sprite "/images/decal/ghost/tree2.png")
      (x 3648)
      (y 320)
    )
    (decal
      (z-pos -100)
      (sprite "/images/decal/ghost/tree2.png")
      (x 4736)
      (y 352)
    )
    (decal
      (z-pos -100)
      (sprite "/images/decal/ghost/tree2.png")
      (x 5408)
      (y 416)
    )
    (decal
      (z-pos -100)
      (sprite "/images/decal/ghost/tree2.png")
      (x 6048)
      (y 224)
    )
    (decal
      (z-pos -100)
      (sprite "/images/decal/ghost/tree2.png")
      (x 6240)
      (y 544)
    )
    (decal
      (z-pos -100)
      (sprite "/images/decal/ghost/tree2.png")
      (x 6720)
      (y 352)
    )
    (decal
      (z-pos -100)
      (sprite "/images/decal/ghost/tree2.png")
      (x 7232)
      (y 544)
    )
    (decal
      (z-pos -100)
      (sprite "/images/decal/ghost/tree2.png")
      (x 8032)
      (y 512)
    )
    (decal
      (z-pos -100)
      (sprite "/images/decal/ghost/tree2.png")
      (x 8960)
      (y 640)
    )
    (decal
      (z-pos -100)
      (sprite "/images/decal/ghost/tree2.png")
      (x 9152)
      (y 512)
    )
    (decal
      (z-pos -100)
      (sprite "/images/decal/ghost/tree2.png")
      (x 9792)
      (y 384)
    )
    (decal
      (z-pos -100)
      (sprite "/images/decal/ghost/tree2.png")
      (x 9312)
      (y 640)
    )
    (decal
      (z-pos -100)
      (sprite "/images/decal/ghost/tree2.png")
      (x 9952)
      (y 640)
    )
    (decal
      (z-pos -100)
      (sprite "/images/decal/ghost/tree2.png")
      (x 10816)
      (y 608)
    )
    (decal
      (z-pos -100)
      (sprite "/images/decal/ghost/tree2.png")
      (x 11488)
      (y 608)
    )
    (decal
      (z-pos -100)
      (sprite "/images/decal/ghost/tree2.png")
      (x 12256)
      (y 512)
    )
    (decal
      (z-pos -100)
      (sprite "/images/decal/ghost/tree2.png")
      (x 12896)
      (y 480)
    )
    (decal
      (z-pos -100)
      (sprite "/images/decal/ghost/tree2.png")
      (x 13728)
      (y 544)
    )
    (decal
      (z-pos -100)
      (sprite "/images/decal/ghost/tree2.png")
      (x 14080)
      (y 512)
    )
    (decal
      (z-pos -100)
      (sprite "/images/decal/ghost/tree2.png")
      (x 14720)
      (y 480)
    )
    (decal
      (z-pos -100)
      (sprite "/images/decal/ghost/tree2.png")
      (x 15520)
      (y 544)
    )
    (decal
      (z-pos -100)
      (sprite "/images/decal/ghost/mushroom-1.png")
      (x 12128)
      (y 832)
    )
    (decal
      (z-pos -100)
      (sprite "/images/decal/ghost/mushroom-1.png")
      (x 11392)
      (y 928)
    )
    (decal
      (z-pos -100)
      (sprite "/images/decal/ghost/mushroom-1.png")
      (x 11008)
      (y 928)
    )
    (decal
      (z-pos -100)
      (sprite "/images/decal/ghost/mushroom-1.png")
      (x 11072)
      (y 800)
    )
    (decal
      (z-pos -100)
      (sprite "/images/decal/ghost/mushroom-1.png")
      (x 10240)
      (y 960)
    )
    (decal
      (z-pos -100)
      (sprite "/images/decal/ghost/mushroom-1.png")
      (x 9568)
      (y 960)
    )
    (decal
      (z-pos -100)
      (sprite "/images/decal/ghost/mushroom-1.png")
      (x 9856)
      (y 832)
    )
    (decal
      (z-pos -100)
      (sprite "/images/decal/ghost/mushroom-1.png")
      (x 9504)
      (y 704)
    )
    (decal
      (z-pos -100)
      (sprite "/images/decal/ghost/mushroom-1.png")
      (x 9152)
      (y 704)
    )
    (decal
      (z-pos -100)
      (sprite "/images/decal/ghost/mushroom-1.png")
      (x 8928)
      (y 960)
    )
    (decal
      (z-pos -100)
      (sprite "/images/decal/ghost/mushroom-1.png")
      (x 8512)
      (y 960)
    )
    (decal
      (z-pos -100)
      (sprite "/images/decal/ghost/mushroom-1.png")
      (x 8000)
      (y 832)
    )
    (decal
      (z-pos -100)
      (sprite "/images/decal/ghost/mushroom-1.png")
      (x 7392)
      (y 864)
    )
    (decal
      (z-pos -100)
      (sprite "/images/decal/ghost/mushroom-1.png")
      (x 6784)
      (y 864)
    )
    (decal
      (z-pos -100)
      (sprite "/images/decal/ghost/mushroom-1.png")
      (x 7040)
      (y 736)
    )
    (decal
      (z-pos -100)
      (sprite "/images/decal/ghost/mushroom-1.png")
      (x 6432)
      (y 736)
    )
    (decal
      (z-pos -100)
      (sprite "/images/decal/ghost/mushroom-1.png")
      (x 6080)
      (y 736)
    )
    (decal
      (z-pos -100)
      (sprite "/images/decal/ghost/mushroom-1.png")
      (x 6176)
      (y 864)
    )
    (decal
      (z-pos -100)
      (sprite "/images/decal/ghost/mushroom-1.png")
      (x 5792)
      (y 736)
    )
    (decal
      (z-pos -100)
      (sprite "/images/decal/ghost/mushroom-1.png")
      (x 5408)
      (y 864)
    )
    (decal
      (z-pos -100)
      (sprite "/images/decal/ghost/mushroom-1.png")
      (x 5120)
      (y 864)
    )
    (decal
      (z-pos -100)
      (sprite "/images/decal/ghost/mushroom-1.png")
      (x 4512)
      (y 864)
    )
    (decal
      (z-pos -100)
      (sprite "/images/decal/ghost/mushroom-1.png")
      (x 3968)
      (y 640)
    )
    (decal
      (z-pos -100)
      (sprite "/images/decal/ghost/mushroom-1.png")
      (x 3488)
      (y 544)
    )
    (decal
      (z-pos -100)
      (sprite "/images/decal/ghost/mushroom-1.png")
      (x 3104)
      (y 544)
    )
    (decal
      (z-pos -100)
      (sprite "/images/decal/ghost/mushroom-1.png")
      (x 2656)
      (y 544)
    )
    (decal
      (z-pos -100)
      (sprite "/images/decal/ghost/mushroom-1.png")
      (x 2144)
      (y 544)
    )
    (decal
      (z-pos -100)
      (sprite "/images/decal/ghost/mushroom-1.png")
      (x 1632)
      (y 800)
    )
    (decal
      (z-pos -100)
      (sprite "/images/decal/ghost/mushroom-1.png")
      (x 1984)
      (y 800)
    )
    (decal
      (z-pos -100)
      (sprite "/images/decal/ghost/mushroom-1.png")
      (x 1056)
      (y 800)
    )
    (decal
      (z-pos -100)
      (sprite "/images/decal/ghost/mushroom-1.png")
      (x 416)
      (y 800)
    )
    (decal
      (z-pos -100)
      (sprite "/images/decal/ghost/mushroom-2.png")
      (x 0)
      (y 800)
    )
    (decal
      (z-pos -100)
      (sprite "/images/decal/ghost/mushroom-2.png")
      (x 704)
      (y 800)
    )
    (decal
      (z-pos -100)
      (sprite "/images/decal/ghost/mushroom-2.png")
      (x 1472)
      (y 800)
    )
    (decal
      (z-pos -100)
      (sprite "/images/decal/ghost/mushroom-2.png")
      (x 1056)
      (y 544)
    )
    (decal
      (z-pos -100)
      (sprite "/images/decal/ghost/mushroom-2.png")
      (x 1792)
      (y 448)
    )
    (decal
      (z-pos -100)
      (sprite "/images/decal/ghost/mushroom-2.png")
      (x 2208)
      (y 544)
    )
    (decal
      (z-pos -100)
      (sprite "/images/decal/ghost/mushroom-2.png")
      (x 2848)
      (y 544)
    )
    (decal
      (z-pos -100)
      (sprite "/images/decal/ghost/mushroom-2.png")
      (x 2752)
      (y 320)
    )
    (decal
      (z-pos -100)
      (sprite "/images/decal/ghost/mushroom-2.png")
      (x 2496)
      (y 128)
    )
    (decal
      (z-pos -100)
      (sprite "/images/decal/ghost/mushroom-2.png")
      (x 3168)
      (y 544)
    )
    (decal
      (z-pos -100)
      (sprite "/images/decal/ghost/mushroom-2.png")
      (x 3840)
      (y 640)
    )
    (decal
      (z-pos -100)
      (sprite "/images/decal/ghost/mushroom-2.png")
      (x 4128)
      (y 864)
    )
    (decal
      (z-pos -100)
      (sprite "/images/decal/ghost/mushroom-2.png")
      (x 4512)
      (y 736)
    )
    (decal
      (z-pos -100)
      (sprite "/images/decal/ghost/mushroom-2.png")
      (x 4800)
      (y 864)
    )
    (decal
      (z-pos -100)
      (sprite "/images/decal/ghost/mushroom-2.png")
      (x 5152)
      (y 736)
    )
    (decal
      (z-pos -100)
      (sprite "/images/decal/ghost/mushroom-2.png")
      (x 5792)
      (y 608)
    )
    (decal
      (z-pos -100)
      (sprite "/images/decal/ghost/mushroom-2.png")
      (x 6368)
      (y 608)
    )
    (decal
      (z-pos -100)
      (sprite "/images/decal/ghost/mushroom-2.png")
      (x 7104)
      (y 864)
    )
    (decal
      (z-pos -100)
      (sprite "/images/decal/ghost/mushroom-2.png")
      (x 8256)
      (y 960)
    )
    (decal
      (z-pos -100)
      (sprite "/images/decal/ghost/mushroom-2.png")
      (x 8640)
      (y 960)
    )
    (decal
      (z-pos -100)
      (sprite "/images/decal/ghost/mushroom-2.png")
      (x 9184)
      (y 960)
    )
    (decal
      (z-pos -100)
      (sprite "/images/decal/ghost/mushroom-2.png")
      (x 10144)
      (y 832)
    )
    (decal
      (z-pos -100)
      (sprite "/images/decal/ghost/mushroom-2.png")
      (x 10752)
      (y 928)
    )
    (decal
      (z-pos -100)
      (sprite "/images/decal/ghost/mushroom-2.png")
      (x 11456)
      (y 928)
    )
    (decal
      (z-pos -100)
      (sprite "/images/decal/ghost/mushroom-2.png")
      (x 12192)
      (y 832)
    )
    (decal
      (z-pos -100)
      (sprite "/images/decal/ghost/mushroom-2.png")
      (x 12832)
      (y 800)
    )
    (decal
      (z-pos -100)
      (sprite "/images/decal/ghost/mushroom-2.png")
      (x 13632)
      (y 864)
    )
    (decal
      (z-pos -100)
      (sprite "/images/decal/ghost/mushroom-2.png")
      (x 14624)
      (y 800)
    )
    (decal
      (z-pos -100)
      (sprite "/images/decal/ghost/mushroom-2.png")
      (x 15264)
      (y 864)
    )
    (decal
      (z-pos -100)
      (sprite "/images/decal/ghost/mushroom-3.png")
      (x 288)
      (y 736)
    )
    (decal
      (z-pos -100)
      (sprite "/images/decal/ghost/mushroom-3.png")
      (x 3552)
      (y 480)
    )
    (decal
      (z-pos -100)
      (sprite "/images/decal/ghost/mushroom-3.png")
      (x 6400)
      (y 800)
    )
    (decal
      (z-pos -100)
      (sprite "/images/decal/ghost/mushroom-3.png")
      (x 10336)
      (y 896)
    )
    (decal
      (z-pos -100)
      (sprite "/images/decal/ghost/mushroom-3.png")
      (x 15040)
      (y 800)
    )
    (dispenser
      (z-pos 55)
      (cycle 3)
      (objects
        (leafshot
          (z-pos 50)
          (glinting #f)
        )
      )
      (direction "left")
      (x 13856)
      (y 888)
    )
    (dispenser
      (z-pos 55)
      (cycle 2.5)
      (objects
        (leafshot
          (z-pos 50)
          (glinting #f)
        )
      )
      (direction "left")
      (x 13728)
      (y 760)
    )
    (gradient
      (top_color 0.4 0 0.7)
      (bottom_color 1 1 1)
      (z-pos -301)
    )
    (hurting_platform
      (z-pos 50)
      (handle
        (scale_x 0)
        (scale_y 0)
        (offset_x 0)
        (offset_y 0)
      )
      (running #f)
      (name "root1")
      (path-ref "gen17678807322232820520944")
    )
    (hurting_platform
      (z-pos 50)
      (handle
        (scale_x 0)
        (scale_y 0)
        (offset_x 0)
        (offset_y 0)
      )
      (running #f)
      (name "root2")
      (path-ref "gen17678808672232820532176")
    )
    (hurting_platform
      (z-pos 50)
      (handle
        (scale_x 0)
        (scale_y 0)
        (offset_x 0)
        (offset_y 0)
      )
      (path-ref "gen17679573282000062185328")
    )
    (igel
      (z-pos 50)
      (direction "left")
      (x 11328)
      (y 832)
      (glinting #f)
    )
    (igel
      (z-pos 50)
      (direction "left")
      (x 11968)
      (y 928)
      (glinting #f)
    )
    (jumpy
      (z-pos 50)
      (sprite "/images/creatures/jumpy/wooden.sprite")
      (x 2080)
      (y 352)
      (glinting #f)
    )
    (mole
      (z-pos -1)
      (x 9056)
      (y 992)
      (glinting #f)
    )
    (mrtree
      (z-pos 50)
      (direction "left")
      (x 9568)
      (y 544)
      (glinting #f)
    )
    (mrtree
      (z-pos 50)
      (direction "left")
      (x 13120)
      (y 768)
      (glinting #f)
    )
    (music
      (file "/music/forest/ghostlyskulls.music")
    )
    (path
      (name "gen17678807322232820520944")
      (path
        (mode "oneshot")
        (adapt_speed #f)
        (node
          (x 1664)
          (y 896)
        )
        (node
          (x 1664)
          (y 768)
        )
      )
    )
    (path
      (name "gen17678808672232820532176")
      (path
        (mode "oneshot")
        (adapt_speed #f)
        (node
          (x 1312)
          (y 896)
        )
        (node
          (x 1312)
          (y 768)
        )
      )
    )
    (path
      (name "gen17679573282000062185328")
      (path
        (mode "pingpong")
        (adapt_speed #f)
        (node
          (x 7808)
          (y 896)
          (time 2)
        )
        (node
          (x 7808)
          (y 768)
          (time 2)
        )
      )
    )
    (scripttrigger
      (oneshot #t)
      (script "root1.start_moving();
root2.start_moving();")
      (button #f)
      (width 32)
      (height 256)
      (x 1408)
      (y 608)
    )
    (sequencetrigger
      (sequence "endsequence")
      (width 32)
      (height 928)
      (x 15424)
      (y 0)
    )
    (sequencetrigger
      (sequence "stoptux")
      (width 32)
      (height 32)
      (x 15776)
      (y 896)
    )
    (spawnpoint
      (name "main")
      (x 64)
      (y 800)
    )
    (tarantula
      (z-pos 1)
      (x 7904)
      (y 704)
      (glinting #f)
    )
    (tarantula
      (z-pos 1)
      (x 7680)
      (y 704)
      (glinting #f)
    )
    (tarantula
      (z-pos 1)
      (x 8368)
      (y 752)
      (glinting #f)
    )
    (tilemap
      (solid #f)
      (z-pos -100)
      (width 500)
      (height 35)
      (tiles -10481 0 130 -499 0 129 -499 0 129 -499 0 129 -499 0 129 -499 0 129 -499 0 129 -499 0 129 -499 0 129 -3018 0)
    )
    (tilemap
      (solid #f)
      (z-pos 100)
      (width 500)
      (height 35)
      (tiles -10483 0 130 -93 0 3862 3863 3864 3865 -402 0 129 -93 0 3866 3867 3868 3869 -17 0 3862 3863 3864 3865 -381 0 129 -114 0 3866 3867 3868 3869 -381 0 129 -499 0 129 -499 0 129 -7 0 1998 1999 2000 -46 0 -3 3828 -8 0 -3 3828 -189 0 -3 3828 -237 0 129 -7 0 2023 2024 2025 -46 0 -3 3832 -8 0 -3 3832 -189 0 -3 3832 -237 0 129 -7 0 2026 2027 2028 -15 0 3862 3863 3864 3865 -27 0 -3 3836 -8 0 -3 3836 -16 0 3862 3863 3864 3865 -169 0 -3 3836 -156 0 3862 3863 3864 3865 -77 0 129 -7 0 2029 2030 2031 -15 0 3866 3867 3868 3869 -20 0 3862 3863 3864 3865 -3 0 -3 3836 -8 0 -3 3836 -16 0 3866 3867 3868 3869 -169 0 -3 3836 -156 0 3866 3867 3868 3869 -109 0 3860 3861 -16 0 3866 3867 3868 3869 -3 0 -3 3836 -8 0 -3 3836 0 3860 3861 -28 0 3860 3861 -74 0 3862 3863 3864 3865 -78 0 -3 3836 -248 0 3860 3861 -26 0 3860 3861 -16 0 -3 3836 -8 0 -3 3836 -71 0 3860 3861 -34 0 3866 3867 3868 3869 -12 0 3860 3861 -64 0 -3 3836 0 3862 3863 3864 3865 -147 0 3860 3861 -30 0 3860 3861 -49 0 3862 3863 3864 3865 -51 0 3860 3861 -209 0 3866 3867 3868 3869 -230 0 3866 3867 3868 3869 -15 0 3861 -217 0 3860 3861 -64 0 3860 3861 -536 0 3860 3861 -176 0)
    )
    (tilemap
      (solid #t)
      (z-pos 0)
      (width 500)
      (height 35)
      (tiles -2578 0 3827 -2 3828 3829 -3 0 3827 -2 3828 3829 -489 0 4014 -2 4015 4016 -3 0 4014 -2 4015 4016 -988 0 3830 -4 0 3827 3828 3829 -4 0 3830 -487 0 4013 -4 0 4014 4015 4016 -4 0 4013 -983 0 3827 -2 3828 3829 0 3827 -2 3828 3829 -3 0 3827 -2 3828 3829 0 3827 -2 3828 3829 -460 0 -4 83 -7 0 3830 -7 0 4014 -2 4015 4016 0 4014 -2 4015 4016 -3 0 4014 -2 4015 4016 0 4014 -2 4015 4016 -449 0 -3 83 -19 0 3834 -499 0 3838 -4 0 3827 3828 3829 -4 0 3830 -4 0 3827 3828 3829 -4 0 3830 -4 0 3827 3828 3829 -23 0 -3 83 -410 0 -3 83 -16 0 3827 -6 3828 3829 -5 0 3838 83 140 -2 83 4014 4015 4016 -4 0 4013 -4 0 4014 4015 4016 -4 0 4013 -4 0 4014 4015 4016 -12 0 77 104 -2 77 -429 0 3827 -3 3828 3829 -5 0 4014 -6 4015 4016 -5 0 3838 -113 0 3827 -3 3828 3829 -358 0 3831 -3 3832 3833 -18 0 3838 -94 0 -3 83 -16 0 4014 -3 4015 4016 -348 0 3827 -3 3828 3829 -5 0 3839 -3 3840 3841 -18 0 3838 3827 -47 3828 3829 -4 0 27 -3 28 29 -45 0 3827 -3 3828 3829 -15 0 3827 -3 3828 3829 -338 0 3831 -3 3832 3833 -28 0 3838 3831 -47 3832 3833 -54 0 4014 -3 4015 4016 -15 0 4014 -3 4015 4016 -102 0 3827 -3 3828 3829 -231 0 3839 -3 3840 3841 -28 0 3838 3835 -47 3836 3837 -44 0 3827 -3 3828 3829 -15 0 3827 -3 3828 3829 -15 0 3827 -3 3828 3829 -92 0 4014 -3 4015 4016 -124 0 3827 -2 3828 3829 -136 0 3838 3835 -47 3836 3847 -12 3828 3829 -31 0 4014 -3 4015 4016 -15 0 4014 -3 4015 4016 -15 0 4014 -3 4015 4016 -16 0 -3 83 -202 0 4014 -2 4015 4016 -97 0 3830 -38 0 3838 3835 -47 3836 3851 -12 3832 3833 -21 0 3827 -3 3828 3829 -55 0 3827 -3 3828 3829 -296 0 -7 83 -9 0 3834 -38 0 3838 3835 -60 3836 3837 -21 0 4014 -3 4015 4016 -55 0 4014 -3 4015 4016 -72 0 3827 -3 3828 3829 -5 0 3827 -3 3828 3829 -5 0 3827 -3 3828 3829 -87 0 -3 83 -2 0 140 83 -2 0 -3 83 -116 0 3838 -38 0 3838 3835 -60 3836 3837 -11 0 3827 -3 3828 3829 -15 0 3827 -3 3828 3829 -5 0 3827 -3 3828 3829 -5 0 3827 -3 3828 3829 -5 0 3827 -3 3828 3829 -5 0 3827 -3 3828 3829 -15 0 3827 -3 3828 3829 -62 0 4014 -3 4015 4016 -5 0 4014 -3 4015 4016 -5 0 4014 -3 4015 4016 -112 0 3827 3828 3829 -2 0 3827 3828 3829 -95 0 3838 -38 0 3838 3835 -60 3836 3837 -11 0 4014 -3 4015 4016 -15 0 4014 -3 4015 4016 -5 0 4014 -3 4015 4016 -5 0 4014 -3 4015 4016 -5 0 4014 -3 4015 4016 -5 0 4014 -3 4015 4016 -15 0 4014 -3 4015 4016 -199 0 4014 4015 4016 -2 0 4014 4015 4016 -69 0 -26 3828 3854 -38 3828 3854 3848 -60 3836 3837 -110 0 3827 -10 3828 3829 -95 0 3827 -9 3828 3829 -40 0 3827 -14 3828 3829 -44 0 3827 -9 3828 3829 -33 0 -26 3832 3857 -38 3832 3857 3852 -60 3836 3837 -110 0 3831 -10 3832 3846 -4 3828 3829 -21 0 3827 -3 3828 3829 -5 0 3827 -3 3828 3829 -5 0 3827 -3 3828 3829 -5 0 3827 -3 3828 3829 -5 0 3827 -3 3828 3829 -24 0 4014 -9 4015 4016 -22 0 3827 -9 3828 3829 -7 0 3831 -14 3832 3833 -28 0 3827 -9 3828 3829 -5 0 4014 -9 4015 4016 -33 0 -127 3836 3847 -16 3828 -5 3446 -25 3828 -5 3446 -5 3828 -5 3446 -25 3828 -5 3446 -13 3828 3829 -5 0 3835 -10 3836 3851 -4 3832 3846 3829 -11 0 -3 83 140 -3 83 -2 0 4014 -3 4015 4016 -5 0 4014 -3 4015 4016 -5 0 4014 -3 4015 4016 -5 0 4014 -3 4015 4016 -5 0 4014 -3 4015 4016 -3 0 -4 83 -50 0 4014 -9 4015 4016 -7 0 3835 -14 3836 3837 -7 0 3827 -14 3828 3829 -5 0 4014 -9 4015 4016 -19 0 3827 -29 3828 -127 3836 3851 -104 3832 3833 -5 0 3835 -15 3836 3851 3846 3829 -108 0 3827 -9 3828 3829 -20 0 3835 -14 3836 3837 -7 0 3831 -14 3832 3833 -35 0 3831 -29 3832 -232 3836 3837 -5 0 3835 -16 3836 3851 3846 3829 -78 0 3827 -9 3828 3829 -6 0 3827 -9 3828 3829 0 4014 -9 4015 4016 -20 0 3835 -14 3836 3837 -7 0 3835 -14 3836 3837 -35 0 3835 -261 3836 3837 -5 0 3835 -17 3836 3851 3846 -72 3828 3829 -5 0 4014 -9 4015 4016 -6 0 4014 -9 4015 4016 -32 0 3835 -14 3836 3837 -7 0 3835 -14 3836 3837 -35 0 3835 -261 3836 3837 -5 0 3835 -18 3836 3851 -72 3832 3833 -65 0 3835 -14 3836 3837 -7 0 3835 -14 3836 3837 -35 0 3835 -261 3836 3837 -5 0 3835 -91 3836 3837 -65 0 3835 -14 3836 3837 -7 0 3835 -14 3836 3837 -35 0 3835 -261 3836 3837 -5 0 3835 -91 3836 3837 -65 0 3835 -14 3836 3837 -7 0 3835 -14 3836 3837 -35 0 3835 -29 3836)
    )
    (viciousivy
      (z-pos 50)
      (direction "left")
      (x 3040)
      (y 576)
      (glinting #f)
    )
    (viciousivy
      (z-pos 50)
      (direction "left")
      (x 2912)
      (y 576)
      (glinting #f)
    )
    (walkingleaf
      (z-pos 50)
      (direction "left")
      (x 3392)
      (y 576)
      (glinting #f)
    )
    (walkingleaf
      (z-pos 50)
      (direction "left")
      (x 4864)
      (y 704)
      (glinting #f)
    )
    (walkingleaf
      (z-pos 50)
      (direction "left")
      (x 5856)
      (y 512)
      (glinting #f)
    )
    (walkingleaf
      (z-pos 50)
      (direction "left")
      (x 6176)
      (y 576)
      (glinting #f)
    )
    (walkingleaf
      (z-pos 50)
      (direction "left")
      (x 6176)
      (y 768)
      (glinting #f)
    )
    (walkingleaf
      (z-pos 50)
      (direction "left")
      (x 14368)
      (y 864)
      (glinting #f)
    )
  )
)
