(supertux-level
  (version 3)
  (name (_ "A Ghostly World"))
  (author "Christoph Sommer")
  (license "GPL 2+ / CC-by-sa 3.0")
  (allow-item-pocket "inherit")
  (icon "")
  (icon-locked "")
  (statistics
    (enable-coins #t)
    (enable-secrets #t)
  )
  (sector
    (name "main")
    (ambient-light
      (color 1 1 1)
    )
    (background
      (color 1 1 1)
      (speed 0.5)
      (image-top "images/background/BlueRock_Forest/blue-top.jpg")
      (image "images/background/BlueRock_Forest/blue-middle.jpg")
      (image-bottom "images/background/BlueRock_Forest/blue-bottom.jpg")
    )
    (camera
      (name "Camera")
      (mode "normal")
    )
    (music
      (file "music/wisphunt.music")
    )
    (scripttrigger
      (script "Tux.deactivate();
play_music(\"music/ghostforest.music\");
wait(1);
thunder1.lightning();
wait(1);
thunder1.lightning();
wait(0.33);
thunder1.lightning();
play_sound(\"sounds/warp.wav\");
Tux.activate();
Level.spawn(\"ghostforest\", \"main\");
")
      (button #f)
      (width 28)
      (height 608)
      (x 2016)
      (y 352)
    )
    (sequencetrigger
      (sequence "endsequence")
      (width 668)
      (height 252)
      (x 7520)
      (y 640)
    )
    (sequencetrigger
      (sequence "stoptux")
      (width 156)
      (height 252)
      (x 8032)
      (y 640)
    )
    (spawnpoint
      (name "main")
      (x 128)
      (y 768)
    )
    (spawnpoint
      (name "back")
      (x 6848)
      (y 768)
    )
    (thunderstorm
      (running #f)
      (name "thunder1")
    )
    (tilemap
      (solid #f)
      (z-pos -100)
      (width 256)
      (height 36)
      (tiles -3627 0 1073 1074 1075 -253 0 1081 1082 1083 1084 -251 0 1088 1089 1090 1091 1092 1093 -83 0 1168 1169 1170 -60 0 1240 1241 1242 -100 0 1095 1096 1097 1098 1099 1100 1101 -83 0 1174 1175 1176 1177 -58 0 1243 1244 1245 1246 -100 0 1103 1104 1105 1106 1107 1108 1109 1110 -81 0 1179 1180 1181 1182 1183 -58 0 1247 1248 1249 1250 -100 0 1111 1112 1113 1114 1115 1116 1117 1118 -81 0 1185 1186 1187 1188 1189 1190 -57 0 1251 1252 1253 1254 -100 0 1119 1120 1121 1122 1123 1124 1125 1126 -81 0 1191 1192 1193 1194 1195 1196 -57 0 1255 1256 1257 1258 -37 0 130 -62 0 1127 1128 1129 1130 1131 1132 1133 1134 -81 0 1197 1198 1199 1200 1201 1202 -19 0 402 403 404 405 -34 0 1259 1260 1261 1262 -37 0 129 -64 0 1137 1138 1139 1140 -83 0 1203 1204 1205 1206 1207 1208 -19 0 406 407 408 409 -34 0 1263 1264 1265 1266 -37 0 129 -27 0 402 403 404 405 -33 0 1145 1146 1147 1148 -83 0 1209 1210 1211 1212 1213 1214 -15 0 402 403 404 405 410 411 412 413 -13 0 402 403 404 405 -17 0 1267 1268 1269 1270 -37 0 129 -27 0 406 407 408 409 -33 0 1145 1146 1147 1148 -78 0 402 403 404 -4 0 1223 1224 -17 0 406 407 408 409 414 415 416 417 -13 0 406 407 408 409 -18 0 1272 1273 -38 0 129 -23 0 402 403 404 405 418 419 426 427 436 437 404 405 -29 0 1153 1154 1155 1156 -72 0 402 403 404 405 -2 0 406 407 408 0 404 405 0 1229 1230 -17 0 410 411 426 427 428 429 420 421 -13 0 410 411 412 413 -17 0 1279 1280 1281 1282 -37 0 129 -23 0 406 407 408 409 422 423 430 431 440 441 408 409 -15 0 360 -13 0 1161 1162 1163 1164 -15 0 360 0 360 -54 0 406 407 408 409 -2 0 410 411 412 0 408 409 1234 1235 1236 -17 0 414 415 430 431 432 433 424 425 -13 0 414 415 416 417 -7 0 360 -9 0 1283 1284 1285 1286 -16 0 360 0 360 -18 0 129 -2325 0)
    )
    (tilemap
      (solid #t)
      (z-pos 0)
      (width 256)
      (height 36)
      (tiles -3923 0 84 -332 0 -5 84 -685 0 84 47 84 -73 0 1000 1001 -6 1002 1003 -247 0 1004 1005 -6 1006 1007 -104 0 -2 44 0 -2 44 -23 0 44 -2 0 44 -99 0 1000 1001 -3 1002 1003 -6 0 1008 -7 1009 1011 -7 0 1000 1001 -3 1002 1003 -127 0 1000 1001 -2 1002 -16 0 1000 1001 1002 1003 -71 0 1004 1005 -3 1006 1007 -6 0 1012 1013 1009 1020 1022 -3 1009 1015 -7 0 1004 1005 -3 1006 1007 -20 0 -4 84 -66 0 102 -2 47 83 -2 47 83 -21 0 83 47 -2 83 47 83 -3 0 1004 1005 1006 1007 -16 0 1004 -2 1006 1007 -5 0 47 84 -3 47 84 47 -16 0 1000 1001 -14 1002 1003 -7 0 1000 1001 1003 -7 0 1000 1001 1003 -6 0 1008 -4 1009 1011 84 -5 0 1008 -2 1009 1026 1028 -3 1009 1011 -6 0 84 1008 -4 1009 1011 -4 0 1000 1001 -3 1002 1003 -37 0 1000 1001 1002 1003 -51 0 1000 1001 1003 -22 0 1008 -2 1009 1015 -16 0 1008 -2 1009 1011 -18 0 1000 1001 -8 1002 1036 1005 -14 1006 1007 -7 0 1004 1005 1007 -7 0 1004 1005 1007 -6 0 1008 1020 1021 1022 1009 1011 -6 0 1012 1013 -6 1009 1015 -7 0 1008 1009 1020 1021 1022 1011 -4 0 1004 1005 -3 1006 1007 -37 0 1004 1005 1006 1007 -51 0 1004 1005 1007 -7 0 1000 -2 1002 1003 -11 0 1008 -2 1009 1011 -16 0 1008 -2 1009 1011 -18 0 1004 1005 -8 1006 1040 -15 1009 1011 -7 0 1008 1009 1011 -7 0 1008 1009 1011 -6 0 1008 1026 1027 1028 1009 1011 -6 0 1008 -7 1009 1011 -7 0 1008 1009 1026 1027 1028 1015 -4 0 1008 -4 1009 1011 -6 0 1000 1001 -9 1002 1003 -19 0 1008 -2 1009 1011 -25 0 -26 1002 1034 1009 1035 1002 1003 -3 0 1000 1001 1036 -2 1006 1037 1001 -10 1002 1034 -2 1009 1035 1001 -15 1002 1034 -2 1009 1035 1001 -17 1002 1034 -2 1009 1020 1021 1022 -10 1009 1020 1021 1022 -7 1009 1035 1001 -6 1002 1034 1009 1035 1001 -6 1002 1034 1013 1035 1001 -5 1002 1034 -4 1009 1035 1001 -5 1002 1034 1009 1020 -2 1021 1022 -2 1009 1035 1001 -6 1002 1034 -4 1009 1035 1001 -3 1002 1034 -4 1009 1035 1001 -5 1002 1036 1005 -9 1006 1037 1001 1002 1001 -16 1002 1034 -2 1009 1035 1001 -24 1002 -26 1006 1040 1009 1041 1006 1007 -3 0 1004 1005 1040 -2 1009 1041 1005 -10 1006 1040 -2 1009 1041 1005 -15 1006 1040 -2 1009 1041 1005 -17 1006 1040 -2 1009 1026 1027 1028 -2 1009 1020 1022 -6 1009 1026 1027 1028 -2 1009 1020 1021 1022 -2 1009 1041 1005 -6 1006 1040 1009 1041 1005 -6 1006 1040 1009 1041 1005 -5 1006 1040 -4 1009 1041 1005 -5 1006 1040 1009 1023 1029 1027 1028 -2 1009 1041 1005 -6 1006 1040 -4 1009 1041 1005 -3 1006 1040 -4 1009 1041 1005 -5 1006 1040 -10 1009 1041 1005 1006 1005 1006 1005 -14 1006 1040 1009 1020 1022 1005 -24 1006 -8 1009 1020 1022 -11 1009 1020 1021 1022 -6 1009 1011 -3 0 1008 -12 1009 1020 1021 1022 -2 1009 1020 1022 -10 1009 1020 1021 1022 -9 1009 1020 1021 1022 -3 1009 1020 1022 1009 1020 1021 1022 -13 1009 1026 1028 -2 1009 1020 -2 1021 1022 -3 1009 1020 1021 1032 1029 1028 -7 1009 1020 1022 -13 1009 1020 1022 -19 1009 1023 1025 -41 1009 1020 1022 -11 1009 1020 1021 1022 -10 1009 1026 1028 -10 1009 1020 1021 1022 -10 1009 1020 1022 -3 1009 1020 -2 1021 1022 1009 1026 1028 -11 1009 1026 1027 1028 -3 1009 1020 1022 1009 1011 -3 0 1008 -2 1009 1020 1022 -4 1009 1020 1022 -2 1009 1026 1027 1028 -2 1009 1026 1028 -5 1009 1020 -2 1021 1022 1009 1026 1027 1028 -6 1009 1020 1022 1009 1026 1027 1028 -3 1009 1026 1028 1009 1026 1027 1028 -4 1009 1020 1022 -11 1009 1023 -2 1024 1025 -3 1009 1026 -2 1027 1028 -8 1009 1026 1028 1009 1020 1021 1022 -9 1009 1026 1028 -15 1009 1020 -2 1021 1022 1026 1028 -5 1009 1020 1021 1022 -6 1009 1020 1022 -2 1009 1020 1021 1022 -8 1009 1020 1021 1022 -9 1009 1026 1028 -5 1009 1020 1021 1022 -3 1009 1026 1027 1028 1009 1020 -4 1021 1022 -9 1009 1020 1021 1022 -3 1009 1023 1024 1025 -10 1009 1026 1028 -3 1009 1023 -2 1024 1025 -8 1009 1020 1021 1022 -9 1009 1026 1028 1009 1011 -3 0 1008 -2 1009 1023 1025 -4 1009 1026 1028 -7 1009 1020 1021 1022 -4 1009 1023 -2 1024 1025 -10 1009 1026 1028 -17 1009 1026 1028 -6 1009 1020 1021 1022 -2 1009 1026 -2 1027 1028 -18 1009 1026 1027 1028 1020 -2 1021 1022 -13 1009 1020 1022 -7 1009 1023 -2 1024 1025 -7 1009 1026 1027 1028 -6 1009 1026 1028 -2 1009 1026 1027 1028 -5 1009 1020 1022 1009 1026 1027 1028 -14 1009 1020 1021 1032 1029 1028 -7 1009 1023 -2 1024 1029 1027 1028 -9 1009 1026 1027 1028 -3 1009 1026 1027 1028 -5 1009 1020 -2 1021 1022 -4 1009 1020 1022 1026 -2 1027 1028 -8 1009 1026 1027 1028 -3 1009 1020 1022 -7 1009 1011 -3 0 1008 -2 1009 1023 1031 1022 -12 1009 1026 1027 1028 -4 1009 1026 -2 1027 1028 -5 1009 1020 1021 1022 -9 1009 1020 -2 1021 1022 -16 1009 1026 1027 1028 -11 1009 1020 1021 1022 -13 1009 1023 -2 1024 1025 -7 1009 1020 1021 1022 -3 1009 1026 1028 -7 1009 1026 -2 1027 1028 -5 1009 1020 1022 -21 1009 1026 1028 -9 1009 1020 -2 1021 1022 -5 1009 1023 1024 1029 1028 -8 1009 1026 -2 1027 1028 -4 1009 1020 1021 1022 -18 1009 1023 1024 1029 1028 -4 1009 1026 1028 -18 1009 1026 1028 -2 1009 1020 1021 1022 -2 1009 1011 -3 0 1008 -2 1009 1026 1027 1028 -7 1009 1020 1022 -19 1009 1026 1027 1028 -9 1009 1023 -2 1024 1025 -5 1009 1020 1021 1022 -22 1009 1026 1027 1028 -3 1009 1020 1021 1022 -7 1009 1026 -2 1027 1028 -7 1009 1026 1027 1028 -21 1009 1026 1028 -18 1009 1020 1021 1022 -7 1009 1020 1022 -2 1009 1026 1027 1030 1031 1022 -4 1009 1026 1027 1028 -17 1009 1026 1027 1028 -3 1009 1020 1022 -13 1009 1026 1027 1028 -10 1009 1020 1021 1022 -2 1009 1020 1022 -12 1009 1026 1027 1028 -2 1009 1011 -3 0 1008 -12 1009 1026 1028 -26 1009 1020 1021 1022 -2 1009 1026 -2 1027 1028 -5 1009 1026 1027 1028 -4 1009 1020 1021 1022 -7 1009 1020 1021 1022 -11 1009 1026 1030 1025 -15 1009 1020 1022 -13 1009 1020 1022 -5 1009 1020 1021 1022 -9 1009 1020 1021 1022 -5 1009 1020 1021 1022 -2 1009 1026 1027 1028 -7 1009 1026 1028 -4 1009 1026 1027 1028 -13 1009 1020 1021 1022 -4 1009 1020 1022 -8 1009 1023 1025 -8 1009 1020 1022 -16 1009 1026 1027 1028 -2 1009 1026 1028 -15 1009 1020 1022 1011 -3 0 1008 -2 1009 1020 1022 -5 1009 1020 1021 1022 -9 1009 1020 1022 -3 1009 1020 1021 1022 -4 1009 1020 1022 -5 1009 1026 1027 1028 -7 1009 1020 1022 -7 1009 1020 1021 1032 1029 1028 -7 1009 1026 1027 1028 -12 1009 1023 1025 -5 1009 1020 1021 1022 -7 1009 1026 1028 -6 1009 1020 1021 1022 -4 1009 1026 1028 -5 1009 1026 1027 1028 -9 1009 1026 1027 1028 -2 1009 1020 1022 1009 1026 1027 1028 -8 1009 1020 1021 1022 -16 1009 1020 1022 -5 1009 1026 1027 1028 -4 1009 1026 1028 -8 1009 1026 1028 -3 1009 1020 1021 1022 -2 1009 1026 1028 -8 1009 1020 1022 1020 1021 1022 -14 1009 1020 1021 1022 -8 1009 1026 1028 1011 -3 0 1008 -2 1009 1026 1028 -5 1009 1026 1027 1028 -9 1009 1026 1028 -3 1009 1026 1027 1028 -4 1009 1026 1028 -15 1009 1026 1028 -7 1009 1026 -2 1027 1028 -12 1009 1020 1022 -9 1009 1026 1028 -5 1009 1026 1027 1028 -15 1009 1026 1027 1028 -28 1009 1026 1028 -12 1009 1026 1027 1028 -16 1009 1026 1028 -27 1009 1026 1027 1028 -12 1009 1026 1028)
    )
    (tilemap
      (solid #f)
      (z-pos 100)
      (width 256)
      (height 36)
      (tiles -8884 0 1358 1359 1360 -78 0 1358 -5 1359 1360 -11 0 1358 -3 1359 1360 0 1358 -5 1359 1360 -19 0 1358 -5 1359 1360 -8 0 1358 -3 1359 1360 -12 0 1358 -5 1359 1360 -9 0 1358 -3 1359 1360 -8 0 1358 -5 1359 1360 -16 0 1358 -5 1359 1360 -7 0 1358 -3 1359 1360 -12 0 1358 -5 1359 1360 -3 0 1361 1362 1363 -16 0 1358 -5 1359 1360 -11 0 1358 1359 1360 -12 0 1358 -5 1359 1360 -16 0 1358)
    )
    (viciousivy
      (z-pos 50)
      (x 1344)
      (y 816)
      (glinting #f)
    )
  )
  (sector
    (name "ghostforest")
    (ambient-light
      (color 1 1 1)
    )
    (background
      (color 1 1 1)
      (speed 0.5)
      (image-top "images/background/ghostforest.jpg")
      (image "images/background/ghostforest.jpg")
      (image-bottom "images/background/ghostforest.jpg")
    )
    (camera
      (name "Camera")
      (mode "normal")
    )
    (corrupted_granito
      (type "skullyhop")
      (z-pos 50)
      (x 1344)
      (y 800)
      (glinting #f)
    )
    (corrupted_granito
      (type "skullyhop")
      (z-pos 50)
      (x 3296)
      (y 704)
      (glinting #f)
    )
    (corrupted_granito
      (type "skullyhop")
      (z-pos 50)
      (x 3488)
      (y 704)
      (glinting #f)
    )
    (corrupted_granito
      (type "skullyhop")
      (z-pos 50)
      (x 5280)
      (y 576)
      (glinting #f)
    )
    (corrupted_granito
      (type "skullyhop")
      (z-pos 50)
      (x 7200)
      (y 800)
      (glinting #f)
    )
    (corrupted_granito
      (type "skullyhop")
      (z-pos 50)
      (x 7328)
      (y 704)
      (glinting #f)
    )
    (firefly
      (z-pos 0)
      (x 2656)
      (y 672)
    )
    (jumpy
      (type "wooden")
      (z-pos 50)
      (x 4192)
      (y 784)
      (glinting #f)
    )
    (jumpy
      (type "wooden")
      (z-pos 50)
      (x 6576)
      (y 752)
      (glinting #f)
    )
    (mrbomb
      (z-pos 50)
      (x 5968)
      (y 720)
      (glinting #f)
    )
    (music
      (file "music/ghostforest.music")
    )
    (scripttrigger
      (script "Tux.deactivate();
thunder2.lightning();
wait(0.66);
thunder2.thunder();
wait(0.3);
thunder2.lightning();
play_sound(\"sounds/warp.wav\");
Tux.activate();
Level.spawn(\"main\", \"back\");
")
      (button #f)
      (width 28)
      (height 608)
      (x 6848)
      (y 352)
    )
    (sequencetrigger
      (sequence "endsequence")
      (width 668)
      (height 252)
      (x 7520)
      (y 640)
    )
    (sequencetrigger
      (sequence "stoptux")
      (width 156)
      (height 252)
      (x 8032)
      (y 640)
    )
    (spawnpoint
      (name "main")
      (x 2016)
      (y 768)
    )
    (thunderstorm
      (running #f)
      (name "thunder2")
    )
    (tilemap
      (solid #f)
      (z-pos -100)
      (width 256)
      (height 36)
      (tiles -3627 0 1073 1074 1075 -253 0 1081 1082 1083 1084 -251 0 1088 1089 1090 1091 1092 1093 -146 0 1240 1241 1242 -100 0 1095 1096 1097 1098 1099 1100 1101 -145 0 1243 1244 1245 1246 -100 0 1103 1104 1105 1106 1107 1108 1109 1110 -144 0 1247 1248 1249 1250 -100 0 1111 1112 1113 1114 1115 1116 1117 1118 -144 0 1251 1252 1253 1254 -100 0 1119 1120 1121 1122 1123 1124 1125 1126 -144 0 1255 1256 1257 1258 -37 0 130 -62 0 1127 1128 1129 1130 1131 1132 1133 1134 -144 0 1259 1260 1261 1262 -37 0 129 -64 0 1137 1138 1139 1140 -146 0 1263 1264 1265 1266 -37 0 129 -27 0 402 403 404 405 -33 0 1145 1146 1147 1148 -146 0 1267 1268 1269 1270 -37 0 129 -27 0 406 407 408 409 -33 0 1145 1146 1147 1148 -147 0 1272 1273 -38 0 129 -23 0 402 403 404 405 418 419 426 427 436 437 404 405 -29 0 1153 1154 1155 1156 -146 0 1279 1280 1281 1282 -37 0 129 -23 0 406 407 408 409 422 423 430 431 440 441 408 409 -15 0 360 -13 0 1161 1162 1163 1164 -15 0 322 0 322 -128 0 1283 1284 1285 1286 -16 0 322 0 322 -18 0 129 -2325 0)
    )
    (tilemap
      (solid #t)
      (z-pos 0)
      (name "solid")
      (width 256)
      (height 36)
      (tiles -3923 0 102 -332 0 -3 83 102 83 -508 0 44 0 44 -174 0 83 104 83 -73 0 1423 1424 -6 1425 1426 -247 0 1427 1428 -6 1429 1430 -34 0 -2 44 -199 0 1423 1424 -3 1425 1426 -6 0 1431 -7 1432 1434 -7 0 1423 1424 -3 1425 1426 -127 0 1423 1424 -2 1425 -16 0 1423 1424 1425 1426 -71 0 1427 1428 -3 1429 1430 -6 0 1431 -2 1432 1436 1437 -3 1432 1434 -7 0 1427 1428 -3 1429 1430 -20 0 -2 83 102 83 -66 0 84 -2 47 84 -2 47 84 -21 0 84 104 -2 84 104 84 -3 0 1427 1428 1429 1430 -16 0 1427 -2 1429 1430 -5 0 104 83 77 104 77 83 104 -16 0 1423 1424 -14 1425 1426 -7 0 1423 1424 1426 -7 0 1423 1424 1426 -6 0 1431 -4 1432 1434 -6 0 1431 1432 1437 1436 -4 1432 1434 -7 0 1431 -2 1437 -2 1432 1434 -4 0 1423 1424 -3 1425 1426 -37 0 1423 1424 1425 1426 -51 0 1423 1424 1426 -22 0 1431 1437 1432 1434 -16 0 1431 -2 1432 1434 -18 0 1423 1424 -8 1425 3375 -15 1429 1430 -7 0 1427 1428 1430 -7 0 1427 1428 1430 -6 0 1431 1432 1436 -2 1432 1434 -6 0 1431 1432 1436 -2 1432 1433 -2 1432 1434 -7 0 1431 1432 -2 1436 1432 1434 -4 0 1427 1428 -3 1429 1430 -37 0 1427 1428 1429 1430 -51 0 1427 1428 1430 -7 0 1423 -2 1425 1426 -11 0 1431 1432 1436 1434 -16 0 1431 1432 1433 1434 -6 0 44 0 44 0 44 -7 0 1427 1428 -8 1429 3379 -8 1432 1433 -6 1432 1434 -7 0 1431 1432 1434 -7 0 1431 1432 1434 -6 0 1431 -2 1432 1433 1432 1434 -6 0 1431 1432 1437 -3 1432 1436 1432 1434 -7 0 1431 1432 -2 1436 1432 1434 -4 0 1431 -4 1432 1434 -6 0 1423 1424 -9 1425 1426 -19 0 1431 -2 1432 1434 -25 0 -26 1425 3373 1432 3374 1425 1426 -3 0 1423 1425 3375 -2 1429 3376 1424 -10 1425 3373 1432 1436 3374 -16 1425 3373 -2 1432 3374 1424 -17 1425 3373 -3 1432 1436 -4 1437 -2 1432 1436 1432 -2 1437 1432 -3 1436 -5 1432 1436 1432 3374 1425 1426 -3 0 1423 1425 3373 1432 3374 1425 1426 -3 0 1425 1424 3373 1432 1434 -6 0 1431 1432 1436 -2 1432 1434 -6 0 1431 1432 1437 1436 1437 -3 1432 1434 -7 0 1431 -2 1432 1437 1432 1434 -4 0 1431 1437 1436 1432 1433 3374 -6 1425 3375 -10 1429 3376 -2 1425 1424 -16 1425 3373 1432 1437 3374 1424 -24 1425 -26 1429 3379 1432 3380 1429 1430 -3 0 1427 1429 3381 1432 1436 3380 1428 -10 1429 3379 1437 1436 3380 -16 1429 3379 -2 1436 3380 1428 -17 1429 3379 -3 1432 1436 -3 1432 -2 1437 -3 1436 -4 1437 1432 -2 1436 1432 1437 -4 1432 3380 1429 1430 -3 0 1427 1429 3379 1432 3380 1429 1430 -3 0 1427 1429 3379 1436 1434 -6 0 1431 1432 -2 1437 1432 1434 -6 0 1431 -2 1432 -2 1436 -3 1432 1434 -7 0 1431 -2 1436 -2 1432 1434 -4 0 1431 -4 1432 3380 -6 1429 3379 -4 1432 1437 -5 1432 3380 -2 1429 1428 1429 1428 -14 1429 3379 -2 1432 3380 1428 -24 1429 -3 1432 1437 1432 -3 1436 -2 1432 -2 1437 1436 -2 1432 -3 1436 -2 1432 1437 -2 1436 -2 1432 -2 1436 -3 1432 1434 -3 0 1431 -2 1432 1437 -2 1436 1432 -3 1437 1436 -5 1432 1433 -2 1432 1436 1437 -3 1432 1436 -3 1432 1437 -3 1432 1436 -6 1432 -3 1437 -3 1432 -3 1437 -4 1432 1436 -7 1432 1433 -3 1432 -2 1437 -2 1432 -2 1436 -2 1432 1437 1436 -2 1432 1437 1432 -4 1436 1432 1436 -3 1432 1434 -3 0 1431 -2 1436 1433 -2 1432 1434 -3 0 1431 1437 1436 1432 1434 -6 0 1431 -2 1437 -2 1436 1434 -6 0 1431 1432 1433 1432 1437 1436 -2 1432 1434 -7 0 1431 1432 1436 -2 1432 1434 -4 0 1431 -2 1437 -10 1432 -2 1437 -4 1432 -2 1437 -2 1432 1433 -3 1432 1437 -3 1432 -2 1437 1432 1437 -2 1432 -2 1437 -2 1432 -2 1437 1432 -2 1437 1432 1433 -7 1432 -2 1437 1432 -4 1437 -3 1432 1437 1432 1437 -6 1432 1433 -4 1432 -4 1436 -6 1432 -4 1436 -4 1432 1437 -4 1432 1434 -3 0 1431 -2 1432 1437 -3 1432 -2 1436 -3 1432 -2 1436 -6 1432 1437 -2 1436 1437 1432 1437 -3 1436 1432 -2 1436 -2 1432 -2 1436 -7 1432 -2 1436 1432 1436 -2 1432 -2 1437 1432 1437 -3 1432 1436 1432 1436 -5 1432 1436 -3 1432 1436 -6 1432 1436 1437 -10 1432 1434 -3 0 1431 1432 1436 -3 1432 1434 -3 0 1431 -3 1432 1434 -6 0 1431 -4 1432 1434 -6 0 1431 -7 1432 1434 -7 0 -3 1432 1433 1432 1434 -4 0 1431 1432 1437 -3 1432 -2 1437 1432 -2 1437 -3 1432 1437 1432 1437 -3 1432 1437 -7 1432 1437 -7 1432 1437 -8 1432 1437 -9 1432 1437 -3 1432 1437 1432 1437 1432 1433 -5 1432 -2 1437 -8 1432 -4 1436 -8 1432 -2 1436 -4 1432 1437 -4 1432 1434 -3 0 1431 -2 1432 1437 -4 1432 1436 -3 1432 -2 1436 -6 1432 1437 -2 1436 1437 1432 1437 -3 1436 1432 -2 1436 -2 1432 -2 1436 -7 1432 -2 1436 1432 1436 -2 1432 -2 1437 1432 1437 -3 1432 1436 1432 1436 -5 1432 1436 -3 1432 1436 -6 1432 1436 1437 -3 1432 1433 -6 1432 1434 -3 0 1431 1432 1436 -3 1432 1434 -3 0 1431 -3 1432 1434 -6 0 1431 1432 1436 -2 1432 1434 -6 0 1431 -7 1432 1434 -7 0 -3 1432 1436 1432 1434 -4 0 1431 1432 1437 -3 1432 1433 1437 1432 -2 1437 -3 1432 1437 1432 1437 -3 1432 1437 -7 1432 1437 -7 1432 1433 -8 1432 1437 -9 1432 1437 -3 1432 1437 1432 1437 -7 1432 -2 1437 -8 1432 -4 1436 -6 1432 -2 1436 -6 1432 1437 -4 1432 1434 -3 0 1431 -2 1432 1437 -2 1432 -3 1436 -3 1432 -2 1436 -6 1432 1437 -2 1436 1437 1432 1437 -3 1436 1432 -3 1436 1432 -2 1436 -7 1432 -2 1436 1432 1436 -2 1432 -2 1437 1432 1437 -3 1432 1436 1432 1436 -5 1432 1436 -10 1432 1436 1437 -10 1432 1434 -3 0 1431 -5 1432 1434 -3 0 1431 -3 1432 1434 -6 0 1431 -2 1432 1433 1432 1434 -6 0 1431 -5 1432 -2 1436 1434 -7 0 -3 1432 1436 1432 1434 -4 0 1431 1432 1437 -3 1432 -2 1437 1432 -2 1437 -3 1432 1437 1432 1437 -3 1432 1437 -7 1432 1437 -7 1432 1437 -8 1432 1437 -9 1432 1437 -3 1432 1437 1432 1437 -7 1432 -2 1437 -18 1432 1436 -7 1432 1437 -4 1432 1434 -3 0 1431 -5 1432 -2 1436 -2 1432 1433 1432 -2 1436 -6 1432 -5 1436 1437 -3 1436 1432 -2 1436 -2 1432 -8 1436 1432 1433 1436 1432 1436 -2 1432 -2 1437 1432 1437 -3 1432 1436 1432 1436 -16 1432 1436 1437 -10 1432 1434 -3 0 1431 -5 1432 1434 -3 0 1431 1432 1433 1432 1434 -6 0 1431 1432 -2 1436 1432 1434 -6 0 1431 -2 1432 -3 1436 1432 1436 1434 -7 0 -3 1432 1436 1432 1434 -4 0 1431 1432 1437 -3 1432 -2 1437 1432 -2 1437 -3 1432 1437 1432 1437 -3 1432 1437 -7 1432 1437 -7 1432 1437 -22 1432 1437 1432 1437 -7 1432 -2 1437 -11 1432 1433 -10 1432 1433 -8 1432 1434 -3 0 1431 -5 1432 1436 1432 -9 1436 -2 1432 1436 1437 -2 1436 1433 1432 1437 -3 1436 1432 -2 1436 1432 -5 1436 -3 1432 -4 1436 1432 1436 -2 1432 -2 1437 -3 1436 -4 1432 1436 -9 1432 1436 -6 1432 1436 1437 -10 1432 1434 -3 0 1431 -5 1432 1434 -3 0 1431 -2 1436 1432 1434 -6 0 1431 1432 1436 -2 1432 1434 -6 0 1431 -2 1436 -2 1432 1433 -2 1432 1434 -7 0 -3 1432 1436 1432 1434 -4 0 1431 1432 1437 -4 1432 1437 1432 -2 1437 -4 1432 1433 1437 -28 1432 1437 -6 1432 1433 -8 1432 1437 -5 1432 1433 1432 -2 1437 -10 1432 -2 1436 -8 1432 -2 1436 -9 1432 1434 -3 0 1431 -2 1432 1437 -2 1432 1436 1432 1436 -3 1432 -2 1436 -6 1432 1437 -2 1436 1437 1432 1437 -12 1436 -4 1432 -3 1436 1432 1436 -2 1432 -2 1437 1432 1437 -2 1436 -2 1432 1433 1436 -5 1432 1436 -3 1432 1436 -6 1432 1433 1437 -10 1432 1434 -3 0 1431 1432 1433 -3 1432 1434 -3 0 1431 1432 -2 1436 1434 -6 0 1431 -3 1432 1436 1434 -6 0 1431 1432 1436 -5 1432 1434 -7 0 1432 1433 1432 1436 1432 1434 -4 0 1431 1432 1437 -4 1432 1437 1432 -2 1437 -5 1432 1437 -14 1432 1433 -4 1432 1437 -8 1432 1437 -9 1432 1437 -14 1432 1437 -8 1432 -4 1436 -6 1432 -4 1436 -4 1432 1437 -4 1432 1434 -3 0 1431 1433 -4 1432 -3 1436 -3 1432 -2 1436 -6 1432 1437 -2 1436 1437 1432 1437 -3 1436 1432 -2 1436 -2 1432 -3 1436 1432 -3 1436 -2 1432 -4 1436 -2 1432 -2 1437 1432 1437 -11 1432 1436 -3 1432 1436 -6 1432 1436 1437 -10 1432 1434 -3 0 1431 1432 1436 -3 1432 1434 -3 0 1431 -3 1432 1434 -6 0 1431 -4 1432 1434 -6 0 1431 -7 1432 1434 -7 0 -3 1432 1436 1432 1434 -4 0 1431 1432 1437 -6 1432 -2 1437 -3 1432 1437 1432 1437 -3 1432 1437 -7 1432 1437 -7 1432 1437 -8 1432 1437 -9 1432 1437 -13 1432 -2 1437 1432)
    )
    (tilemap
      (solid #f)
      (z-pos 100)
      (width 256)
      (height 36)
      (tiles -9216 0)
    )
  )
)
