(supertux-level
  (version 3)
  (name (_ "Going Underground"))
  (author "Carsten")
  (license "GPL 2+ / CC-by-sa 3.0")
  (allow-item-pocket "inherit")
  (icon "")
  (icon-locked "")
  (statistics
    (enable-coins #t)
    (enable-secrets #t)
  )
  (sector
    (name "main")
    (ambient-light
      (color 1 1 1)
    )
    (background
      (scroll-offset-y -800)
      (color 1 1 1)
      (scroll-speed-x 0.5)
      (scroll-speed-y 0.5)
      (speed 0.5)
      (image-top "/images/background/BlueRock_Forest/blue-top.jpg")
      (image "/images/background/BlueRock_Forest/blue-middle.jpg")
      (image-bottom "/images/background/BlueRock_Forest/blue-bottom.jpg")
    )
    (bonusblock
      (type "purple")
      (z-pos 51)
      (x 4128.13)
      (y 2400)
    )
    (camera
      (name "Camera")
      (mode "normal")
    )
    (dispenser
      (z-pos 55)
      (cycle 4)
      (objects
        (viciousivy
          (z-pos 50)
          (glinting #f)
        )
      )
      (direction "left")
      (x 3296.092)
      (y 1464.661)
    )
    (firefly
      (z-pos 0)
      (x 2449.13)
      (y 1833.79)
    )
    (igel
      (z-pos 50)
      (direction "left")
      (x 1857.25)
      (y 2273.11)
      (glinting #f)
    )
    (igel
      (z-pos 50)
      (direction "left")
      (x 4451.63)
      (y 2120.62)
      (glinting #f)
    )
    (jumpy
      (type "wooden")
      (z-pos 50)
      (x 2112.88)
      (y 441.8438)
      (glinting #f)
    )
    (jumpy
      (type "wooden")
      (z-pos 50)
      (x 944.375)
      (y 1474.87)
      (glinting #f)
    )
    (jumpy
      (type "wooden")
      (z-pos 50)
      (x 2207.88)
      (y 2044)
      (glinting #f)
    )
    (jumpy
      (type "wooden")
      (z-pos 50)
      (x 2302.25)
      (y 1999.69)
      (glinting #f)
    )
    (jumpy
      (type "wooden")
      (z-pos 50)
      (x 3810.254)
      (y 2437.275)
      (glinting #f)
    )
    (mole
      (z-pos -1)
      (x 3045.504)
      (y 920.4257)
      (glinting #f)
    )
    (mole
      (z-pos -1)
      (x 4147.25)
      (y 2010.555)
      (glinting #f)
    )
    (mrbomb
      (z-pos 50)
      (direction "left")
      (x 1152.255)
      (y 289.5605)
      (glinting #f)
    )
    (mrbomb
      (z-pos 50)
      (direction "left")
      (x 2115)
      (y 1237.88)
      (glinting #f)
    )
    (mrbomb
      (z-pos 50)
      (direction "left")
      (x 939.75)
      (y 2008.712)
      (glinting #f)
    )
    (mrbomb
      (z-pos 50)
      (direction "left")
      (x 2960.75)
      (y 1597.11)
      (glinting #f)
    )
    (mrbomb
      (z-pos 50)
      (direction "left")
      (x 3117)
      (y 1597.11)
      (glinting #f)
    )
    (mrtree
      (z-pos 50)
      (direction "left")
      (x 1581.625)
      (y 450.5818)
      (glinting #f)
    )
    (mrtree
      (z-pos 50)
      (direction "left")
      (x 1780.75)
      (y 1418.01)
      (glinting #f)
    )
    (music
      (file "/music/forest2.ogg")
    )
    (secretarea
      (message (_ "You found a secret area!"))
      (width 351.75)
      (height 192.9929)
      (x 1567.75)
      (y 639.8297)
    )
    (secretarea
      (fade-tilemap "secret1")
      (message (_ "You found a secret area!"))
      (width 384.125)
      (height 159.9434)
      (x 3424.63)
      (y 1696.088)
    )
    (snail
      (z-pos 50)
      (direction "left")
      (x 2001.629)
      (y 1471.235)
      (glinting #f)
    )
    (snail
      (z-pos 50)
      (direction "left")
      (x 1425.88)
      (y 2014.153)
      (glinting #f)
    )
    (snail
      (z-pos 50)
      (direction "left")
      (x 3389.63)
      (y 2581.223)
      (glinting #f)
    )
    (spawnpoint
      (name "main")
      (x 96.59421)
      (y 480.5109)
    )
    (tilemap
      (solid #f)
      (z-pos -110)
      (width 150)
      (height 110)
      (tiles -1582 0 2007 -8 1353 -59 0 404 405 -49 0 402 403 404 405 -27 0 2009 474 -7 1353 -59 0 408 409 -49 0 406 407 408 409 -28 0 2007 -8 1353 -58 0 426 427 404 405 -47 0 418 419 426 427 404 405 -13 0 1001 1002 -3 0 402 403 404 405 -4 0 2007 -8 1353 -58 0 430 431 408 409 -47 0 422 423 430 431 408 409 -18 0 406 407 408 409 -4 0 2007 -9 1353 -57 0 442 443 426 427 436 437 404 405 -41 0 402 403 428 429 450 451 420 421 -18 0 410 411 412 413 -4 0 2007 -10 1353 -56 0 446 447 430 431 440 441 408 409 -41 0 406 407 432 433 454 455 424 425 -18 0 414 415 416 417 0 -3 1351 476 -10 1353 -136 0 -3 1352 478 -10 1353 -136 0 -14 1353 -105 0 -9 1353 -22 0 -14 1353 -104 0 -2 1353 473 -5 1821 474 -4 1353 -21 0 -12 1353 -104 0 1353 473 2014 -5 0 2009 -2 1821 474 1353 -21 0 -12 1353 -104 0 1353 2012 -9 0 2007 1353 -21 0 -11 1353 -105 0 1353 2012 -9 0 2007 1353 -25 0 -7 1353 -2 0 -4 1353 -99 0 1353 2013 -9 0 2008 1353 -14 0 -25 1353 -98 0 1353 475 -9 1351 476 1353 -11 0 -28 1353 -98 0 1353 477 -9 1352 478 1353 -11 0 -28 1353 -105 0 -5 1353 -10 0 -30 1353 -105 0 -5 1353 -10 0 -30 1353 -105 0 -5 1353 -10 0 -30 1353 -105 0 -45 1353 -103 0 -25 1353 -6 0 -10 1353 -109 0 -25 1353 -125 0 -25 1353 -124 0 -23 1353 -127 0 -23 1353 -127 0 -23 1353 -127 0 -20 1353 -131 0 -19 1353 -3 0 -5 1353 -123 0 -19 1353 0 -8 1353 -89 0 -61 1353 -89 0 -61 1353 -87 0 -63 1353 -86 0 -63 1353 -87 0 -63 1353 -16 0 -6 1353 -65 0 -63 1353 0 -25 1353 -61 0 -62 1353 -2 0 -25 1353 -62 0 -59 1353 -4 0 -25 1353 -61 0 -32 1353 -22 0 -6 1353 -4 0 -25 1353 -61 0 -29 1353 -32 0 -28 1353 -61 0 -29 1353 -30 0 -30 1353 -61 0 -29 1353 -30 0 -30 1353 -61 0 -29 1353 -30 0 -35 1353 -56 0 -29 1353 -25 0 -48 1353 -50 0 -9 1353 -39 0 -20 1353 0 -31 1353 -50 0 -68 1353 0 -31 1353 -49 0 -68 1353 -2 0 -31 1353 -49 0 -68 1353 -2 0 -31 1353 -49 0 -67 1353 -3 0 -56 1353 -24 0 -67 1353 -3 0 -56 1353 -24 0 -67 1353 -3 0 -56 1353 -25 0 -66 1353 -3 0 -56 1353 -26 0 -20 1353 0 -44 1353 -3 0 -56 1353 -26 0 -65 1353 -3 0 -56 1353 -30 0 -61 1353 -16 0 -43 1353 -38 0 -10 1353 -2 0 -13 1353 -3 0 -25 1353 -17 0 -42 1353 -39 0 -52 1353 -18 0 -41 1353 -39 0 -52 1353 -18 0 -19 1353 -2 0 -20 1353 -39 0 -34 1353 -8 0 -10 1353 -18 0 -19 1353 -2 0 -20 1353 -39 0 -34 1353 -8 0 -10 1353 -18 0 -18 1353 -6 0 -17 1353 -39 0 -35 1353 -7 0 -10 1353 -18 0 -18 1353 -6 0 -17 1353 -42 0 -32 1353 -7 0 -10 1353 -18 0 -41 1353 -45 0 -29 1353 -35 0 -32 1353 -54 0 -18 1353 -3 0 -8 1353 -34 0 -33 1353 -54 0 -18 1353 -3 0 -7 1353 -34 0 -34 1353 -116 0 -34 1353 -116 0 -33 1353 -108 0 -42 1353 -108 0 -40 1353 -110 0 -40 1353 -110 0 -17 1353 -4 0 -6 1353 0 -6 1353 -116 0 -17 1353 -4 0 -6 1353 0 -6 1353 -116 0 -17 1353 -41 0 -36 1353 -2 0 -23 1353 -2 0 -23 1353 -2 0 -56 1353 -6 0 -36 1353 -2 0 -23 1353 -2 0 -23 1353 -2 0 -56 1353 -6 0 -36 1353 -2 0 -23 1353 -2 0 -23 1353 -2 0 -56 1353 -6 0 -36 1353 -2 0 -23 1353 -2 0 -23 1353 -2 0 -56 1353 -6 0 -36 1353 -2 0 -23 1353 -2 0 -23 1353 -2 0 -56 1353 -6 0 -36 1353 -2 0 -23 1353 -2 0 -23 1353 -2 0 -56 1353 -6 0 -36 1353 -2 0 -23 1353 -2 0 -23 1353 -2 0 -56 1353 -6 0 -36 1353 -2 0 -23 1353 -2 0 -23 1353 -2 0 -56 1353 -6 0 -36 1353 -2 0 -23 1353 -2 0 -23 1353 -2 0 -56 1353 -6 0 -36 1353 -2 0 -23 1353 -2 0 -23 1353 -2 0 -56 1353 -6 0 -36 1353 -2 0 -23 1353 -2 0 -23 1353 -2 0 -56 1353 -6 0 -36 1353 -2 0 -23 1353 -2 0 -23 1353 -2 0 -56 1353 -6 0 -36 1353 -2 0 -23 1353 -2 0 -23 1353 -2 0 -56 1353 -6 0 -36 1353 -2 0 -23 1353 -2 0 -23 1353 -2 0 -56 1353 -6 0 -36 1353 -2 0 -23 1353 -2 0 -23 1353 -2 0 -98 1353 -2 0 -23 1353 -2 0 -23 1353 -2 0 -98 1353 -2 0 -23 1353 -2 0 -23 1353 -2 0 -98 1353 -2 0 -23 1353 -2 0 -23 1353 -2 0 -98 1353 -2 0 -23 1353 -2 0 -23 1353 -2 0 -98 1353 -2 0 -23 1353 -2 0 -23 1353 -2 0 -98 1353 -2 0 -23 1353 -2 0 -23 1353 -2 0 -98 1353 -2 0 -23 1353 -2 0 -23 1353 -2 0 -58 1353 -4 0 -36 1353 -2 0 -23 1353 -2 0 -23 1353 -2 0 -57 1353 -5 0 -36 1353 -2 0 -23 1353 -2 0 -23 1353 -2 0 -57 1353 -5 0 -36 1353 -2 0 -23 1353 -2 0 -23 1353 -2 0 -57 1353 -5 0 -36 1353 -2 0 -23 1353 -2 0 -23 1353 -2 0 -57 1353 -5 0 -36 1353 -2 0 -23 1353 -2 0 -23 1353 -2 0 -56 1353 1908 -5 0)
    )
    (tilemap
      (solid #f)
      (z-pos -100)
      (name "Background")
      (width 150)
      (height 110)
      (tiles -337 0 1073 1074 1075 -111 0 1168 1169 1170 -33 0 1081 1082 1083 1084 -110 0 1174 1175 1176 1177 -19 0 1287 1288 -10 0 1088 1089 1090 1091 1092 1093 -108 0 1179 1180 1181 1182 1183 -19 0 1289 1290 -9 0 1095 1096 1097 1098 1099 1100 1101 -2 0 1240 1241 1242 -9 0 1168 1169 1170 -18 0 1287 1288 -71 0 1185 1186 1187 1188 1189 1190 -18 0 1291 1292 -9 0 1103 1104 1105 1106 1107 1108 1109 1110 1243 1244 1245 1246 -9 0 1174 1175 1176 1177 -17 0 1289 1290 -71 0 1191 1192 1193 1194 1195 1196 0 1240 1241 1242 -14 0 1293 1294 -9 0 1111 1112 1113 1114 1115 1116 1117 1118 1247 1248 1249 1250 -8 0 1179 1180 1181 1182 1183 -14 0 1240 1241 1242 1291 1292 -71 0 1197 1198 1199 1200 1201 1202 1243 1244 1245 1246 -14 0 1295 1296 -9 0 1119 1120 1121 1122 1123 1124 1125 1126 1251 1252 1253 1254 -8 0 1185 1186 1187 1188 1189 1190 -12 0 1243 1244 1245 1246 1293 1294 -71 0 1203 1204 1205 1206 1207 1208 1247 1248 1249 1250 -14 0 1297 1298 -9 0 1127 1128 1129 1130 1131 1132 1133 1134 1255 1256 1257 1258 -8 0 1191 1192 1193 1194 1195 1196 -12 0 1247 1248 1249 1250 1295 1296 -71 0 1209 1210 1211 1212 1213 1214 1251 1252 1253 1254 -14 0 1299 1300 -2 0 402 403 404 405 -5 0 1137 1138 1139 1140 -2 0 1259 1260 1261 1262 -8 0 1197 1198 1199 1200 1201 1202 -12 0 1251 1252 1253 1254 1297 1298 -72 0 2045 1219 1220 -2 0 1255 1256 1257 1258 -14 0 1301 1302 -2 0 406 407 408 409 -5 0 1145 1146 1147 1148 -2 0 1263 1264 1265 1266 -8 0 1203 1204 1205 1206 1207 1208 -12 0 1255 1256 1257 1258 1299 1300 -72 0 2046 1225 1226 -2 0 1259 1260 1261 1262 -14 0 1303 1304 -2 0 410 411 426 427 404 405 -3 0 1153 1154 1155 1156 -2 0 1267 1268 1269 1270 -8 0 1209 1210 1211 1212 1213 1214 -12 0 1259 1260 1261 1262 1301 1302 -73 0 1217 1218 -2 0 1263 1264 1265 1266 -14 0 1305 1306 -2 0 414 415 430 431 408 409 0 360 0 1161 1162 1163 1164 -2 0 1271 1272 1273 1274 -10 0 1219 1218 -11 0 1001 1002 0 1263 1264 1265 1266 1303 1304 -73 0 1223 1224 -2 0 1267 1268 1269 1270 -8 0 402 403 404 405 -2 0 1307 1308 -17 0 1275 1276 1277 1278 -10 0 1225 1224 -14 0 1267 1268 1269 1270 1305 1306 -72 0 1228 1229 1230 -3 0 1280 1281 1282 -8 0 406 407 408 409 -2 0 1309 1310 -17 0 1279 1280 1281 1282 -9 0 1228 1229 1230 -3 0 360 -11 0 1280 1281 0 1307 1308 -72 0 1234 1235 1236 -3 0 1284 1285 1286 -3 0 360 -2 0 360 0 410 411 412 413 -21 0 1283 1284 1285 1286 -9 0 1234 1235 1236 -15 0 1284 1285 0 1309 1310 -1199 0 323 324 -148 0 325 326 -148 0 327 328 -148 0 329 330 -317 0 322 -140 0 -2 322 -732 0 322 -441 0 1616 1617 -11 0 323 324 -122 0 323 324 -5 0 360 -5 0 1618 1619 -11 0 325 326 -94 0 323 324 -26 0 325 326 -24 0 327 328 -94 0 325 326 -26 0 327 328 -5 0 323 324 -17 0 329 330 -94 0 327 328 -26 0 329 330 -5 0 325 326 -113 0 329 330 -33 0 327 328 -148 0 329 330 -175 0 323 324 -115 0 322 -17 0 360 -14 0 325 326 -148 0 327 328 -148 0 329 330 -627 0 323 324 -148 0 325 326 -63 0 323 324 -83 0 327 328 -63 0 325 326 -33 0 323 324 -48 0 329 330 -63 0 327 328 -33 0 325 326 -17 0 322 -15 0 322 -3 0 322 -75 0 329 330 -33 0 327 328 -41 0 323 324 -5 0 322 -99 0 329 330 -41 0 325 326 -148 0 327 328 -81 0 322 -66 0 329 330 -2 0 323 324 -148 0 325 326 -59 0 -2 322 -58 0 322 -9 0 322 -5 0 360 -12 0 327 328 -14 0 322 -69 0 360 -63 0 329 330 -379 0 323 324 -148 0 325 326 -148 0 327 328 -148 0 329 330 -67 0 -2 322 -2 0 322 -174 0 322 -76 0 55 -58 0 323 324 -89 0 56 -58 0 325 326 -70 0 322 -2 0 322 -74 0 327 328 -148 0 329 330 -584 0 322 -6 0 322 -277 0 1616 1617 -148 0 1618 1619 -141 0 323 324 -148 0 325 326 -6 0 323 324 -140 0 327 328 -6 0 325 326 -140 0 329 330 -6 0 327 328 -148 0 329 330 -1683 0 130 -149 0 129 -149 0 129 -149 0 129 -149 0 129 -149 0 129 -1066 0)
    )
    (tilemap
      (solid #t)
      (z-pos 0)
      (name "Interactive")
      (width 150)
      (height 110)
      (tiles -80 0 1008 -69 1009 -80 0 1008 -69 1009 -80 0 1008 -69 1009 -80 0 1008 -69 1009 -80 0 1008 -69 1009 -80 0 1008 -69 1009 -33 0 47 83 47 -44 0 1008 -69 1009 -80 0 1016 1017 -68 1009 -82 0 1008 -67 1009 -32 0 -5 44 -45 0 1012 1009 1010 -65 1009 -31 0 47 83 27 28 29 83 47 -31 0 104 -2 83 104 -9 0 1016 1017 -6 1018 -60 1009 -70 0 -2 44 -18 0 1012 -59 1009 -61 0 -2 83 -7 0 -2 44 -18 0 1016 -59 1009 -27 0 1000 1001 -12 1002 1003 -27 0 1000 -2 44 1003 -18 0 1012 -58 1009 -15 0 1278 -11 0 1004 1005 -12 1006 1007 -27 0 1004 1005 1006 1007 -18 0 1016 -2 1009 1010 -55 1009 -15 0 1282 -6 0 1060 -4 1002 1034 -13 1009 1011 -18 0 1000 1001 1002 1003 -5 0 1008 -2 1009 1011 -19 0 1016 -57 1009 1001 -20 1002 1063 1064 -4 1006 1040 -2 1009 1010 -10 1009 1035 1001 -17 1002 1036 1005 1006 1037 1001 -4 1002 1034 -2 1009 1035 1001 -6 1002 1003 -12 0 1008 -56 1009 1005 -20 1006 1067 1068 -18 1009 1041 1005 -17 1006 1040 -2 1009 1041 1005 -4 1006 1040 -2 1009 1041 1005 -6 1006 1007 -12 0 1008 -3 1009 1020 -3 1021 1022 -118 1009 1010 -9 1009 1035 1002 1003 -10 0 1008 -3 1009 1023 -3 1024 1025 -54 1009 1010 -12 1009 1020 -2 1021 1022 -24 1009 1010 -2 1009 -7 1018 -23 1009 1041 1006 1007 -10 0 1008 -3 1009 1023 -3 1024 1025 -65 1009 1020 1021 1032 -2 1024 1025 -26 1009 1019 -7 0 1016 -2 1018 -17 1009 1020 1021 1022 -2 1009 1011 -9 0 1000 1034 -3 1009 1026 -3 1027 1028 -65 1009 1023 -3 1024 1029 1028 -25 1009 1011 -11 0 1008 -16 1009 1023 1024 1031 1022 1009 1035 1001 -2 1002 1003 -5 0 1004 1040 -73 1009 1026 -3 1027 1028 -26 1009 1011 -3 0 128 -7 0 1008 -16 1009 1026 1030 1024 1025 1009 1041 1005 -2 1006 1007 -4 0 1000 1034 -105 1009 1011 -11 0 1008 -17 1009 1026 1027 1028 -4 1009 1010 1015 -4 0 1004 1040 -3 1009 -2 1017 -100 1009 1011 -11 0 1008 -15 1009 1017 -9 1018 1019 0 -2 44 0 1016 -3 1009 1019 -2 0 1016 -99 1009 1035 1001 -5 1002 1003 -3 0 1000 1034 -12 1009 1017 1018 1019 -12 0 -2 44 -2 0 1016 1017 1019 -4 0 1008 1010 -97 1009 1041 1005 -5 1006 1007 -3 0 1004 1040 -11 1009 1015 -15 0 -2 44 -7 0 102 0 1008 -105 1009 1011 -3 0 1008 -11 1009 1018 1019 -26 0 1008 -105 1009 1011 -2 0 112 1008 -10 1009 1011 -28 0 1008 -105 1009 1011 -3 0 1008 -6 1009 1010 -3 1009 1015 -6 0 1723 1724 1725 1724 1725 1724 1725 1726 -8 0 1723 1724 1725 1724 1725 1724 1817 -105 1009 1011 -3 0 1016 -3 1018 1017 -6 1018 1019 -6 0 1008 -6 1009 1820 1724 1725 1724 1725 1724 1725 1724 1725 1817 -9 1009 1020 1022 -99 1009 1018 1019 -21 0 1008 -25 1009 1026 1028 -98 1009 1011 -3 0 112 -16 0 1723 1724 1725 1817 -125 1009 1011 -20 0 1008 -18 1009 1010 -109 1009 1019 -20 0 1008 -3 1009 1020 1022 -34 1009 1010 -48 1009 1010 -38 1009 1011 -18 0 1723 1724 1725 1817 -3 1009 1026 1028 -122 1009 1820 1726 -2 0 112 -14 0 1008 -131 1009 1011 -17 0 1008 -26 1009 1020 -2 1021 1022 -101 1009 1011 -17 0 1008 -4 1009 -3 1018 -19 1009 1023 -2 1024 1025 -94 1009 1010 -6 1009 1015 -3 0 1723 1724 1725 1726 -3 0 1723 1724 1725 1726 -3 0 1008 -2 1009 1017 1019 -3 0 1016 -18 1009 1023 -2 1024 1025 -69 1009 -32 1018 1019 -3 0 1008 -2 1009 1011 -3 0 1008 -2 1009 1011 -3 0 1016 1017 1019 -6 0 1008 -17 1009 1026 -2 1027 1028 -68 1009 1011 -36 0 1016 1017 1018 1019 -3 0 1016 1017 1018 1019 -11 0 1723 1008 -88 1009 1017 1019 -58 0 1817 -19 1009 1010 -68 1009 1019 -32 0 -5 83 -17 0 -2 44 -4 0 1817 -87 1009 1011 -55 0 -2 44 -3 0 1723 1817 -17 1009 -4 1018 -58 1009 1020 1021 1022 -5 1009 1011 1726 -54 0 -2 44 0 1723 1724 1817 -3 1009 -14 1017 1019 -4 0 1008 1009 -2 1017 -54 1009 1023 1024 1025 -6 1009 1011 -29 0 1723 1724 1725 1724 1725 1724 1725 1724 1725 1724 1725 1724 1725 1724 1725 1724 1725 1724 1725 1724 1725 1724 1725 1726 -4 0 1008 -4 1009 1011 -19 0 1016 1019 -2 0 1008 -53 1009 1026 1027 1028 -6 1009 1011 -26 0 1723 1724 1725 1817 -22 1009 1820 1724 1725 1724 1725 1817 -4 1009 1011 -16 0 103 -6 0 1008 -62 1009 1019 -10 0 1723 1726 -6 0 1723 1726 -6 0 1008 -35 1009 1011 -23 0 1008 -61 1009 1011 -11 0 1016 1019 -6 0 1016 1019 -6 0 1008 -8 1009 1020 1022 -11 1009 1010 -11 1009 1017 1018 1019 -23 0 1008 -3 1009 1020 1021 1022 -55 1009 1011 -27 0 1008 -8 1009 1026 1028 -21 1009 1018 1019 -8 0 1723 1724 1725 1724 1725 1724 1725 1724 1725 1724 1725 1724 1725 1724 1726 -3 0 1008 -3 1009 1023 1024 1025 -55 1009 1011 -27 0 1008 1010 -29 1009 1011 -10 0 1008 -13 1009 1820 -3 0 1008 -3 1009 1026 1027 1028 -43 1009 1010 -11 1009 1820 1724 1726 -7 0 1723 1725 1724 1725 1724 1725 1724 1725 1724 1725 1724 1725 1724 1725 1724 1725 1724 1725 1817 -30 1009 1011 -9 0 1723 1817 1009 -12 1018 1019 -3 0 1008 1009 -3 1017 -32 1009 1020 -3 1021 1022 -22 1009 1011 -2 0 -3 44 -2 0 1008 -44 1009 -4 1018 1019 -9 0 1008 1009 1011 -16 0 1008 1015 -3 0 1016 -7 1018 -24 1009 1023 -3 1024 1025 -22 1009 1011 -2 0 -3 44 -2 0 1008 1010 -39 1009 1017 -2 1018 1019 -13 0 1723 1817 1009 1011 -16 0 1016 1019 -11 0 1008 -23 1009 1026 1027 1030 1024 1025 -22 1009 1011 -2 0 1723 1724 1726 -2 0 1016 1017 -38 1018 1019 -17 0 1008 -2 1009 1011 -6 0 -5 44 -11 0 -5 44 -2 0 1008 -13 1009 1010 -11 1009 1023 1024 1025 -22 1009 1019 -2 0 1016 1018 1019 -58 0 1723 1724 1817 -2 1009 1011 -3 0 1723 1724 1725 1724 1725 1724 1725 1724 1725 1724 1725 1724 1725 1724 1725 1724 1725 1726 0 -5 44 0 1723 1817 -25 1009 1026 1027 1028 -21 1009 1011 -64 0 1008 -4 1009 1011 -3 0 1008 -16 1009 1820 1724 1725 1724 1725 1724 1725 1724 1817 -50 1009 1011 -64 0 1016 -4 1009 1011 -3 0 1016 -16 1018 -10 1009 -24 1018 -24 1009 1010 1820 1726 -5 0 1723 1726 -49 0 1723 1726 -6 0 1008 -3 1009 1011 -20 0 1008 -8 1009 1011 -24 0 1008 -25 1009 1820 1726 -4 0 1016 1019 -12 0 1723 1725 1726 -3 0 47 -3 83 47 -2 0 47 83 102 83 47 -19 0 1016 1019 -6 0 1008 -3 1009 1011 -20 0 1016 -8 1018 1019 -24 0 1008 -26 1009 1011 -18 0 1008 1009 1011 -40 0 -2 44 1008 -2 1009 1010 1011 -4 0 -5 44 -45 0 1008 -26 1009 1820 1724 1725 1724 1726 -14 0 1008 1009 1820 1726 -17 0 1723 1726 -20 0 1723 1724 1008 -3 1009 1820 1724 1725 1724 1725 1724 1725 1724 1725 1724 1725 1724 1725 1726 -24 0 1723 1724 -15 0 1008 -4 1009 1010 -19 1009 1020 1021 1022 -3 1009 1820 1724 1725 1724 1725 1724 1725 1724 1726 -6 0 1016 -2 1009 1820 1724 1725 1724 1725 1724 1725 1724 1725 1724 1725 1724 1725 1724 1725 1724 1725 1724 1817 1011 -20 0 1008 -18 1009 1820 1726 -23 0 1008 1820 1724 1725 1724 1725 1726 -10 0 1008 -24 1009 1023 1024 1025 -11 1009 1820 1726 -6 0 1016 -20 1009 1015 -20 0 1016 1018 -7 1009 1010 -10 1009 1820 1726 -22 0 1008 -5 1009 1820 -10 0 1008 -24 1009 1026 1027 1028 -12 1009 1820 -7 0 1012 -3 1009 -11 1018 -5 1009 1019 -22 0 1008 -18 1009 1820 1726 -16 0 1723 1724 1725 1724 1725 1817 -3 1009 -2 1017 1019 -10 0 1008 -36 1009 1010 -2 1009 1820 -7 0 1016 -2 1017 1019 -11 0 1016 1017 -2 1018 1019 -5 0 1723 1724 1725 1724 1725 1724 1725 1724 1725 1726 -8 0 1008 -12 1009 1020 1021 1022 -4 1009 1011 -16 0 1008 -7 1009 1011 -13 0 1008 -39 1009 1820 -32 0 1008 -8 1009 1011 -8 0 1008 -12 1009 1026 1030 1031 1022 -3 1009 1019 -15 0 1723 1817 -6 1009 1017 1019 -6 0 -5 83 -2 0 1008 -39 1009 1820 -30 0 -2 44 1008 -8 1009 1011 -8 0 1008 -13 1009 1023 1024 1025 -2 1009 1011 -16 0 1817 -2 1009 1010 -3 1009 1011 -15 0 1008 -39 1009 1820 1724 1725 1726 -25 0 -2 44 57 58 1008 -8 1009 1011 -8 0 1008 -13 1009 1026 1027 1028 -2 1009 1011 1724 1725 1724 1725 1724 1725 1724 1725 1724 1725 1724 1725 1724 1725 1724 1725 1817 -6 1009 1011 -15 0 1008 -42 1009 1820 1724 1725 1726 -10 0 2948 -11 0 57 58 59 60 1016 -8 1009 1820 1724 1725 1724 1725 1724 1725 1724 1725 1817 -42 1009 1011 -6 0 1723 1724 1725 1724 1725 1724 1725 1724 1725 1008 -45 1009 1011 -16 0 1723 1724 1725 1724 1725 1726 59 60 2865 2866 55 1012 1009 1020 1021 1022 -33 1009 -9 1018 -4 1009 -3 1018 -4 1009 -2 1018 1019 -6 0 1817 -54 1009 1011 -16 0 1008 -4 1009 1011 59 60 2869 2870 56 1817 1009 1023 1024 1025 -32 1009 1019 -9 0 1016 1017 1018 1019 -3 0 1016 1017 1018 1019 -9 0 1008 -54 1009 1820 1724 1725 1724 1725 1724 1725 1724 1725 1724 1725 1724 1725 1724 1725 1724 1725 1817 1533 1534 1535 1010 1820 59 60 1817 -3 1009 1020 1032 1024 1025 -29 1009 1010 1009 1019 -30 0 1008 -72 1009 1536 1537 1538 -6 1009 1020 1021 1032 1024 1029 1028 -30 1009 1019 -30 0 1723 1817 -81 1009 1023 -2 1024 1029 1028 -30 1009 1011 -31 0 1817 -82 1009 1026 -2 1027 1028 -31 1009 1011 -29 0 1723 1724 1817 -64 1009 1010 -44 1009 -8 1018 1019 -7 0 -4 44 -14 0 1819 -3 0 1817 -95 1009 1010 -14 1009 1011 -15 0 1723 1724 1725 1724 1725 1726 -4 0 1723 1724 1726 -4 0 1723 1724 1818 1724 1725 1724 1008 -110 1009 1011 -15 0 1008 -4 1009 1011 -4 0 1817 1009 1011 -4 0 1817 -115 1009 1010 1011 -15 0 1008 1020 1021 1022 1009 1820 1724 1725 1724 1725 1817 1009 1820 1724 1725 1724 1725 1817 1010 -2 1009 1020 1022 -105 1009 1020 1022 -4 1009 1011 -4 0 1723 1724 1725 1724 1725 1724 1725 1724 1725 1724 1725 1817 1023 1024 1025 -17 1009 1026 1028 -105 1009 1026 1028 -4 1009 1011 -4 0 1008 -11 1009 1026 1027 1028 -38 1009 -35 1017 -4 1009 -21 1017 -4 1009 -21 1017 -4 1009 -3 1017 1019 -4 0 1016 -40 1017 -12 1009 -35 0 1012 -2 1009 1011 -21 0 1012 -2 1009 1011 -21 0 1012 -2 1009 1011 -49 0 1008 -11 1009 -35 0 1012 -2 1009 1011 -21 0 1012 -2 1009 1011 -21 0 1012 -2 1009 1011 -49 0 1008 1009 1010 -9 1009 -35 0 1012 -2 1009 1011 -21 0 1012 -2 1009 1011 -21 0 1012 -2 1009 1011 -49 0 1008 -11 1009 -35 0 1012 -2 1009 1011 -21 0 1012 -2 1009 1011 -21 0 1012 -2 1009 1011 -5 0 1723 1726 -42 0 1008 -11 1009 -35 0 1012 -2 1009 1011 -21 0 1012 -2 1009 1011 -21 0 1012 -2 1009 1011 -5 0 1016 1019 -42 0 1008 -11 1009 -35 0 1012 -2 1009 1011 -21 0 1012 -2 1009 1011 -21 0 1012 -2 1009 1011 -49 0 1008 -11 1009 -35 0 1012 -2 1009 1011 -21 0 1012 -2 1009 1011 -21 0 1012 -2 1009 1011 -49 0 1008 -11 1009 -35 0 1012 -2 1009 1011 -21 0 1012 -2 1009 1011 -21 0 1012 -2 1009 1011 -8 0 1723 1726 -39 0 1016 -2 1018 -9 1009 -35 0 1012 -2 1009 1011 -21 0 1012 -2 1009 1011 -21 0 1012 -2 1009 1011 -8 0 1016 1019 -42 0 1016 1018 -7 1009 -35 0 1012 -2 1009 1011 -21 0 1012 -2 1009 1011 -21 0 1012 1009 1010 1011 -54 0 1008 -6 1009 -35 0 1012 -2 1009 1011 -21 0 1012 -2 1009 1011 -21 0 1012 -2 1009 1011 -54 0 1008 -6 1009 -35 0 1012 -2 1009 1011 -21 0 1012 -2 1009 1011 -21 0 1012 -2 1009 1011 -45 0 133 -8 0 1008 1009 1010 -4 1009 -35 0 1012 -2 1009 1011 -21 0 1012 -2 1009 1011 -21 0 1012 -2 1009 1011 -10 0 1723 1726 -33 0 133 -8 0 1008 -6 1009 -35 0 1012 -2 1009 1011 -21 0 1012 -2 1009 1011 -21 0 1012 -2 1009 1011 -10 0 1016 1019 -33 0 133 -8 0 1016 1017 -5 1018 -35 0 1012 -2 1009 1011 -21 0 1012 -2 1009 1011 -21 0 1012 -2 1009 1011 -45 0 133 -14 0 132 -35 0 1012 -2 1009 1011 -21 0 1012 -2 1009 1011 -21 0 1012 -2 1009 1011 -5 0 -3 44 -37 0 133 -14 0 132 -35 0 1012 -2 1009 1011 -21 0 1012 -2 1009 1011 -21 0 1012 -2 1009 1011 -5 0 -3 44 -37 0 133 -14 0 132 -35 0 1012 -2 1009 1011 -21 0 1012 -2 1009 1011 -21 0 1012 -2 1009 1011 -5 0 -3 44 -37 0 133 -14 0 132 -35 0 1012 -2 1009 1011 -21 0 1012 -2 1009 1011 -21 0 1012 -2 1009 1011 -45 0 133 -10 0 1723 1724 1725 1724 132 -35 0 1012 -2 1009 1011 -21 0 1012 -2 1009 1011 -21 0 1012 -2 1009 1011 -4 0 27 -50 28 29 1817 -4 1009 -35 0 1012 -2 1009 1011 -21 0 1012 -2 1009 1011 -21 0 1012 -2 1009 1011 -5 0 323 324 -6 0 1348 -13 0 1348 -8 0 323 324 -3 0 1348 -13 0 1008 -5 1009 -35 0 1012 -2 1009 1011 -21 0 1012 -2 1009 1011 -21 0 1012 -2 1009 1011 -5 0 325 326 -6 0 79 -13 0 79 -8 0 325 326 -3 0 79 -13 0 1008 -5 1009 -35 0 1012 -2 1009 1011 -21 0 1012 -2 1009 1011 -21 0 1012 -2 1009 1011 -5 0 327 328 -6 0 79 -13 0 79 -8 0 327 328 -3 0 79 -13 0 1008 -3 1009 1010 1009 -35 0 1012 -2 1009 1011 -21 0 1012 -2 1009 1011 -21 0 1012 -2 1009 1011 -5 0 329 330 -6 0 79 -13 0 79 -8 0 329 330 -3 0 79 -13 0 1008 -5 1009 -35 0 1012 -2 1009 1011 -21 0 1012 -2 1009 1011 -21 0 1012 -2 1009 1011 -13 0 79 -13 0 79 -13 0 79 -13 0 1008 -5 1009 -35 0 1012 -2 1009 1011 -21 0 1012 -2 1009 1011 -21 0 1012 -2 1009 1011 -13 0 79 -13 0 79 -13 0 79 -13 0 1008 -5 1009)
    )
    (tilemap
      (solid #t)
      (z-pos -1)
      (width 150)
      (height 110)
      (tiles -80 0 -4 1282 -146 0 -4 1282 -146 0 -4 1282 -146 0 -4 1282 -146 0 -4 1282 -146 0 -4 1282 -146 0 -4 1282 -146 0 -4 1282 -147 0 -3 1282 -9 0 1227 -137 0 -3 1282 -144 0 1282 -3 0 -2 1282 -144 0 1282 -149 0 1282 -449 0 313 314 -148 0 315 316 -4318 0 317 318 -18 0 317 318 -128 0 319 320 -18 0 319 320 -470 0 317 318 -102 0 1972 1976 -44 0 319 320 -75 0 1980 1984 -15 0 1972 1976 1980 1984 -5 0 1972 -2 1977 -121 0 -2 1981 1984 -7 0 1972 1976 1980 1976 1980 1976 1980 1977 1981 1977 1981 1980 1976 1980 1976 1980 1981 1977 1978 -1485 0 317 318 -17 0 317 318 -129 0 319 320 -17 0 319 320 -220 0 317 318 -148 0 319 320 -429 0 1980 1984 -120 0 1972 1976 1980 1984 -2 0 1972 1976 1980 1984 -18 0 1981 1985 -120 0 1973 1977 -2 1981 1976 1980 -2 1977 1981 1985 -1385 0 1972 1984 -2 0 1972 1984 -123 0 317 318 -12 0 1972 1976 1980 1976 1980 1984 0 1973 1981 1976 1980 1977 1985 -123 0 319 320 -3198 0 1725 -1050 0)
    )
    (tilemap
      (solid #t)
      (z-pos 100)
      (name "Foreground")
      (width 150)
      (height 110)
      (tiles -6111 0 1358 -2 1359 1360 -145 0 470 465 -2 1362 1363 -146 0 1364 1365 459 461 1359 1360 -146 0 1361 -2 1362 1363 -146 0 1364 1365 468 1366 -135 0 1009 -2 1017 1009 -9 0 463 -149 0 466 -544 0 1358 -2 1359 1360 -146 0 1361 -2 1362 1363 -146 0 1364 -2 1365 1366 -921 0 1358 1359 1360 -147 0 1361 1362 1363 -147 0 1364 468 1366 -148 0 463 -149 0 466 -833 0 460 -148 0 1358 464 1359 1360 -146 0 1361 -2 1362 1363 -145 0 1358 462 -2 1362 1363 -145 0 1361 -3 1362 461 1360 -40 0 1723 1724 1725 -101 0 1361 -4 1362 1363 -3 0 460 -34 0 1724 1725 -26 0 1358 -3 1359 1360 -44 0 469 -28 0 1361 -4 1362 461 -3 1359 464 1359 1360 -60 0 1361 -3 1362 467 472 -72 0 1364 -2 1365 459 -7 1362 1363 -59 0 1358 462 458 -2 1365 1366 -41 0 1358 1360 -33 0 1361 -7 1362 467 471 472 -57 0 1361 1362 1363 -43 0 1358 462 1363 -33 0 1364 -7 1365 1366 -59 0 1364 1365 1366 -43 0 1361 1362 1363 -145 0 1358 1359 462 1362 1363 -144 0 470 465 -2 1362 458 1366 -145 0 1364 -2 1365 1366 -253 0 1996 1997 -503 0 1358 1359 1360 -147 0 1361 1362 461 1360 -146 0 1364 1365 459 461 1360 -147 0 1361 1362 1363 -147 0 1361 1362 461 -147 0 1364 459 1362 -148 0 1364 1365 -885 0 130 -11 0 -3 1009 -135 0 129 -11 0 1008 -2 1009 -135 0 129 -11 0 1008 -2 1009 -135 0 129 -11 0 1008 -2 1009 -135 0 129 -11 0 1008 -2 1009 -135 0 129 -11 0 1008 -2 1009 -144 0 1723 -2 0 -3 1009 -300 0 2019 2140 2141 2142 2019 2140 2141 2142 2019 2140 2141 2142 2019 2140 2141 2142 2019 2140 2141 2142 2019 2140 2141 2142 2019 2140 2141 2142 2019 2140 2141 2142 2019 2140 2141 2142 2019 2140 2141 2142 2019 2140 2141 2142 2019 2140 2141 2142 2019 2140 2141 2142 2019 2140 2141 2142 2019 2140 2141 2142 2019 2140 2141 2142 2019 2140 2141 2142 2019 2140 2141 2142 2019 2140 2141 2142 2019 2140 2141 2142 2019 2140 2141 2142 2019 2140 2141 2142 2019 2140 2141 2142 2019 2140 2141 2142 2019 2140 2141 2142 2019 2140 2141 2142 2019 2140 2141 2142 2019 2140 2141 2142 2019 2140 2141 2142 2019 2140 2141 2142 2019 2140 2141 2142 2019 2140 2141 2142 2019 2140 2141 2142 2019 2140 2141 2142 2019 2140 2141 2142 2019 2140 2141 2142 2019 2140 2141 2142 2019 2140 -450 2020)
    )
    (tilemap
      (solid #f)
      (z-pos 110)
      (name "secret1")
      (width 150)
      (height 110)
      (tiles -7906 0 -5 1009 -145 0 -13 1009 -137 0 -13 1009 -137 0 1008 -12 1009 -137 0 1008 1010 -11 1009 -137 0 -13 1009 -141 0 -8 1009 -7682 0)
    )
    (viciousivy
      (z-pos 50)
      (direction "left")
      (x 958.75)
      (y 412.5103)
      (glinting #f)
    )
    (viciousivy
      (z-pos 50)
      (direction "left")
      (x 1725.63)
      (y 504.2551)
      (glinting #f)
    )
    (viciousivy
      (z-pos 50)
      (direction "left")
      (x 1710.255)
      (y 2011.032)
      (glinting #f)
    )
    (viciousivy
      (z-pos 50)
      (direction "left")
      (x 1820.88)
      (y 2009.163)
      (glinting #f)
    )
    (walkingleaf
      (z-pos 50)
      (direction "left")
      (x 1276)
      (y 413.7587)
      (glinting #f)
    )
    (walkingleaf
      (z-pos 50)
      (direction "left")
      (x 1142.255)
      (y 413.1348)
      (glinting #f)
    )
    (walkingleaf
      (z-pos 50)
      (direction "left")
      (x 2598.13)
      (y 927.014)
      (glinting #f)
    )
    (walkingleaf
      (z-pos 50)
      (direction "left")
      (x 4315)
      (y 2234.385)
      (glinting #f)
    )
    (walkingleaf
      (z-pos 50)
      (direction "left")
      (x 1435.88)
      (y 2332.28)
      (glinting #f)
    )
    (walkingleaf
      (z-pos 50)
      (direction "left")
      (x 3555)
      (y 2486.89)
      (glinting #f)
    )
  )
)
