(supertux-level
  (version 3)
  (name (_ "Kneep-deep in the depth"))
  (author "Christoph Sommer")
  (license "GPL 2+ / CC-by-sa 3.0")
  (allow-item-pocket "inherit")
  (icon "")
  (icon-locked "")
  (statistics
    (enable-coins #t)
    (enable-secrets #t)
  )
  (sector
    (name "main")
    (ambient-light
      (color 1 1 1)
    )
    (background
      (scroll-offset-y -840)
      (color 1 1 1)
      (speed 0.5)
      (image-top "images/background/BlueRock_Forest/blue-top.jpg")
      (image "images/background/BlueRock_Forest/blue-middle.jpg")
      (image-bottom "images/background/BlueRock_Forest/blue-bottom.jpg")
    )
    (camera
      (name "Camera")
      (mode "normal")
    )
    (firefly
      (z-pos 0)
      (x 2208)
      (y 2640)
    )
    (firefly
      (z-pos 0)
      (x 2064)
      (y 592)
    )
    (flame
      (z-pos 150)
      (x 2192)
      (y 1232)
    )
    (flame
      (z-pos 150)
      (x 2448)
      (y 1104)
    )
    (igel
      (z-pos 50)
      (x 2672)
      (y 1584)
      (glinting #f)
    )
    (jumpy
      (z-pos 50)
      (x 2640)
      (y 1792)
      (glinting #f)
    )
    (jumpy
      (type "wooden")
      (z-pos 50)
      (x 2432)
      (y 1312)
      (glinting #f)
    )
    (mrtree
      (z-pos 50)
      (x 1024)
      (y 896)
      (glinting #f)
    )
    (music
      (file "music/forest.music")
    )
    (path
      (name "gen1772929733104989800813136")
      (path
        (adapt_speed #f)
        (node
          (x 2272)
          (y 1376)
          (time 25)
        )
        (node
          (x 2272)
          (y 1376)
          (time 7)
        )
        (node
          (x 2272)
          (y 928)
          (time 2)
        )
        (node
          (x 2272)
          (y 864)
        )
      )
    )
    (path
      (name "gen1772929733104989822238272")
      (path
        (adapt_speed #f)
        (node
          (x 2528)
          (y 1376)
          (time 25)
        )
        (node
          (x 2528)
          (y 1376)
          (time 7)
        )
        (node
          (x 2528)
          (y 928)
          (time 2)
        )
        (node
          (x 2528)
          (y 864)
        )
      )
    )
    (path
      (name "gen1772929733104989798655008")
      (path
        (adapt_speed #f)
        (node
          (x 1856)
          (y 2784)
          (time 25)
        )
        (node
          (x 1996)
          (y 1376)
          (time 7)
        )
        (node
          (x 2041)
          (y 928)
          (time 2)
        )
        (node
          (x 2051)
          (y 864)
        )
      )
    )
    (platform
      (z-pos 50)
      (handle
        (scale_x 0)
        (scale_y 0)
        (offset_x 0)
        (offset_y 0)
      )
      (running #f)
      (name "plat1")
      (path-ref "gen1772929733104989800813136")
      (sprite "images/objects/platforms/big.sprite")
    )
    (platform
      (z-pos 50)
      (handle
        (scale_x 0)
        (scale_y 0)
        (offset_x 0)
        (offset_y 0)
      )
      (running #f)
      (name "plat2")
      (path-ref "gen1772929733104989822238272")
      (sprite "images/objects/platforms/big.sprite")
    )
    (powerup
      (z-pos 50)
      (script "add_key(\"fire\");
Tux.deactivate();
wait(0.5);
Tux.do_cheer();
end_level();
")
      (sprite "images/objects/keys/key_fire.sprite")
      (x 3904)
      (y 736)
    )
    (pushbutton
      (z-pos -99)
      (script "LavaRising.goto_node(3);
plat1.goto_node(3);
plat2.goto_node(3);")
      (x 2145)
      (y 2674)
    )
    (secretarea
      (width 124)
      (height 140)
      (x 2016)
      (y 96)
    )
    (snail
      (z-pos 50)
      (x 2464)
      (y 2288)
      (glinting #f)
    )
    (snail
      (z-pos 50)
      (x 2496)
      (y 2032)
      (glinting #f)
    )
    (spawnpoint
      (name "main")
      (x 96)
      (y 704)
    )
    (tilemap
      (solid #f)
      (z-pos -101)
      (name "BGTiles")
      (width 160)
      (height 128)
      (tiles -53 0 -50 1478 -110 0 -50 1478 -110 0 -50 1478 -110 0 -50 1478 -110 0 -50 1478 -110 0 -50 1478 -110 0 -50 1478 -110 0 -50 1478 -110 0 -50 1478 -110 0 -50 1478 -110 0 -50 1478 -76 0 1073 1074 1075 -31 0 -50 1478 -76 0 1081 1082 1083 1084 -30 0 -50 1478 -67 0 1168 1169 1170 -5 0 1088 1089 1090 1091 1092 1093 -18 0 1073 1074 1075 -8 0 -50 1478 -67 0 1174 1175 1176 1177 -3 0 1095 1096 1097 1098 1099 1100 1101 -18 0 1081 1082 1083 1084 -7 0 -50 1478 -66 0 1179 1180 1181 1182 1183 -3 0 1103 1104 1105 1106 1107 1108 1109 1110 -16 0 1088 1089 1090 1091 1092 1093 -6 0 -50 1478 -66 0 1185 1186 1187 1188 1189 1190 -2 0 1111 1112 1113 1114 1115 1116 1117 1118 -15 0 1095 1096 1097 1098 1099 1100 1101 -6 0 -50 1478 -66 0 1191 1192 1193 1194 1195 1196 -2 0 1119 1120 1121 1122 1123 1124 1125 1126 -15 0 1103 1104 1105 1106 1107 1108 1109 1110 -5 0 -50 1478 -66 0 1197 1198 1199 1200 1201 1202 -2 0 1127 1128 1129 1130 1131 1132 1133 1134 -15 0 1111 1112 1113 1114 1115 1116 1117 1118 -5 0 -50 1478 -66 0 1203 1204 1205 1206 1207 1208 -4 0 1137 1138 1139 1140 1141 -16 0 1119 1120 1121 1122 1123 1124 1125 1126 -5 0 -50 1478 -66 0 1209 1210 1211 1212 1213 1214 -4 0 1145 1146 1147 1148 -17 0 1127 1128 1129 1130 1131 1132 1133 1134 -5 0 -50 1478 -68 0 1217 1218 -6 0 1137 1138 1139 1140 1141 -18 0 1137 1138 1139 1140 1141 -6 0 -50 1478 -68 0 1223 1224 -6 0 1145 1146 1147 1148 -19 0 1145 1146 1147 1148 -7 0 -50 1478 -67 0 1228 1229 1230 -6 0 1153 1154 1155 1156 -19 0 1153 1154 1155 1156 -7 0 -50 1478 -67 0 1234 1235 1236 -6 0 1161 1162 1163 1164 0 -2 1002 -13 1351 -3 0 1161 1162 1163 1164 -7 0 -50 1478 -13 0 405 -69 0 -13 1352 -14 0 -50 1478 -83 0 -13 1353 -14 0 -51 1478 -82 0 -13 1353 -14 0 -51 1478 -82 0 -13 1353 -14 0 -51 1478 -82 0 -13 1353 -14 0 -51 1478 -82 0 -13 1353 -13 0 -52 1478 -82 0 -13 1353 -13 0 -52 1478 -108 0 -52 1478 -108 0 -52 1478 -108 0 -52 1478 -108 0 -52 1478 -108 0 -52 1478 -108 0 -52 1478 -108 0 -52 1478 -108 0 -52 1478 -108 0 -52 1478 -108 0 -52 1478 -108 0 -52 1478 -108 0 -52 1478 -108 0 -52 1478 -108 0 -52 1478 -108 0 -52 1478 -108 0 -52 1478 -108 0 -52 1478 -108 0 -52 1478 -108 0 -52 1478 -108 0 -52 1478 -108 0 -52 1478 -108 0 -52 1478 -108 0 -52 1478 -108 0 -52 1478 -108 0 -52 1478 -108 0 -52 1478 -108 0 -52 1478 -108 0 -52 1478 -108 0 -52 1478 -108 0 -52 1478 -108 0 -52 1478 -108 0 -52 1478 -108 0 -52 1478 -108 0 -52 1478 -108 0 -52 1478 -108 0 -52 1478 -108 0 -52 1478 -108 0 -52 1478 -108 0 -52 1478 -108 0 -52 1478 -108 0 -52 1478 -108 0 -52 1478 -108 0 -52 1478 -108 0 -52 1478 -108 0 -52 1478 -108 0 -52 1478 -108 0 -52 1478 -108 0 -52 1478 -108 0 -52 1478 -108 0 -52 1478 -108 0 -52 1478 -108 0 -52 1478 -108 0 -52 1478 -108 0 -52 1478 -108 0 -52 1478 -108 0 -52 1478 -108 0 -52 1478 -108 0 -52 1478 -108 0 -52 1478 -108 0 -52 1478 -108 0 -52 1478 -108 0 -52 1478 -108 0 -52 1478 -108 0 -52 1478 -108 0 -52 1478 -108 0 -52 1478 -108 0 -52 1478 -108 0 -52 1478 -108 0 -52 1478 -108 0 -52 1478 -108 0 -52 1478 -108 0 -52 1478 -108 0 -52 1478 -108 0 -52 1478 -108 0 -52 1478 -108 0 -52 1478 -108 0 -52 1478 -108 0 -52 1478 -108 0 -52 1478 -108 0 -52 1478 -108 0 -52 1478 -108 0 -52 1478 -108 0 -52 1478 -108 0 -52 1478 -108 0 -52 1478 -108 0 -52 1478 -108 0 -52 1478 -108 0 -52 1478 -108 0 -52 1478 -108 0 -52 1478 -108 0 -52 1478 -108 0 -52 1478 -108 0 -52 1478 -108 0 -52 1478 -108 0 -52 1478 -108 0 -52 1478 -56 0)
    )
    (tilemap
      (solid #f)
      (z-pos -100)
      (name "BGArt")
      (width 160)
      (height 128)
      (tiles -383 0 79 -2 0 79 -9 0 79 -2 0 79 -9 0 79 -2 0 79 -130 0 79 -2 0 79 -9 0 79 -2 0 79 -9 0 79 -2 0 79 -130 0 79 -2 0 79 -9 0 79 -2 0 79 -9 0 79 -2 0 79 -130 0 79 -2 0 79 -9 0 79 -2 0 79 -9 0 79 -2 0 79 -130 0 79 -2 0 79 -9 0 79 -2 0 79 -9 0 79 -2 0 79 -130 0 1347 -2 0 1347 -12 0 79 -9 0 79 -2 0 79 -25 0 85 86 87 88 -20 0 85 86 87 88 -41 0 85 86 87 88 -18 0 85 86 87 88 -36 0 79 -2 0 79 -25 0 89 90 91 92 -20 0 89 90 91 92 -17 0 85 86 87 88 -20 0 89 90 91 92 -18 0 89 90 91 92 -36 0 79 -2 0 79 -12 0 85 86 87 88 -19 0 85 86 87 88 -22 0 85 86 87 88 -5 0 89 90 91 92 -7 0 85 86 87 88 -22 0 85 86 87 88 -45 0 79 -2 0 79 -12 0 89 90 91 92 -19 0 89 90 91 92 -22 0 89 90 91 92 -16 0 89 90 91 92 -22 0 89 90 91 92 -45 0 1347 -2 0 1347 -336 0 1073 1074 1075 -157 0 1081 1082 1083 1084 -155 0 1088 1089 1090 1091 1092 1093 -153 0 1095 1096 1097 1098 1099 1100 1101 -153 0 1103 1104 1105 1106 1107 1108 1109 1110 -152 0 1111 1112 1113 1114 1115 1116 1117 1118 -66 0 1752 1753 -84 0 1119 1120 1121 1122 1123 1124 1125 1126 -152 0 1127 1128 1129 1130 1131 1132 1133 1134 -57 0 402 403 404 405 -5 0 1758 1759 -28 0 402 403 404 405 -46 0 402 403 404 405 -4 0 1137 1138 1139 1140 1141 -58 0 406 407 408 409 402 403 404 405 -24 0 402 403 404 405 -3 0 406 407 408 409 -46 0 406 407 408 409 402 403 404 405 1145 1146 1147 1148 -59 0 410 411 420 421 406 407 408 409 402 403 404 405 -16 0 402 403 404 405 406 407 408 409 -3 0 418 419 412 413 -46 0 410 411 420 421 406 407 408 409 1153 1154 1155 1156 -58 0 360 414 415 424 425 410 411 412 413 406 407 408 409 -16 0 406 407 408 409 410 411 412 413 402 403 404 422 423 416 417 -46 0 414 415 424 425 410 411 412 413 1161 1162 1163 1164 402 403 404 -60 0 414 415 416 417 410 411 412 413 -16 0 410 411 412 413 414 415 416 417 406 407 408 409 -49 0 418 419 420 421 -75 0 414 415 416 417 -16 0 414 415 416 417 -4 0 410 411 412 413 -144 0 402 403 404 405 -8 0 414 415 416 417 -144 0 406 407 408 409 -156 0 410 411 412 413 -156 0 414 415 416 417 -995 0 1355 -2 0 1355 -156 0 1356 -2 0 1356 -156 0 1356 -2 0 1356 -156 0 1356 -2 0 1356 -148 0 1355 -2 0 1355 -4 0 1356 -2 0 1356 -148 0 1356 -2 0 1356 -4 0 1356 -2 0 1356 -148 0 1411 -2 0 1411 -4 0 1411 -2 0 1411 -1601 0 1355 -2 0 1355 -156 0 1356 -2 0 1356 -156 0 1356 -2 0 1356 -156 0 1356 -2 0 1356 -156 0 1356 -2 0 1356 -156 0 1411 -2 0 1411 -316 0 1355 -2 0 1355 -156 0 1356 -2 0 1356 -156 0 1356 -2 0 1356 -156 0 1356 -2 0 1356 -156 0 1356 -2 0 1356 -156 0 1411 -2 0 1411 -470 0 1355 -4 0 1355 -154 0 1356 -4 0 1356 -154 0 1356 -4 0 1356 -154 0 1356 -4 0 1356 -154 0 1356 -4 0 1356 -154 0 1411 -4 0 1411 -1905 0 1719 2001 -159 0 79 -159 0 79 -159 0 79 -159 0 79 -159 0 79 -159 0 79 -159 0 79 -159 0 79 -159 0 79 -159 0 79 -159 0 79 -159 0 79 -159 0 79 -159 0 79 -159 0 79 -159 0 79 -159 0 79 -159 0 79 -159 0 79 -159 0 79 -159 0 79 -159 0 79 -159 0 79 -159 0 79 -159 0 79 -159 0 79 -159 0 79 -159 0 79 -159 0 79 -159 0 79 -159 0 79 -159 0 79 -159 0 79 -159 0 79 -159 0 79 -159 0 79 -159 0 79 -159 0 79 -159 0 79 -159 0 79 -159 0 79 -159 0 79 -159 0 79 -93 0)
    )
    (tilemap
      (solid #t)
      (z-pos 0)
      (name "Interactive")
      (width 160)
      (height 128)
      (tiles -50 0 1408 1412 1415 -49 1368 1379 1416 1412 1388 -106 0 1404 -4 1372 1382 -41 1372 1382 -3 1372 1373 -108 0 1404 1372 1406 -46 1376 -2 1372 1373 -108 0 1404 1372 1373 -8 0 -3 83 128 -34 0 1404 1372 1373 -108 0 1404 1372 1373 -46 0 1404 1372 1373 -108 0 1404 1372 1373 -46 0 1404 1372 1373 -108 0 1404 1372 1373 -46 0 1404 1372 1373 -108 0 1404 1372 1373 -7 0 27 -4 28 29 -21 0 -4 83 -8 0 1404 1372 1373 -108 0 1404 1372 1373 -46 0 1404 1372 1373 -108 0 1404 1372 1373 -46 0 1404 1372 1373 -108 0 1404 1372 1373 -46 0 1404 1372 1373 -108 0 1404 1372 1373 0 112 -31 0 27 -4 28 29 -7 0 1404 1372 1373 -108 0 1404 1372 1373 -46 0 1404 1372 1373 -108 0 1404 1372 1373 -46 0 1404 1372 1373 -108 0 1404 1372 1373 -46 0 1404 1372 1373 -108 0 1404 1372 1373 -46 0 1404 1372 1373 -108 0 1404 1372 1383 1416 1388 -41 0 1408 1412 1415 1371 1372 1373 -108 0 1404 1372 1406 1410 -44 0 1397 1394 1372 1373 -78 0 -2 44 -28 0 1404 1372 1373 -46 0 1404 1372 1373 -108 0 1404 1372 1373 -46 0 1404 1372 1373 -77 0 1754 1755 1756 1757 -27 0 1374 1376 1377 -46 0 1374 1376 1377 -119 0 -2 83 102 83 -22 0 -3 83 102 -251 0 317 318 -37 0 -4 44 -22 0 -4 44 -67 0 -24 1002 319 320 1003 -11 0 1000 1001 -13 1002 -50 0 1001 -56 1002 -26 1006 1007 -11 0 1004 1005 -13 1006 -12 1368 1379 1416 1412 1388 -18 0 1408 1412 1415 -13 1368 1005 -56 1006 -23 1009 1020 1021 1022 1035 1003 -10 0 1012 -11 1009 1020 1022 1009 -12 1372 1406 1410 -22 0 1397 1394 -12 1372 -80 1009 1023 1024 1025 1041 1007 -10 0 1012 -11 1009 1026 1028 1009 -10 1372 1382 1372 1373 -24 0 1404 -4 1372 1382 -7 1372 -63 1009 1010 -16 1009 1026 1027 1028 1009 1011 -10 0 1008 1009 1010 -12 1009 -12 1372 1373 -24 0 1404 -12 1372 -84 1009 1035 1003 -9 0 1008 -14 1009 -12 1372 1373 0 -3 44 -20 0 1404 -12 1372 -84 1009 1041 1037 1001 -8 1002 1034 -14 1009 -12 1372 1373 -24 0 1404 -12 1372 -83 1009 1013 1009 1041 1005 -8 1006 1040 -14 1009 -12 1372 1383 -2 1368 1390 1416 1388 -19 0 1404 -12 1372 -71 1009 1010 -38 1009 -12 1372 1406 -3 1376 1407 -20 0 1404 -12 1372 -110 1009 -9 1372 1395 -2 1372 1373 -10 0 -2 44 -12 0 1404 -12 1372 -110 1009 -9 1372 1395 -2 1372 1373 -24 0 1404 -12 1372 -110 1009 -12 1372 1373 -9 0 1408 1415 1416 1388 -11 0 1404 -12 1372 -110 1009 -12 1372 1373 -10 0 1374 1377 -12 0 1404 -12 1372 -110 1009 -12 1372 1373 -2 0 -2 44 -20 0 1404 -12 1372 -110 1009 -7 1372 1382 -4 1372 1373 -24 0 1404 -12 1372 -110 1009 -12 1372 1373 0 1408 1415 1416 1388 -19 0 1404 -12 1372 -110 1009 -12 1372 1373 -2 0 1374 1377 -20 0 1404 -5 1372 1382 -6 1372 -110 1009 -12 1372 1373 -24 0 1404 -12 1372 -110 1009 -12 1372 1373 -24 0 1404 -12 1372 -110 1009 -12 1372 1383 1368 -3 1379 1380 -4 0 1400 1390 1368 1369 -4 0 1367 1416 1388 -4 0 1404 -12 1372 -110 1009 -12 1372 1406 1387 -3 1376 1414 -4 1412 1413 -2 1376 1414 -4 1412 1413 1407 -5 0 1404 -12 1372 -110 1009 -12 1372 1373 -24 0 1404 -12 1372 -110 1009 -12 1372 1373 -24 0 1404 -12 1372 -110 1009 -12 1372 1373 -21 0 1408 1415 1368 1371 -12 1372 -110 1009 -12 1372 1373 -22 0 1397 1376 1394 -12 1372 -110 1009 -8 1372 1382 -3 1372 1373 -13 0 -6 44 -5 0 1404 -12 1372 -110 1009 -12 1372 1373 -24 0 1404 -12 1372 -110 1009 -12 1372 1373 -12 0 1408 -6 1412 1388 -4 0 1404 -12 1372 -110 1009 -12 1372 1373 -24 0 1404 -12 1372 -110 1009 -12 1372 1373 -24 0 1404 -12 1372 -110 1009 -12 1372 1373 -24 0 1404 -12 1372 -110 1009 -12 1372 1373 -20 0 1408 1415 1390 1368 1371 -12 1372 -110 1009 -12 1372 1373 -21 0 1397 -2 1376 1394 -12 1372 -110 1009 -12 1372 1373 -24 0 1404 1382 -11 1372 -110 1009 -3 1372 1382 -8 1372 1373 -14 0 1408 -2 1412 1388 -6 0 1404 -12 1372 -110 1009 -12 1372 1373 -24 0 1404 -12 1372 -110 1009 -12 1372 1373 -24 0 1404 -12 1372 -110 1009 -12 1372 1373 -18 0 -2 83 102 83 -2 0 1404 -12 1372 -110 1009 -12 1372 1373 -24 0 1404 -12 1372 -110 1009 -12 1372 1373 -18 0 -4 44 -2 0 1404 -12 1372 -110 1009 -12 1372 1373 -8 0 -2 1568 -14 0 1404 -12 1372 -110 1009 -12 1372 1373 -4 0 1408 1415 -18 1368 1371 -3 1372 1382 -8 1372 -110 1009 -12 1372 1373 -5 0 1397 -2 1376 1387 -15 1376 1394 -12 1372 -110 1009 -9 1372 1382 -2 1372 1373 -24 0 1404 -12 1372 -110 1009 -12 1372 1373 -24 0 1404 -12 1372 -110 1009 -12 1372 1383 1416 1388 -7 0 -4 44 -11 0 1404 -12 1372 -110 1009 -12 1372 1406 1407 -7 0 44 -4 0 44 -10 0 1404 -12 1372 -110 1009 -12 1372 1373 -5 0 1568 -10 0 1568 -7 0 1404 -12 1372 -110 1009 -12 1372 1373 -5 0 -2 1568 -8 0 -2 1568 -7 0 1404 -12 1372 -110 1009 -12 1372 1383 1368 -17 1379 1416 1388 -4 0 1404 -12 1372 -110 1009 -12 1372 1406 -14 1376 1387 -3 1376 1407 -5 0 1404 -12 1372 -110 1009 -12 1372 1373 -24 0 1404 -12 1372 -110 1009 -12 1372 1373 -22 0 1419 0 1404 -12 1372 -110 1009 -12 1372 1373 -22 0 1420 0 1404 -12 1372 -110 1009 -12 1372 1373 -24 0 1404 -12 1372 -110 1009 -12 1372 1373 -15 0 44 -4 0 1408 1415 -2 1368 1371 -12 1372 -110 1009 -12 1372 1373 -21 0 1397 -2 1376 1394 -12 1372 -110 1009 -12 1372 1373 -9 0 44 -4 0 1408 1412 1388 -7 0 1404 -12 1372 -110 1009 -12 1372 1373 0 44 -22 0 1404 -12 1372 -110 1009 -12 1372 1373 -8 0 1408 1412 1388 -13 0 1404 -12 1372 -110 1009 -12 1372 1373 0 48 -22 0 1404 -12 1372 -110 1009 -12 1372 1383 -2 1368 1379 1416 1388 -19 0 1404 -12 1372 -110 1009 -12 1372 1406 -2 1376 1375 1407 -20 0 1404 -12 1372 -110 1009 -12 1372 1377 -24 0 1374 -12 1372 -110 1009 -12 1372 -26 0 -12 1372 -110 1009 -12 1372 1369 -24 0 1370 -12 1372 -110 1009 -12 1372 1373 -24 0 1404 -12 1372 -110 1009 -7 1372 1382 -4 1372 1373 -24 0 1404 -8 1372 1382 -3 1372 -110 1009 -5 1372 1382 -6 1372 1373 -24 0 1404 -6 1372 1382 -5 1372 -110 1009 -12 1372 1373 -24 0 1404 -12 1372 -110 1009 -12 1372 1373 -24 0 1404 -12 1372 -110 1009 -12 1372 1373 -24 0 1404 -12 1372 -110 1009 -12 1372 1373 -24 0 1404 -12 1372 -110 1009 -12 1372 1373 -24 0 1404 -12 1372 -110 1009 -12 1372 1373 -24 0 1404 -12 1372 -110 1009 -12 1372 1373 -24 0 1404 -12 1372 -110 1009 -12 1372 1373 -24 0 1404 -12 1372 -110 1009 -12 1372 1373 -24 0 1404 -12 1372 -110 1009 -12 1372 1373 -24 0 1404 -12 1372 -110 1009 -12 1372 1373 -24 0 1404 -12 1372 -110 1009 -12 1372 1373 -24 0 1404 -12 1372 -110 1009 -12 1372 1373 -24 0 1404 -12 1372 -110 1009 -12 1372 1373 -24 0 1404 -12 1372 -110 1009 -12 1372 1373 -24 0 1404 -12 1372 -110 1009 -12 1372 1373 -24 0 1404 -12 1372 -110 1009 -12 1372 1373 -24 0 1404 -12 1372 -110 1009 -12 1372 1373 -24 0 1404 -12 1372 -110 1009 -12 1372 1373 -24 0 1404 -12 1372 -110 1009 -12 1372 1373 -24 0 1404 -12 1372 -110 1009 -12 1372 1373 -24 0 1404 -12 1372 -110 1009 -12 1372 1373 -24 0 1404 -12 1372 -110 1009 -12 1372 1373 -24 0 1404 -12 1372 -110 1009 -12 1372 1373 -24 0 1404 -12 1372 -110 1009 -12 1372 1373 -24 0 1404 -12 1372 -110 1009 -12 1372 1373 -24 0 1404 -12 1372 -110 1009 -12 1372 1373 -24 0 1404 -12 1372 -110 1009 -12 1372 1373 -24 0 1404 -12 1372 -110 1009 -12 1372 1373 -24 0 1404 -12 1372 -110 1009 -12 1372 1373 -24 0 1404 -12 1372 -110 1009 -12 1372 1373 -24 0 1404 -12 1372 -110 1009 -12 1372 1373 -24 0 1404 -12 1372 -110 1009 -12 1372 1373 -24 0 1404 -12 1372 -110 1009 -12 1372 1373 -24 0 1404 -12 1372 -110 1009 -12 1372 1373 -24 0 1404 -12 1372 -57 1009)
    )
    (tilemap
      (handle
        (scale_x 0)
        (scale_y 0)
        (offset_x 0)
        (offset_y 0)
      )
      (solid #t)
      (z-pos 101)
      (name "LavaRising")
      (path-ref "gen1772929733104989798655008")
      (width 34)
      (height 41)
      (tiles -34 1708 -34 1705 -1326 1700)
    )
    (tilemap
      (solid #f)
      (z-pos 102)
      (name "LavaBorder")
      (width 160)
      (height 128)
      (tiles -4377 0 -6 1372 1382 1372 1373 -24 0 1404 -4 1372 1382 -6 1372 -115 0 -8 1372 1373 -24 0 1404 -11 1372 -115 0 -8 1372 1373 -24 0 1404 -11 1372 -115 0 -8 1372 1373 -24 0 1404 -11 1372 -115 0 -8 1372 1373 -24 0 1404 -11 1372 -115 0 -8 1372 1373 -24 0 1404 -11 1372 -115 0 -5 1372 1395 -2 1372 1373 -24 0 1404 -11 1372 -115 0 -8 1372 1373 -24 0 1404 -11 1372 -115 0 -8 1372 1373 -24 0 1404 -11 1372 -115 0 -8 1372 1373 -24 0 1404 -11 1372 -115 0 -8 1372 1373 -24 0 1404 -11 1372 -115 0 -3 1372 1382 -4 1372 1373 -24 0 1404 -11 1372 -115 0 -8 1372 1373 -24 0 1404 -11 1372 -115 0 -8 1372 1373 -24 0 1404 -5 1372 1382 -5 1372 -115 0 -8 1372 1373 -24 0 1404 -11 1372 -115 0 -8 1372 1373 -24 0 1404 -11 1372 -115 0 -8 1372 1373 -24 0 1404 -11 1372 -115 0 -8 1372 1373 -24 0 1404 -11 1372 -115 0 -8 1372 1373 -24 0 1404 -11 1372 -115 0 -8 1372 1373 -24 0 1404 -11 1372 -115 0 -8 1372 1373 -24 0 1404 -11 1372 -115 0 -8 1372 1373 -24 0 1404 -4 1372 1395 -6 1372 -115 0 -4 1372 1382 -3 1372 1373 -24 0 1404 -11 1372 -115 0 -8 1372 1373 -24 0 1404 -11 1372 -115 0 -8 1372 1373 -24 0 1404 -11 1372 -115 0 -8 1372 1373 -24 0 1404 -11 1372 -115 0 -8 1372 1373 -24 0 1404 -11 1372 -115 0 -8 1372 1373 -24 0 1404 -11 1372 -115 0 -8 1372 1373 -24 0 1404 -11 1372 -115 0 -8 1372 1373 -24 0 1404 -11 1372 -115 0 -8 1372 1373 -24 0 1404 1382 -10 1372 -115 0 -8 1372 1373 -24 0 1404 -11 1372 -115 0 -8 1372 1373 -24 0 1404 -11 1372 -115 0 -8 1372 1373 -24 0 1404 -11 1372 -115 0 -8 1372 1373 -24 0 1404 -11 1372 -115 0 -8 1372 1373 -24 0 1404 -11 1372 -115 0 -8 1372 1373 -24 0 1404 -11 1372 -115 0 -8 1372 1373 -24 0 1404 -11 1372 -115 0 -8 1372 1373 -24 0 1404 -3 1372 1382 -7 1372 -115 0 -8 1372 1373 -24 0 1404 -11 1372 -115 0 -5 1372 1382 -2 1372 1373 -24 0 1404 -11 1372 -115 0 -8 1372 1373 -24 0 1404 -8 1372 1395 -2 1372 -115 0 -8 1372 1373 -24 0 1404 -11 1372 -115 0 -8 1372 1373 -24 0 1404 -11 1372 -115 0 -8 1372 1373 -24 0 1404 -11 1372 -115 0 -8 1372 1373 -24 0 1404 -11 1372 -115 0 -8 1372 1373 -24 0 1404 -11 1372 -115 0 -8 1372 1373 -24 0 1404 -11 1372 -115 0 -8 1372 1373 -24 0 1404 -11 1372 -115 0 -8 1372 1373 -24 0 1404 -11 1372 -115 0 -8 1372 1373 -24 0 1404 -11 1372 -115 0 -8 1372 1373 -24 0 1404 -11 1372 -115 0 -8 1372 1373 -24 0 1404 -11 1372 -115 0 -8 1372 1373 -24 0 1404 -11 1372 -115 0 -8 1372 1373 -24 0 1404 -11 1372 -115 0 -8 1372 1373 -24 0 1404 -11 1372 -115 0 -8 1372 1373 -24 0 1404 -11 1372 -115 0 -8 1372 1373 -24 0 1404 -11 1372 -115 0 -6 1372 1395 1372 1373 -24 0 1404 -11 1372 -115 0 -8 1372 1373 -24 0 1404 -11 1372 -115 0 -8 1372 1373 -24 0 1404 -11 1372 -115 0 -8 1372 1373 -24 0 1404 -11 1372 -115 0 -8 1372 1373 -24 0 1404 -11 1372 -115 0 -8 1372 1373 -24 0 1404 -11 1372 -115 0 -3 1372 1382 -4 1372 1373 -24 0 1404 -8 1372 1382 -2 1372 -115 0 1372 1382 -6 1372 1373 -24 0 1404 -6 1372 1382 -4 1372 -115 0 -8 1372 1373 -24 0 1404 -11 1372 -115 0 -8 1372 1373 -24 0 1404 -11 1372 -115 0 -8 1372 1373 -24 0 1404 -11 1372 -115 0 -8 1372 1373 -24 0 1404 -11 1372 -115 0 -8 1372 1373 -24 0 1404 -11 1372 -115 0 -8 1372 1373 -24 0 1404 -11 1372 -115 0 -8 1372 1373 -24 0 1404 -11 1372 -115 0 -8 1372 1373 -24 0 1404 -11 1372 -115 0 -8 1372 1373 -24 0 1404 -11 1372 -115 0 -8 1372 1373 -24 0 1404 -11 1372 -115 0 -8 1372 1373 -24 0 1404 -11 1372 -115 0 -8 1372 1373 -24 0 1404 -11 1372 -115 0 -8 1372 1373 -24 0 1404 -11 1372 -115 0 -8 1372 1373 -24 0 1404 -11 1372 -115 0 -8 1372 1373 -24 0 1404 -11 1372 -115 0 -8 1372 1373 -24 0 1404 -11 1372 -115 0 -8 1372 1373 -24 0 1404 -11 1372 -115 0 -8 1372 1373 -24 0 1404 -11 1372 -115 0 -8 1372 1373 -24 0 1404 -11 1372 -115 0 -8 1372 1373 -24 0 1404 -11 1372 -115 0 -8 1372 1373 -24 0 1404 -11 1372 -115 0 -8 1372 1373 -24 0 1404 -11 1372 -115 0 -8 1372 1373 -24 0 1404 -11 1372 -115 0 -8 1372 1373 -24 0 1404 -11 1372 -115 0 -8 1372 1373 -24 0 1404 -11 1372 -115 0 -8 1372 1373 -24 0 1404 -11 1372 -115 0 -8 1372 1373 -24 0 1404 -11 1372 -115 0 -8 1372 1373 -24 0 1404 -11 1372 -115 0 -8 1372 1373 -24 0 1404 -11 1372 -115 0 -8 1372 1373 -24 0 1404 -11 1372 -115 0 -8 1372 1373 -24 0 1404 -11 1372 -115 0 -8 1372 1373 -24 0 1404 -11 1372 -115 0 -8 1372 1373 -24 0 1404 -11 1372 -115 0 -8 1372 1373 -24 0 1404 -11 1372 -115 0 -8 1372 1373 -24 0 1404 -11 1372 -58 0)
    )
    (tilemap
      (solid #f)
      (z-pos 1)
      (name "FGArt")
      (width 160)
      (height 128)
      (tiles -3864 0 -2 1002 -27 0 1003 -48 0 1000 -101 0 1938 -8 0 1007 -48 0 1004 -8 0 1953 -70 0 1936 1937 -19 0 1945 -9 0 1011 -48 0 1008 -7 0 1950 1951 -70 0 1940 1941 -19 0 1949 -9 0 1011 -48 0 1008 -7 0 1954 1955 -101 0 1011 -48 0 1008 -110 0 1011 -48 0 1008 -110 0 1011 -48 0 1008 -110 0 1011 -48 0 1008 -110 0 1011 -48 0 1008 -110 0 1011 -48 0 1008 -110 0 1011 -48 0 1008 -110 0 1011 -48 0 1008 -110 0 1011 -48 0 1008 -110 0 1011 -48 0 1008 -110 0 1011 -48 0 1008 -110 0 1011 -48 0 1008 -110 0 1011 -48 0 1008 -110 0 1011 -48 0 1008 -110 0 1011 -48 0 1008 -110 0 1011 -48 0 1008 -110 0 1011 -48 0 1008 -110 0 1011 -48 0 1008 -110 0 1011 -48 0 1008 -110 0 1011 -48 0 1008 -110 0 1011 -48 0 1008 -110 0 1011 -48 0 1008 -110 0 1011 -48 0 1008 -110 0 1011 -48 0 1008 -110 0 1011 -48 0 1008 -110 0 1011 -48 0 1008 -110 0 1011 -48 0 1008 -110 0 1011 -48 0 1008 -110 0 1011 -48 0 1008 -110 0 1011 -48 0 1008 -110 0 1011 -48 0 1008 -110 0 1011 -48 0 1008 -110 0 1011 -48 0 1008 -110 0 1011 -48 0 1008 -110 0 1011 -48 0 1008 -110 0 1011 -48 0 1008 -110 0 1011 -48 0 1008 -110 0 1011 -48 0 1008 -110 0 1011 -48 0 1008 -110 0 1011 -48 0 1008 -110 0 1011 -48 0 1008 -110 0 1011 -48 0 1008 -110 0 1011 -48 0 1008 -110 0 1011 -48 0 1008 -110 0 1011 -48 0 1008 -110 0 1011 -48 0 1008 -110 0 1011 -48 0 1008 -110 0 1011 -48 0 1008 -110 0 1011 -48 0 1008 -110 0 1011 -48 0 1008 -110 0 1011 -48 0 1008 -110 0 1011 -48 0 1008 -110 0 1011 -48 0 1008 -110 0 1011 -48 0 1008 -110 0 1011 -48 0 1008 -110 0 1011 -48 0 1008 -110 0 1011 -48 0 1008 -110 0 1011 -48 0 1008 -110 0 1011 -48 0 1008 -110 0 1011 -48 0 1008 -110 0 1011 -48 0 1008 -110 0 1011 -48 0 1008 -110 0 1011 -48 0 1008 -110 0 1011 -48 0 1008 -110 0 1011 -48 0 1008 -110 0 1011 -48 0 1008 -110 0 1011 -48 0 1008 -110 0 1011 -48 0 1008 -110 0 1011 -48 0 1008 -110 0 1011 -48 0 1008 -110 0 1011 -48 0 1008 -110 0 1011 -48 0 1008 -110 0 1011 -48 0 1008 -110 0 1011 -48 0 1008 -110 0 1011 -48 0 1008 -110 0 1011 -48 0 1008 -110 0 1011 -48 0 1008 -110 0 1011 -48 0 1008 -110 0 1011 -48 0 1008 -110 0 1011 -48 0 1008 -110 0 1011 -48 0 1008 -110 0 1011 -48 0 1008 -110 0 1011 -48 0 1008 -110 0 1011 -48 0 1008 -110 0 1011 -48 0 1008 -110 0 1011 -48 0 1008 -110 0 1011 -48 0 1008 -110 0 1011 -48 0 1008 -110 0 1011 -48 0 1008 -110 0 1011 -48 0 1008 -110 0 1011 -48 0 1008 -110 0 1011 -48 0 1008 -110 0 1011 -48 0 1008 -110 0 1011 -48 0 1008 -110 0 1011 -48 0 1008 -110 0 1011 -48 0 1008 -110 0 1011 -48 0 1008 -110 0 1011 -48 0 1008 -110 0 1011 -48 0 1008 -110 0 1011 -48 0 1008 -57 0)
    )
    (viciousivy
      (z-pos 50)
      (x 704)
      (y 752)
      (glinting #f)
    )
    (viciousivy
      (z-pos 50)
      (x 2080)
      (y 752)
      (glinting #f)
    )
  )
)
