(supertux-level
  (version 3)
  (name (_ "Light and Magic"))
  (author "Wolfgang Becker")
  (license "GPL 2+ / CC-by-sa 3.0")
  (allow-item-pocket "inherit")
  (icon "")
  (icon-locked "")
  (statistics
    (enable-coins #t)
    (enable-secrets #t)
  )
  (sector
    (name "main")
    (ambient-light
      (color 0.5333334 0.5333334 0.5333334)
    )
    (background
      (scroll-offset-y -200)
      (color 1 1 1)
      (speed 0.5)
      (image-top "/images/background/transparent_up.png")
      (image "/images/background/ghostforest_para.png")
      (image-bottom "/images/background/black_800px.png")
      (z-pos -205)
    )
    (camera
      (name "Camera")
      (mode "normal")
    )
    (candle
      (z-pos -99)
      (x 8448)
      (y 672)
    )
    (firefly
      (sprite "images/objects/resetpoints/torch.sprite")
      (z-pos 0)
      (x 5248)
      (y 608)
    )
    (fish-jumping
      (z-pos 50)
      (x 3584)
      (y 704)
      (glinting #f)
    )
    (flame
      (z-pos 150)
      (speed -2)
      (x 6880)
      (y 544)
    )
    (gradient
      (top_color 0.5319905 0.5319905 0.5319905)
      (bottom_color 0.2743267 0.2737926 0.2915541)
      (z-pos -210)
    )
    (lantern
      (z-pos 50)
      (color 0 1 0)
      (x 4608)
      (y 672)
    )
    (lantern
      (z-pos 50)
      (x 4128)
      (y 800)
    )
    (lantern
      (z-pos 50)
      (color 1 0 0)
      (x 384)
      (y 352)
    )
    (lantern
      (z-pos 50)
      (color 1 0 0)
      (x 3360)
      (y 640)
    )
    (lantern
      (z-pos 50)
      (color 0 0 1)
      (x 1760)
      (y 704)
    )
    (lantern
      (z-pos 50)
      (color 0 1 0)
      (x 384)
      (y 608)
    )
    (lantern
      (z-pos 50)
      (color 0 1 0)
      (x 2336)
      (y 640)
    )
    (lantern
      (z-pos 50)
      (color 0 0 1)
      (x 6880)
      (y 480)
    )
    (lantern
      (z-pos 50)
      (color 1 0 0)
      (x 6112)
      (y 576)
    )
    (lantern
      (z-pos 50)
      (color 1 0 0)
      (x 3712)
      (y 704)
    )
    (lantern
      (z-pos 50)
      (color 1 0 0)
      (x 7616)
      (y 480)
    )
    (magicblock
      (z-pos 50)
      (color 1 0 0)
      (x 1248)
      (y 640)
    )
    (magicblock
      (z-pos 50)
      (color 0 1 1)
      (x 1984)
      (y 576)
    )
    (magicblock
      (z-pos 50)
      (color 1 0 0)
      (x 1056)
      (y 640)
    )
    (magicblock
      (z-pos 50)
      (color 1 0 0)
      (x 1024)
      (y 640)
    )
    (magicblock
      (z-pos 50)
      (color 1 0 0)
      (x 4096)
      (y 576)
    )
    (magicblock
      (z-pos 50)
      (color 1 0 0)
      (x 4128)
      (y 576)
    )
    (magicblock
      (z-pos 50)
      (color 1 0 0)
      (x 4256)
      (y 512)
    )
    (magicblock
      (z-pos 50)
      (color 0 1 0)
      (x 4544)
      (y 672)
    )
    (magicblock
      (z-pos 50)
      (color 0 1 0)
      (x 4544)
      (y 640)
    )
    (magicblock
      (z-pos 50)
      (color 0 1 0)
      (x 4544)
      (y 704)
    )
    (magicblock
      (z-pos 50)
      (color 1 0 0)
      (x 4544)
      (y 384)
    )
    (magicblock
      (z-pos 50)
      (color 1 0 0)
      (x 5024)
      (y 704)
    )
    (magicblock
      (z-pos 50)
      (color 1 0 0)
      (x 4544)
      (y 320)
    )
    (magicblock
      (z-pos 50)
      (color 1 0 0)
      (x 4544)
      (y 352)
    )
    (magicblock
      (z-pos 50)
      (color 1 0 0)
      (x 4960)
      (y 704)
    )
    (magicblock
      (z-pos 50)
      (color 1 0 0)
      (x 4992)
      (y 704)
    )
    (magicblock
      (z-pos 50)
      (color 1 0 0)
      (x 1216)
      (y 640)
    )
    (magicblock
      (z-pos 50)
      (color 0 1 0)
      (x 384)
      (y 544)
    )
    (magicblock
      (z-pos 50)
      (color 0 0 1)
      (x 1952)
      (y 704)
    )
    (magicblock
      (z-pos 50)
      (color 0 0 1)
      (x 1920)
      (y 704)
    )
    (magicblock
      (z-pos 50)
      (color 1 0 0)
      (x 6560)
      (y 608)
    )
    (magicblock
      (z-pos 50)
      (color 1 0 0)
      (x 6624)
      (y 608)
    )
    (magicblock
      (z-pos 50)
      (color 1 0 0)
      (x 6656)
      (y 608)
    )
    (magicblock
      (z-pos 50)
      (color 1 0 1)
      (x 6912)
      (y 544)
    )
    (magicblock
      (z-pos 50)
      (color 1 0 1)
      (x 6848)
      (y 544)
    )
    (magicblock
      (z-pos 50)
      (color 0 0 1)
      (x 7136)
      (y 480)
    )
    (magicblock
      (z-pos 50)
      (color 1 0 0)
      (x 6592)
      (y 608)
    )
    (magicblock
      (z-pos 50)
      (color 1 0 1)
      (x 6784)
      (y 544)
    )
    (magicblock
      (z-pos 50)
      (color 0 0 1)
      (x 7040)
      (y 480)
    )
    (magicblock
      (z-pos 50)
      (color 0 0 1)
      (x 7072)
      (y 480)
    )
    (magicblock
      (z-pos 50)
      (color 0 0 1)
      (x 7104)
      (y 480)
    )
    (magicblock
      (z-pos 50)
      (color 1 0 1)
      (x 6816)
      (y 544)
    )
    (magicblock
      (z-pos 50)
      (color 1 0 0)
      (x 3936)
      (y 640)
    )
    (magicblock
      (z-pos 50)
      (color 1 0 0)
      (x 4288)
      (y 512)
    )
    (magicblock
      (z-pos 50)
      (color 1 0 1)
      (x 8768)
      (y 608)
    )
    (magicblock
      (z-pos 50)
      (color 1 0 1)
      (x 8800)
      (y 608)
    )
    (magicblock
      (z-pos 50)
      (color 1 0 1)
      (x 8832)
      (y 608)
    )
    (mrbomb
      (z-pos 50)
      (x 2112)
      (y 736)
      (glinting #f)
    )
    (music
      (file "music/ghostforest2.ogg")
    )
    (particles-ghosts
    )
    (snail
      (z-pos 50)
      (x 8448)
      (y 640)
      (glinting #f)
    )
    (spawnpoint
      (name "main")
      (x 96)
      (y 544)
    )
    (tilemap
      (solid #f)
      (draw-target "lightmap")
      (z-pos -250)
      (name "Lightmap")
      (width 300)
      (height 36)
      (tiles -250 0 2034 -25 2035 2041 -273 0 2034 -25 2035 2041 -273 0 2034 -25 2035 2041 -273 0 2034 -25 2035 2041 -273 0 2034 -25 2035 2041 -273 0 2034 -25 2035 2041 -273 0 2034 -25 2035 2041 -273 0 2034 -25 2035 2041 -273 0 2034 -25 2035 2041 -273 0 2034 -25 2035 2041 -273 0 2034 -25 2035 2041 -273 0 2034 -25 2035 2041 -273 0 2034 -25 2035 2041 -273 0 2034 -25 2035 2041 -273 0 2034 -25 2035 2041 -273 0 2034 -25 2035 2041 -273 0 2034 -25 2035 2041 -273 0 2034 -25 2035 2041 -273 0 2034 -25 2035 2041 -273 0 2034 -25 2035 2041 -273 0 2034 -25 2035 2041 -273 0 2034 -25 2035 2041 -273 0 2034 -25 2035 2041 -273 0 2034 -25 2035 2041 -273 0 2034 -25 2035 2041 -273 0 2034 -25 2035 2041 -273 0 2034 -25 2035 2041 -273 0 2034 -25 2035 2041 -273 0 2034 -25 2035 2041 -273 0 2034 -25 2035 2041 -273 0 2034 -25 2035 2041 -273 0 2034 -25 2035 2041 -273 0 2034 -25 2035 2041 -273 0 2034 -25 2035 2041 -273 0 2034 -25 2035 2041 -273 0 2034 -25 2035 2041 -23 0)
    )
    (tilemap
      (solid #f)
      (z-pos -100)
      (width 300)
      (height 36)
      (tiles -245 0 -10 1489 -18 1477 1476 1477 -2 1476 1477 1479 1480 1481 1477 -263 0 -10 1489 -18 1477 1476 1477 -2 1476 1477 1486 1487 1488 1477 -263 0 -10 1489 -18 1477 1476 1477 -2 1476 1477 1493 1494 1495 1477 -263 0 -2 1489 1517 -4 1489 1517 -2 1489 -2 1477 1517 -4 1477 1517 -4 1477 1517 -4 1477 1517 1476 1477 -2 1476 1517 1500 1501 1502 1477 -263 0 -2 1489 1518 -4 1489 1518 -2 1489 -2 1477 1518 -4 1477 1518 -4 1477 1518 -4 1477 1518 1476 1477 -2 1476 1518 1507 1508 1509 1477 -263 0 -6 1489 1479 1480 1481 1489 -16 1477 1479 1480 1481 1477 -2 1476 -5 1477 -263 0 -6 1489 1486 1487 1488 1489 -16 1477 1486 1487 1488 1477 -2 1476 -5 1477 -216 0 1169 1170 -45 0 -6 1489 1493 1494 1495 1489 -16 1477 1493 1494 1495 1477 -2 1476 -5 1477 -155 0 2007 -3 1353 -3 0 -6 1353 -47 0 1174 1175 1176 1177 -44 0 -6 1489 1500 1501 1502 1489 -16 1477 1500 1501 1502 1477 -2 1476 -5 1477 -38 0 1073 1074 1075 -76 0 1073 1074 1075 -35 0 2008 -3 1354 -7 1353 -2 1354 -17 0 1073 1074 1075 -26 0 1179 1180 1181 1182 1183 -44 0 -6 1496 1507 1508 1509 1496 -16 1476 1507 1508 1509 1477 -2 1476 1477 1476 -3 1477 -38 0 1081 1082 1083 1084 -64 0 1168 1169 1170 -8 0 1081 1082 1083 1084 -34 0 2008 -3 1353 -2 1354 1353 1354 -5 1353 -17 0 1081 1082 1083 1084 -25 0 1185 1186 1187 1188 1189 1190 -43 0 1489 1482 1517 1476 1477 1476 1477 1517 1476 1477 1476 1477 1517 1476 1477 1476 1477 1517 1476 1477 1476 1477 1517 1476 1477 1476 1477 1517 1476 1477 1476 1477 1517 1476 1477 1476 1477 -37 0 1088 1089 1090 1091 1092 1093 -49 0 1073 1074 1075 -11 0 1174 1175 1176 1177 -6 0 1088 1089 1090 1091 1092 1093 -33 0 2007 -7 1353 1354 -2 1353 -2 1354 -16 0 1088 1089 1090 1091 1092 1093 -11 0 1168 1169 1170 -10 0 1191 1192 1193 1194 1195 1196 -43 0 1481 1489 1518 1476 1477 1476 1477 1518 1476 1477 1476 1477 1518 1476 1477 1476 1477 1518 1476 1477 1476 1477 1518 1476 1477 1476 1477 1518 1476 1477 1476 1477 1518 1476 1477 1476 1477 -36 0 1095 1096 1097 1098 1099 1100 1101 -49 0 1081 1082 1083 1084 -9 0 1179 1180 1181 1182 1183 -5 0 1095 1096 1097 1098 1099 1100 1101 -33 0 2008 -6 1354 -5 1353 1354 -15 0 1095 1096 1097 1098 1099 1100 1101 -11 0 1174 1175 1176 1177 -9 0 1197 1198 1199 1200 1201 1202 -43 0 -30 1489 1476 -2 1477 1476 1477 -2 1489 -36 0 1103 1104 1105 1106 1107 1108 1109 1110 -27 0 1073 1074 1075 -17 0 1088 1089 1090 1091 1092 1093 -8 0 1185 1186 1187 1188 1189 1190 -4 0 1103 1104 1105 1106 1107 1108 1109 1110 -32 0 2007 -4 1353 0 -4 1353 -2 1354 2013 -15 0 1103 1104 1105 1106 1107 1108 1109 1110 -9 0 1179 1180 1181 1182 1183 -9 0 1203 1204 1205 1206 1207 1208 -43 0 1476 1477 1483 1484 1485 1476 1477 1476 1477 1476 1477 1476 1477 1476 -2 1477 1486 1487 1488 1476 -2 1477 1476 -3 1477 1476 1477 1476 1477 1476 -2 1477 1476 1479 1480 1481 -36 0 1111 1112 1113 1114 1115 1116 1117 1118 -27 0 1081 1082 1083 1084 -15 0 1095 1096 1097 1098 1099 1100 1101 -8 0 1191 1192 1193 1194 1195 1196 -4 0 1111 1112 1113 1114 1115 1116 1117 1118 -32 0 2008 -4 1354 0 -6 1353 2012 -15 0 1111 1112 1113 1114 1115 1116 1117 1118 -9 0 1185 1186 1187 1188 1189 1190 -8 0 1209 1210 1211 1212 1213 1214 -43 0 1476 1477 1490 1491 1492 1476 1477 1476 1477 1476 1477 1476 1477 1476 -2 1477 1493 1494 1495 -3 1476 1479 1480 1481 1477 1476 1477 1476 1477 1476 -2 1477 1476 1486 1487 1488 -36 0 1119 1120 1121 1122 1123 1124 1125 1126 -26 0 1088 1089 1090 1091 1092 1093 -14 0 1103 1104 1105 1106 1107 1108 1109 1110 -7 0 1197 1198 1199 1200 1201 1202 -4 0 1119 1120 1121 1122 1123 1124 1125 1126 -38 0 -4 1353 -2 1354 2013 -15 0 1119 1120 1121 1122 1123 1124 1125 1126 -9 0 1191 1192 1193 1194 1195 1196 -9 0 2045 1219 1220 -45 0 1476 1477 1497 1498 1499 1476 1477 1483 1484 1485 1477 1476 1477 1476 -2 1477 1500 1501 1502 1476 -2 1477 1486 1487 1488 1477 1476 1477 -2 1476 1477 1476 1477 1476 1493 1494 1495 -36 0 1127 1128 1129 1130 1131 1132 1133 1134 -25 0 1095 1096 1097 1098 1099 1100 1101 -14 0 1111 1112 1113 1114 1115 1116 1117 1118 -7 0 1203 1204 1205 1206 1207 1208 -4 0 1127 1128 1129 1130 1131 1132 1133 1134 -38 0 -2 1353 1354 -2 1353 1354 2012 -15 0 1127 1128 1129 1130 1131 1132 1133 1134 -9 0 1197 1198 1199 1200 1201 1202 -9 0 2046 1225 1226 -45 0 1476 1477 1504 1505 1506 1476 1477 1490 1491 1492 1477 1476 1477 1476 -2 1477 1507 1508 1509 -3 1476 1493 1494 1495 -2 1477 1476 1477 1476 1477 1476 -2 1477 1500 1501 1502 -38 0 1137 1138 1139 1140 1141 -26 0 1103 1104 1105 1106 1107 1108 1109 1110 -13 0 1119 1120 1121 1122 1123 1124 1125 1126 -7 0 1209 1210 1211 1212 1213 1214 -6 0 1137 1138 1139 1140 1141 -39 0 -4 1353 -2 1354 2013 -17 0 1137 1138 1139 1140 1141 -10 0 1191 1192 1193 1194 1195 1196 -10 0 1217 1218 -45 0 1476 1477 1476 1477 -2 1476 1477 1497 1498 1499 1477 1476 1477 -2 1476 1477 1476 1477 1476 1477 1476 1477 1500 1501 1502 -2 1477 1476 1477 1476 1477 1476 -2 1477 1507 1508 1509 -38 0 1145 1146 1147 1148 -27 0 1111 1112 1113 1114 1115 1116 1117 1118 -13 0 1127 1128 1129 1130 1131 1132 1133 1134 -8 0 2045 1219 1220 -8 0 1145 1146 1147 1148 -40 0 -2 1353 1354 -2 1353 1354 2012 -17 0 1145 1146 1147 1148 -11 0 1197 1198 1199 1200 1201 1202 -10 0 1223 1224 -45 0 1476 1477 1476 1477 -2 1476 1477 1504 1505 1506 1477 1476 1477 -2 1476 1477 1476 1477 1476 1477 1476 1477 1507 1508 1509 1477 1476 -2 1477 1476 -2 1477 1476 1477 -2 1476 1477 -38 0 1153 1154 1155 1156 -27 0 1119 1120 1121 1122 1123 1124 1125 1126 -15 0 1137 1138 1139 1140 1141 -9 0 2046 1225 1226 -8 0 1137 1138 1139 1140 1141 -37 0 2007 -7 1353 2013 -17 0 1153 1154 1155 1156 -11 0 1203 1204 1205 1206 1207 1208 -9 0 1228 1229 1230 -45 0 1476 1477 1476 1477 -2 1476 1477 1476 1477 1476 1477 1476 1477 -2 1476 1477 1476 1477 1476 1477 1476 -2 1477 1476 1477 1476 1477 1476 1477 1476 -2 1477 1476 1477 -2 1476 1477 -38 0 1161 1162 1163 1164 -27 0 1127 1128 1129 1130 1131 1132 1133 1134 -15 0 1145 1146 1147 1148 -11 0 1217 1218 -8 0 1145 1146 1147 1148 -38 0 2008 1354 -6 1353 2012 -17 0 1161 1162 1163 1164 -11 0 1209 1210 1211 1212 1213 1214 -9 0 1234 1235 1236 -58 0 -2 1476 1477 1476 1477 1476 1477 1476 -2 1477 1476 1477 1476 1477 1476 1477 1476 -2 1477 1476 1477 -2 1476 1477 -71 0 1137 1138 1139 1140 1141 -16 0 1153 1154 1155 1156 -11 0 1223 1224 -8 0 1153 1154 1155 1156 -38 0 2007 -5 1353 -2 1354 2013 -34 0 1217 1218 -72 0 -2 1476 1477 1476 1477 1476 1477 1476 1477 1476 -2 1477 1476 1477 1476 1479 1480 1481 1477 1476 1477 -2 1476 1477 -10 0 1001 -60 0 1145 1146 1147 1148 -17 0 1161 1162 1163 1164 -10 0 1228 1229 1230 -8 0 1161 1162 1163 1164 -38 0 2007 -2 1353 -2 1354 -2 1353 1354 2012 -34 0 1223 1224 -72 0 -2 1476 1477 1476 1477 -2 1476 1477 1476 1477 1476 1477 1476 1477 1476 1486 1487 1488 1477 1476 1477 -2 1476 1477 -71 0 1153 1154 1155 1156 -31 0 1234 1235 1236 -32 0 402 403 434 435 436 437 434 435 436 437 404 405 -6 0 2008 1354 2013 -39 0 1228 1229 1230 -72 0 -2 1476 1477 1476 1477 1476 -2 1477 1476 1477 1476 -2 1477 1476 1477 1493 1494 1495 1476 -2 1477 -2 1476 1477 -71 0 1161 1162 1163 1164 -52 0 76 -5 0 76 -7 0 406 407 438 439 440 441 438 439 440 441 408 409 -48 0 1234 1235 1236 -83 0 1476 1477 1476 1477 1500 1501 1502 1476 1477 -3 1476 1477 -127 0 75 -5 0 75 -7 0 410 411 442 443 444 445 442 443 444 445 412 413 -134 0 1476 1477 1476 1477 1507 1508 1509 1476 1479 1480 1481 1476 1477 -127 0 75 -5 0 75 -7 0 414 415 446 447 448 449 446 447 448 449 416 417 -134 0 1476 1477 1479 1480 1481 -3 1476 1486 1487 1488 1476 1477 -127 0 75 -5 0 75 -153 0 1476 1477 1486 1487 1488 1477 -2 1476 1493 1494 1495 1476 1477 -289 0 1493 1494 1495 1477 -2 1476 1500 1501 1502 -291 0 1500 1501 1502 1477 -2 1476 1507 1508 1509 -291 0 1507 1508 1509 1477 -5 1476 -291 0 1476 1477 1476 1477 -5 1476 -291 0 1479 1480 1481 1479 1480 1481 1479 1480 1481 -291 0 1486 1487 1488 1486 1487 1488 1486 1487 1488 -291 0 1493 1494 1495 1493 1494 1495 1493 1494 1495 -291 0 1500 1501 1502 1500 1501 1502 1500 1501 1502 -20 0)
    )
    (tilemap
      (solid #t)
      (z-pos 0)
      (width 300)
      (height 36)
      (tiles -118 0 1431 -31 1432 1434 -267 0 1431 -7 1432 1433 -10 1432 1433 -6 1432 1433 -5 1432 1434 -266 0 1423 3373 -5 1432 -2 1436 -2 1437 -10 1432 -4 1436 -2 1437 -6 1432 1434 -98 0 1511 1512 -3 0 1511 1512 -3 0 1511 1512 -3 0 1511 1512 -3 0 1511 1512 -3 0 1511 1512 -141 0 1427 3379 -2 1432 1436 -3 1432 -10 1436 -2 1432 1437 -3 1432 -3 1436 1437 -5 1432 1434 -98 0 1513 1514 -3 0 1513 1514 -3 0 1513 1514 -3 0 1513 1514 -3 0 1513 1514 -3 0 1513 1514 -141 0 1431 -3 1432 1436 -3 1432 -2 1436 -3 1432 -2 1437 -9 1432 -2 1433 -2 1436 1437 -4 1432 3374 1426 -97 0 1515 1516 -3 0 1515 1516 -3 0 1515 1516 -3 0 1515 1516 -3 0 1515 1516 -3 0 1515 1516 -141 0 1435 1432 -2 1433 1436 -2 1432 1436 1437 -6 1432 1433 -6 1432 -6 1437 1432 1433 -3 1432 3380 1430 -265 0 1435 -3 1432 -2 1436 -2 1432 1437 1433 -4 1437 -9 1432 -2 1437 -9 1432 1434 -265 0 1435 -33 1432 1434 -265 0 1435 1436 1437 1436 1440 1441 1440 1441 1440 1441 1440 1441 1440 1441 1440 1441 1440 1441 1440 1441 1440 1441 1440 1441 -2 1436 1437 1436 1440 1441 1440 1441 1433 1436 1434 -91 0 77 -48 0 133 -124 0 1439 1440 1441 1442 -20 0 1439 1440 1441 1442 -4 0 1431 1436 1438 -91 0 77 -5 0 1511 1512 -3 0 1511 1512 -3 0 1511 1512 -3 0 1511 1512 -3 0 1511 1512 -3 0 1511 1512 -16 0 133 -156 0 1435 1437 1442 -91 0 77 -5 0 1513 1514 -3 0 1513 1514 -3 0 1513 1514 -3 0 1513 1514 -3 0 1513 1514 -3 0 1513 1514 -16 0 133 -156 0 1431 1434 -92 0 77 0 44 -3 0 1515 1516 -3 0 1515 1516 -3 0 1515 1516 -3 0 1515 1516 -3 0 1515 1516 -3 0 1515 1516 -3 0 44 -12 0 133 -74 0 102 -71 0 1443 -3 1424 1426 -5 0 1435 1438 -76 0 1423 1424 1444 -13 0 77 -48 0 133 -144 0 1423 1445 1446 -3 1428 1430 -5 0 1439 1442 -76 0 1427 1428 1447 1448 1444 -11 0 -41 77 -8 0 133 -144 0 1427 1449 1450 1433 1432 1433 1434 -83 0 1431 1432 1451 1452 1447 1448 1444 -58 0 133 -71 0 27 -4 28 29 -67 0 1439 1441 -2 1436 1437 1433 1434 -83 0 1431 1432 -2 1436 1451 1452 1447 1448 1444 -56 0 133 -146 0 1439 -2 1436 1437 1438 -83 0 1435 -5 1436 1451 1452 1447 1448 -20 1424 1444 -34 0 133 -147 0 1439 1436 1437 1438 -71 0 48 -11 0 1431 1432 -6 1436 1451 1452 -20 1428 1447 1448 3391 -8 0 3390 1444 -22 0 133 -148 0 1435 1437 1438 -83 0 1435 -29 1436 1451 1452 3387 3391 -7 0 3392 1447 1448 1426 -7 0 1423 -6 1424 1444 -5 0 133 -148 0 1439 1441 1442 -83 0 1431 1432 -14 1436 1433 -15 1436 3389 3393 -6 0 3390 3394 1451 1452 1430 -7 0 1427 -6 1428 1447 1448 1444 -3 0 133 -7 0 -28 1424 1426 -19 0 1423 1426 -68 0 1423 1426 -42 0 1423 -8 1424 3391 -18 0 1443 -10 1424 1426 -25 0 1435 -27 1436 1433 -4 1436 3395 1444 -5 0 3392 3396 -2 1436 1434 -7 0 1431 -6 1436 1451 1452 1447 1448 1444 0 133 -7 0 -28 1428 1430 -19 0 1427 1430 -52 0 1443 -6 1424 1426 -8 0 1427 1430 -42 0 1427 -8 1428 3393 -16 0 3384 1445 1446 -10 1428 1430 -25 0 1431 1432 -10 1436 1433 -9 1436 1433 -10 1436 3397 1447 1448 -4 1424 3394 -3 1436 1438 -7 0 1435 -8 1436 1451 1452 1447 1448 133 -5 1424 0 132 -22 1432 1433 -4 1432 1433 1434 -19 0 1431 3374 1424 1426 -19 0 1443 -7 1424 1426 -16 0 1423 -4 1424 1445 1446 -6 1428 1430 -8 0 1431 3374 1424 1426 -19 0 1443 -7 1424 1426 -12 0 1431 1432 -7 1436 3395 1444 -14 0 3390 3386 1449 1450 -10 1436 1434 -25 0 1435 -33 1436 1451 1452 -4 1428 3396 -3 1436 1434 -7 0 1431 -3 1436 1433 -6 1436 1451 1452 -8 1428 -2 1432 -3 1436 -2 1432 -15 1436 1437 -4 1436 1437 1438 -16 0 1423 -2 1424 3373 3380 1428 1430 -17 0 3384 1445 1446 -7 1428 1430 -5 0 1423 -4 1424 1426 -5 0 1427 -4 1428 1449 1450 1433 1432 1433 1432 -2 1433 1434 -5 0 1423 -2 1424 3373 3380 1428 1430 -17 0 3384 1445 1446 -7 1428 1430 -12 0 1435 1436 1433 -6 1436 3397 1447 1448 3385 -5 0 1443 1444 -5 0 3392 3388 -12 1436 1438 -25 0 1431 1432 -40 1436 1433 1436 1438 -7 0 1435 -6 1436 1433 -13 1436 -2 1432 -4 1436 -2 1432 1436 1433 -12 1436 -3 1432 1436 1433 1432 1434 -16 0 1427 -2 1428 3379 -2 1432 3374 -17 1424 3386 1449 1450 1432 1433 -5 1436 1434 -5 0 1427 -4 1428 1430 -5 0 1431 1432 1436 1432 -4 1436 1437 1433 1437 -2 1433 1434 -5 76 1427 -2 1428 3379 -2 1432 3374 1424 1426 -14 0 3390 3386 1449 1450 1432 1433 -5 1436 1434 -12 0 1435 -4 1436 -5 1432 1451 1452 3387 -4 1424 1445 1446 1447 1448 -4 1424 3394 -13 1436 1434 -25 0 1435 -43 1436 1434 -7 0 1431 -9 1436 1433 -10 1436 -2 1432 1436 -2 1432 1436 1437 -4 1432 1436 1437 1436 1437 1436 -9 1432 -2 1436 1432 1438 -16 0 1431 1432 1433 -3 1432 3380 -17 1428 3388 -4 1436 1432 1433 -3 1436 1438 -5 0 1431 1432 1436 1432 1433 1434 -5 0 1435 -8 1436 1437 1436 -2 1437 1438 -5 75 1431 1432 1433 -3 1432 3380 1428 1430 -14 0 3392 3388 -4 1436 1432 1433 -3 1436 1438 -12 0 1435 1436 -8 1432 -2 1436 3389 -4 1428 1449 1450 1451 1452 -4 1428 3396 -13 1436 1438 -25 0 1431 1432 -15 1436 1433 -10 1436 1433 -7 1436 1433 -7 1436 1438 -7 0 1435 -20 1436 -2 1432 1433 1432 1433 1432 1436 1432 -8 1436 -2 1432 1436 -6 1432 -3 1436 1434 -16 0 1431 1432 1433 -21 1432 -6 1436 1437 -3 1436 1434 -5 0 1435 -3 1436 1437 1438 -5 0 1431 1436 1432 1436 -4 1432 1436 1437 1436 -2 1437 1438 -5 75 1431 1432 1433 -5 1432 3374 -14 1424 3394 -6 1436 1437 -3 1436 1434 -12 0 1435 1436 -8 1432 -11 1436 1432 1436 1432 1433 -14 1436 1434 -25 0 1435 -40 1436 1433 -2 1436 1434 -7 0 1431 -3 1436 1433 -16 1436 -2 1432 1437 1436 1437 1436 1437 -9 1432 1437 1436 1437 -3 1432 -6 1436 1438 -16 0 1435 -3 1432 1433 -18 1432 1433 -3 1432 -4 1436 1432 -2 1436 1438 -5 0 1431 1432 1436 -2 1432 1434 -5 0 1435 -2 1436 -2 1432 1433 -2 1436 -4 1432 1437 1438 -5 75 1435 -3 1432 1433 -3 1432 3380 -14 1428 3396 -7 1436 1432 -2 1436 1438 -12 0 1435 1436 -8 1432 -29 1436 1438 -25 0 1431 1432 -42 1436 1438 -7 0 1435 -20 1436 -3 1437 1436 1437 1436 1437 -9 1432 1437 -11 1436 1438 -16 0 1435 -17 1432 1433 -5 1432 1436 -2 1432 -4 1436 1432 -2 1436 1438 -5 0 1431 1432 1436 -2 1432 1434 -5 0 1435 -3 1436 -6 1432 1433 -2 1437 1438 -5 75 1435 -3 1432 1433 -3 1432 -2 1436 -4 1432 -17 1436 1432 -2 1436 1438 -12 0 1435 -3 1436 -4 1432 -31 1436 1438 -25 0 1431 1432 -12 1436 1433 -29 1436 1438 -7 0 1435 -20 1436 -3 1437 1436 1437 1433 1437 -8 1432 1433 1437 -11 1436 1438 -16 0 1435 -12 1432 1433 -14 1432 -2 1436 1433 1432 -2 1436 1438 -5 0 1431 1432 1436 -2 1432 1434 -5 0 1435 1436 1432 -2 1436 1433 1436 -3 1432 1436 -2 1437 1438 -5 75 1435 -3 1432 1436 -3 1432 1433 -5 1432 -17 1436 1432 -2 1436 1438 -12 0 1435 -3 1436 -4 1432 -3 1436 1433 -8 1436 1433 -15 1436 1433 -2 1436 1438 -25 0 1431 1432 -35 1436 1433 -6 1436 1438 -7 0 1435 -4 1436 -2 1433 -14 1436 -11 1437 -3 1432 -4 1436 1437 -7 1436 1433 1436 1438 -16 0 1435 -6 1432 1433 -21 1432 -2 1436 1432 -2 1436 1438 -5 0 1431 1432 1433 -2 1432 1434 -5 0 1435 1436 -4 1432 1436 -2 1432 1437 1436 1432 1437 1438 -5 75 1435 -3 1432 1436 -8 1432 -4 1436 1432 -7 1436 1433 -5 1436 1433 -2 1436 1438 -12 0 1435 -3 1436 -4 1432 -8 1436 1433 -22 1436 1438 -25 0 1431 1432 -4 1436 1433 -14 1436 1433 -22 1436 1438 -7 0 1435 -6 1436 1433 -13 1436 -3 1437 -3 1436 -2 1437 -2 1436 1437 -3 1436 -2 1437 -2 1436 1437 -9 1436 1438 -16 0 1435 -23 1432 -3 1436 -5 1432 -2 1436 1438 -5 0 1431 1432 1436 -2 1432 1434 -5 0 1435 -4 1436 -3 1432 1436 1437 1436 1432 1437 1438 -5 75 1435 -3 1432 1436 -10 1432 -2 1436 1433 1432 -2 1436 1433 -9 1436 1432 -2 1436 1438 -12 0 1435 -28 1436 1433 -9 1436 1438 -25 0 1431 1432 -42 1436 1438 -7 0 1435 -12 1436 1433 -4 1436 1433 -2 1436 -3 1437 1436 -2 1437 -3 1432 1437 1432 1436 -2 1437 1436 1432 1437 1436 1437 -9 1436 1438 -16 0 1435 -23 1432 1436 1433 -5 1432 1433 -2 1436 1438 -5 0 1431 1432 1436 1432 1433 1434 -5 0 1435 -6 1436 1432 1436 1437 1436 1432 1437 1438 -5 75 1435 -3 1432 1436 -10 1432 -3 1436 1432 -4 1436 1432 -7 1436 1432 -2 1436 1438 -12 0 1435 -38 1436 1438 -25 0 1431 1432 -35 1436 1433 -6 1436 1438 -7 0 1435 -20 1436 -5 1437 1436 -3 1432 -4 1437 -3 1436 1437 -6 1436 1433 -4 1436 1438 -16 0 1435 -7 1432 1433 -7 1432 1433 -15 1432 -2 1436 1438 -5 0 1431 1432 1436 -2 1432 1434 -5 0 1435 -2 1436 1433 1436 -3 1432 1433 1437 1436 1432 1437 1438 -5 75 1435 -3 1432 1436 -10 1432 -3 1436 -2 1432 -7 1436 1433 -3 1436 1432 -2 1436 1438 -12 0 1435 -18 1436 1433 -6 1436 1433 -12 1436 1438 -25 0 1431 1432 -10 1436 -2 1433 -16 1436 1433 -13 1436 1438 -7 0 1435 -5 1436 1433 -14 1436 1437 1433 1437 1436 1437 1436 -4 1432 1436 -2 1432 1433 -2 1432 -12 1436 1438 -16 0 1435 -31 1432 -2 1436 1438 -5 0 1431 1432 1436 -2 1432 1434 -5 0 1435 -4 1436 -2 1432 -2 1436 1437 1432 1433 1437 1438 -5 75 1435 -3 1432 1433 -3 1432 -3 1436 -2 1432 -3 1436 1433 -14 1436 1432 -2 1436 1438 -12 0 1435 -3 1436 1433 -7 1436 1433 -21 1436 1433 -4 1436 1438 -25 0 1431 1432 -17 1436 1433 -24 1436 1438 -7 0 1435 -20 1436 -3 1437 1436 1437 1436 1437 -9 1432 1437 1436 1437 -9 1436 1438 -16 0 1435 -3 1432 1433 -19 1432 -7 1436 1432 -2 1436 1438 -5 0 1431 1432 1436 -2 1432 1434 -5 0 1435 -4 1436 1432 -3 1436 -2 1432 -2 1437 1438 -5 75 1435 -3 1432 1433 -3 1432 -23 1436 1432 -2 1436 1438 -12 0 1435 -38 1436 1438 -25 0 1431 1432 -42 1436 1438 -7 0 1435 -20 1436)
    )
    (tilemap
      (solid #f)
      (z-pos 100)
      (width 300)
      (height 36)
      (tiles -5028 0 1358 1359 1360 -297 0 1361 1362 1363 -297 0 1364 -2 1362 1358 1359 1360 -63 0 1998 1999 2000 -228 0 1358 -4 1362 1363 -18 0 317 318 -43 0 2023 2024 2025 -228 0 1361 -3 1362 1365 1366 -18 0 319 320 -30 0 317 318 -11 0 2026 2027 2028 -228 0 1361 -3 1362 1359 1360 -6 0 1358 1359 1360 -26 0 317 318 -13 0 319 320 -11 0 2029 2030 2031 -228 0 1361 -4 1362 1363 -6 0 1361 1362 1363 -12 0 317 318 -12 0 319 320 -26 0 1006 1005 1006 -2 0 1311 -3 0 1311 -3 0 -2 1311 -6 0 1311 -4 0 1311 -2 0 1311 -3 0 1311 -3 0 1311 -3 0 1311 -158 0 1358 1359 1360 -28 0 1361 1362 1363 1364 1365 1366 -6 0 1364 1365 1366 -12 0 319 320 -36 0 1358 1359 1360 -6 0 1311 -3 0 1311 -3 0 1311 0 1311 -4 0 1311 0 1311 -2 0 -2 1311 0 1311 0 1311 0 1311 0 1311 0 1311 0 1311 0 1311 -154 0 1358 1359 1360 -2 0 1361 1362 1363 -28 0 1364 1365 1366 -62 0 1361 1362 1363 -6 0 1311 0 1311 0 1311 -3 0 -2 1311 -6 0 -2 1311 -2 0 1311 -4 0 1311 0 1311 0 1311 0 1311 0 1311 0 -2 1311 -153 0 1361 1362 1363 -2 0 1364 1365 1366 -93 0 1364 1365 1366 -6 0 -5 1311 -3 0 1311 0 1311 -6 0 1311 0 1311 -4 0 1311 -2 0 1311 0 1311 0 1311 0 1311 0 1311 0 1311 -152 0 1364 1365 1366 -108 0 1311 0 1311 -2 0 1311 0 -2 1311 -2 0 1311 -3 0 1311 -2 0 1311 -3 0 -3 1311 -2 0 1311 -3 0 1311 -3 0 1311 -504 0 317 318 -45 0 317 318 -251 0 319 320 -18 0 317 318 -25 0 319 320 -260 0 317 318 -9 0 319 320 -287 0 319 320 -5 0 1358 1359 1360 -272 0 1358 1359 1360 -22 0 1361 1362 1363 -20 0 317 318 -250 0 1361 1362 1363 -22 0 1364 1365 1366 -20 0 319 320 -3 0 1358 -2 1359 1360 -4 0 317 318 -237 0 1364 1365 1366 -50 0 1361 -2 1362 1363 -4 0 319 320 -290 0 1364 -2 1365 1366 -9 0)
    )
    (viciousivy
      (z-pos 50)
      (x 8640)
      (y 352)
      (glinting #f)
    )
    (walkingleaf
      (z-pos 50)
      (x 8992)
      (y 384)
      (glinting #f)
    )
    (walkingleaf
      (z-pos 50)
      (x 8160)
      (y 384)
      (glinting #f)
    )
    (walkingleaf
      (z-pos 50)
      (x 2784)
      (y 704)
      (glinting #f)
    )
  )
)
