(supertux-level
  (version 3)
  (name (_ "Little Venice"))
  (author "Christoph Sommer")
  (license "GPL 2+ / CC-by-sa 3.0")
  (allow-item-pocket "inherit")
  (icon "")
  (icon-locked "")
  (statistics
    (enable-coins #t)
    (enable-secrets #t)
  )
  (sector
    (name "main")
    (ambient-light
      (color 1 1 1)
    )
    (camera
      (name "Camera")
      (mode "normal")
    )
    (candle
      (z-pos -99)
      (x 2176)
      (y 192)
    )
    (candle
      (z-pos -99)
      (x 1632)
      (y 896)
    )
    (candle
      (z-pos -99)
      (x 2176)
      (y 992)
    )
    (candle
      (z-pos -99)
      (x 2176)
      (y 896)
    )
    (candle
      (burning #f)
      (z-pos -99)
      (x 1632)
      (y 1088)
    )
    (candle
      (name "candle1")
      (z-pos -99)
      (x 3232)
      (y 1216)
    )
    (corrupted_granito
      (type "skullyhop")
      (z-pos 50)
      (x 3697.087)
      (y 1865.505)
      (glinting #f)
    )
    (corrupted_granito
      (type "skullyhop")
      (z-pos 50)
      (x 3993.821)
      (y 1322.09)
      (glinting #f)
    )
    (corrupted_granito
      (type "skullyhop")
      (z-pos 50)
      (x 3503.089)
      (y 1353.203)
      (glinting #f)
    )
    (corrupted_granito
      (type "skullyhop")
      (z-pos 50)
      (x 2957.202)
      (y 1064.703)
      (glinting #f)
    )
    (corrupted_granito
      (type "skullyhop")
      (z-pos 50)
      (x 3989.578)
      (y 1061.875)
      (glinting #f)
    )
    (darttrap
      (type "skull")
      (z-pos -1)
      (initial-delay 0)
      (fire-delay 8)
      (ammo -1)
      (x 4080)
      (y 704)
      (dart-sprite "images/creatures/darttrap/granito/root_dart.sprite")
    )
    (darttrap
      (type "skull")
      (z-pos -1)
      (initial-delay 0)
      (fire-delay 8)
      (ammo -1)
      (x 4080)
      (y 752)
      (dart-sprite "images/creatures/darttrap/granito/root_dart.sprite")
    )
    (firefly
      (z-pos 0)
      (x 1727.767)
      (y 383.7921)
    )
    (firefly
      (z-pos 0)
      (x 3881.053)
      (y 1697.881)
    )
    (firefly
      (z-pos 0)
      (x 3439.104)
      (y 951.7267)
    )
    (firefly
      (z-pos 0)
      (x 4109.442)
      (y 616.5579)
    )
    (gradient
      (top_color 0 0 0.2)
      (bottom_color 0 0 0.6)
    )
    (igel
      (z-pos 50)
      (x 4610.396)
      (y 764.2979)
      (glinting #f)
    )
    (igel
      (z-pos 50)
      (x 5122.342)
      (y 762.8837)
      (glinting #f)
    )
    (jumpy
      (type "wooden")
      (z-pos 50)
      (x 6016)
      (y 768)
      (glinting #f)
    )
    (jumpy
      (type "wooden")
      (z-pos 50)
      (x 6496)
      (y 768)
      (glinting #f)
    )
    (jumpy
      (type "wooden")
      (z-pos 50)
      (x 3391.735)
      (y 1845.666)
      (glinting #f)
    )
    (jumpy
      (type "wooden")
      (z-pos 50)
      (x 448.9041)
      (y 379.5699)
      (glinting #f)
    )
    (jumpy
      (type "wooden")
      (z-pos 50)
      (x 2377.205)
      (y 2144.951)
      (glinting #f)
    )
    (jumpy
      (type "wooden")
      (z-pos 50)
      (x 1417.146)
      (y 2143.175)
      (glinting #f)
    )
    (mrbomb
      (z-pos 50)
      (x 1228.972)
      (y 401.0278)
      (glinting #f)
    )
    (mrbomb
      (z-pos 50)
      (x 1051.972)
      (y 432.0278)
      (glinting #f)
    )
    (mrbomb
      (z-pos 50)
      (x 879.9724)
      (y 401.0278)
      (glinting #f)
    )
    (mrbomb
      (z-pos 50)
      (x 1670.145)
      (y 1195.357)
      (glinting #f)
    )
    (mrbomb
      (z-pos 50)
      (x 3600.707)
      (y 1547.253)
      (glinting #f)
    )
    (mrbomb
      (z-pos 50)
      (x 3085.933)
      (y 1547.253)
      (glinting #f)
    )
    (mrbomb
      (z-pos 50)
      (x 2738.036)
      (y 912.2709)
      (glinting #f)
    )
    (music
      (file "music/darkforestkeep.ogg")
    )
    (path
      (name "gen1772935734109743288690576")
      (path
        (mode "oneshot")
        (adapt_speed #f)
        (node
          (x 2830.802)
          (y 1791.478)
        )
      )
    )
    (scripttrigger
      (script "candle1.set_burning(false);")
      (button #f)
      (width 32)
      (height 32)
      (x 3232)
      (y 1216)
    )
    (snail
      (z-pos 50)
      (x 2538.122)
      (y 2070.966)
      (glinting #f)
    )
    (snail
      (z-pos 50)
      (x 2948.244)
      (y 2073.088)
      (glinting #f)
    )
    (snail
      (z-pos 50)
      (x 3303.211)
      (y 2073.088)
      (glinting #f)
    )
    (snail
      (z-pos 50)
      (x 3639.794)
      (y 2075.916)
      (glinting #f)
    )
    (snail
      (z-pos 50)
      (x 4035.774)
      (y 2073.088)
      (glinting #f)
    )
    (snail
      (z-pos 50)
      (x 4355.386)
      (y 2071.674)
      (glinting #f)
    )
    (snail
      (z-pos 50)
      (x 4713.183)
      (y 2073.088)
      (glinting #f)
    )
    (snail
      (z-pos 50)
      (x 4951.112)
      (y 2072.637)
      (glinting #f)
    )
    (snail
      (z-pos 50)
      (x 5276.381)
      (y 2071.223)
      (glinting #f)
    )
    (snail
      (z-pos 50)
      (x 5562.053)
      (y 2074.051)
      (glinting #f)
    )
    (spawnpoint
      (name "main")
      (x 11.12378)
      (y 91.41498)
    )
    (spawnpoint
      (name "chute1")
      (x 1668.63)
      (y 1056.583)
    )
    (spawnpoint
      (x 5696)
      (y 768)
    )
    (tilemap
      (solid #f)
      (z-pos -100)
      (width 224)
      (height 80)
      (tiles -3388 0 1568 -9 0 1568 -209 0 174 -2 0 -2 174 -9 0 -2 174 -2 0 174 -205 0 173 -2 0 -2 173 -9 0 -2 173 -2 0 173 -205 0 -19 173 -882 0 1355 -13 0 1355 -40 0 1355 -8 0 1355 -6 0 1355 -8 0 1355 -6 0 1355 -24 0 1355 -6 0 1355 -8 0 1355 -6 0 1355 -88 0 1356 -13 0 1356 -40 0 1356 -6 0 1628 1629 1356 -6 0 1356 -8 0 1356 -6 0 1356 -15 0 1356 -8 0 1356 141 142 -4 0 1356 -8 0 1356 -6 0 1356 -88 0 1411 -13 0 1411 -40 0 1411 -6 0 1630 1631 1411 -6 0 1411 -8 0 1411 -6 0 1411 -8 0 1411 -6 0 1411 -8 0 1411 143 144 -4 0 1411 -8 0 1411 -6 0 1411 -686 0 174 -2 0 -2 174 -9 0 -2 174 -2 0 -2 174 -9 0 174 -194 0 173 -2 0 -2 173 -9 0 -2 173 -2 0 -2 173 -9 0 173 -194 0 -30 173 -323 0 1355 -2 0 1355 -220 0 1356 -2 0 1356 -220 0 1356 -2 0 1356 -220 0 1356 -2 0 1356 -1357 0 1355 -223 0 1356 -223 0 1356 -223 0 1356 -823 0 1355 -13 0 1355 -40 0 1355 -8 0 1355 -6 0 1355 -8 0 1355 -6 0 1355 -8 0 1355 -6 0 1355 -8 0 1355 -6 0 1355 -8 0 1355 -6 0 1355 -88 0 1356 -13 0 1356 -40 0 1356 -8 0 1356 -6 0 1356 141 142 -6 0 1356 -6 0 1356 -8 0 1356 -6 0 1356 -8 0 1356 -6 0 1356 -8 0 1356 -6 0 1356 -88 0 1411 -13 0 1411 -40 0 1411 -8 0 1411 -6 0 1411 143 144 -6 0 1411 -6 0 1411 -8 0 1411 -6 0 1411 -8 0 1411 -6 0 1411 -8 0 1411 -6 0 1411 -1526 0 1355 0 1355 -221 0 1356 0 1356 -221 0 1356 0 1356 -221 0 1356 0 1356 -648 0 1412 -160 0 1355 -40 0 1355 -4 0 1355 -6 0 1355 -8 0 1355 -6 0 1355 -8 0 1355 -6 0 1355 -8 0 1355 -6 0 1355 -8 0 1355 -6 0 1355 -8 0 1355 -6 0 1355 -90 0 1356 -40 0 1356 -4 0 1356 -6 0 1356 -8 0 1356 -6 0 1356 -8 0 1356 -6 0 1356 -3 0 1608 1609 -3 0 1356 -6 0 1356 -8 0 1356 -6 0 1356 -8 0 1356 -6 0 1356 -90 0 1411 -40 0 1411 -4 0 1411 -6 0 1411 -8 0 1411 -6 0 1411 -8 0 1411 -6 0 1411 -3 0 1610 1611 -3 0 1411 -6 0 1411 -8 0 1411 -6 0 1411 -8 0 1411 -6 0 1411 -566 0 1600 1601 -222 0 1602 1603 -2395 0)
    )
    (tilemap
      (solid #t)
      (z-pos 0)
      (width 224)
      (height 80)
      (tiles -51 1372 1373 -16 0 1404 -155 1372 -5 1376 1394 -45 1372 1373 -16 0 1404 -155 1372 -5 0 1374 1394 -44 1372 1373 -16 0 1404 -155 1372 -6 0 1374 1394 -43 1372 1373 -16 0 1404 -155 1372 -7 0 1374 1394 -42 1372 1373 128 -15 0 1404 -155 1372 -8 0 1374 -5 1376 1394 -36 1372 1373 -16 0 1374 1394 -154 1372 1401 1403 -12 0 1374 1394 -35 1372 1373 -17 0 1404 -155 1372 1383 1403 -12 0 1374 1394 -7 1372 1406 -2 1376 1394 -11 1372 1406 -2 1376 1394 -8 1372 1373 -16 0 1378 1371 -156 1372 1383 1392 -12 0 1374 1394 -6 1372 1373 -2 0 1404 -11 1372 1373 -2 0 1404 -8 1372 1383 1380 -15 0 1404 -158 1372 1383 1403 -12 0 1374 -5 1376 1414 1388 -2 0 1408 1413 -9 1376 1414 1388 -2 0 1408 1413 -8 1376 1414 1388 -14 0 1404 -159 1372 1383 -5 1401 1403 -43 0 112 -13 0 1404 -165 1372 1383 1392 -56 0 1404 -13 1372 1406 -12 1376 1394 -2 1372 1406 -12 1376 1394 -2 1372 1406 -12 1376 1394 -2 1372 1406 -12 1376 1394 -2 1372 1406 -12 1376 1394 -2 1372 1406 -11 1376 1386 1394 -59 1372 1383 1403 -55 0 1404 -13 1372 1373 -12 0 1404 -2 1372 1373 -12 0 1404 -2 1372 1373 -12 0 1404 -2 1372 1373 -12 0 1404 -2 1372 1373 -12 0 1404 -2 1372 1373 -12 0 1404 -43 1372 1406 -4 1376 -12 1372 1383 1403 -6 0 1568 -24 0 -2 1568 -21 0 1404 -13 1372 1373 -12 0 1404 -2 1372 1373 -12 0 1404 -2 1372 1373 -12 0 1404 -2 1372 1373 -12 0 1404 -2 1372 1373 -12 0 1404 -2 1372 1373 -12 0 1404 -42 1372 1406 1377 -3 0 132 -13 1372 1383 -10 1401 1384 -2 0 1370 1384 -9 0 1370 1384 -2 0 1370 -4 1401 -6 1368 1416 1412 1388 -12 0 1404 -13 1372 1373 -12 0 1404 -2 1372 1373 -12 0 1404 -2 1372 1373 -12 0 1404 -2 1372 1373 -12 0 1404 -2 1372 1373 -12 0 1404 -2 1372 1373 -12 0 1404 -41 1372 1406 1377 -4 0 132 -24 1372 1373 -2 0 1404 1373 -4 0 1568 -4 0 1404 1373 -2 0 1404 -9 1372 1406 1377 -14 0 1404 -13 1372 1373 -11 0 44 1404 -2 1372 1373 -12 0 1404 -2 1372 1373 -12 0 1404 -2 1372 1373 -12 0 1404 -2 1372 1373 -12 0 1404 -2 1372 1373 -12 0 1404 -40 1372 1406 1377 -5 0 132 -24 1372 1373 -2 174 1404 1373 -9 174 1404 1373 -2 174 1404 -8 1372 1406 1377 -15 0 1404 -13 1372 1373 -10 0 -2 44 1404 -2 1372 1373 -12 0 1404 -2 1372 1373 -13 0 -2 1372 1373 -12 0 1404 -2 1372 1373 -12 0 1404 -2 1372 1373 -12 0 1404 -33 1372 1406 -6 1376 1377 -6 0 132 -24 1372 1373 -2 173 1404 1373 -9 173 1404 1373 -2 173 1404 -8 1372 1373 -16 0 1404 -13 1372 1373 -9 0 -3 44 1404 -2 1372 1373 -12 0 1404 -2 1372 1373 -13 0 -2 1372 -13 0 1404 -2 1372 1373 -12 0 1404 -2 1372 1373 -12 0 1404 -3 1372 1406 -2 1376 1394 -11 1372 1406 -2 1376 1394 -10 1372 1406 1377 -4 0 133 -8 0 1367 -24 1372 1383 -2 1402 1371 1383 -9 1402 1371 1383 -2 1402 1371 -8 1372 1373 -16 0 1404 -13 1372 1373 -3 44 -5 0 -4 44 1404 -2 1372 1373 -2 44 -8 0 -2 44 1404 -2 1372 1373 -2 44 -24 0 -2 44 1404 -2 1372 1373 -2 44 -8 0 -2 44 1404 -2 1372 1373 -2 44 -8 0 -2 44 1404 -3 1372 1373 -2 0 1404 -11 1372 1373 -2 0 1404 -9 1372 1406 1377 -5 0 133 -7 0 1367 1371 -51 1372 1373 -16 0 1404 -13 1372 1383 1368 1379 1384 -6 0 1400 -2 1368 1371 -2 1372 1383 1368 1379 1384 -6 0 1400 -2 1368 1371 -2 1372 1383 -2 1368 1384 -22 0 1400 -2 1368 1371 -2 1372 1383 1368 1379 1384 -6 0 1400 -2 1368 1371 -2 1372 1383 1368 1379 1384 -6 0 1400 -2 1368 1371 -3 1372 1373 -2 0 1404 -4 1372 1406 1376 1394 -4 1372 1373 -2 0 1404 -4 1372 1406 1376 1394 1372 1406 1377 -6 0 133 -6 0 1367 1371 -52 1372 1373 -16 0 1404 -16 1372 1381 1388 -4 0 1408 1396 -8 1372 1381 1388 -4 0 1408 1396 -8 1372 1381 1388 -20 0 1408 1396 -8 1372 1381 1388 -4 0 1408 1396 -8 1372 1381 1388 -4 0 1408 1396 -2 1372 1406 -3 1376 1407 -2 0 1393 -4 1376 1407 0 1393 -4 1376 1407 -2 0 1393 -4 1376 1407 0 1393 1376 1377 -7 0 133 -5 0 1367 1371 -15 1372 1406 -36 1376 1394 1373 -16 0 1404 1406 -2 1376 1375 -12 1376 1377 -6 0 1374 -8 1376 1377 -6 0 1374 -5 1376 1387 1386 1387 1377 -22 0 1374 -8 1376 1377 -6 0 1374 -8 1376 1377 -6 0 1374 -2 1376 1377 -37 0 1400 -6 1368 1371 -16 1372 1373 -36 0 1397 1407 -16 0 1397 1407 -58 0 -2 1372 1373 0 102 83 -78 0 1367 1371 -23 1372 1383 1403 -56 0 -2 44 -55 0 -2 1372 1373 -13 0 -2 44 -14 0 -2 44 -49 0 1367 1371 -25 1372 1383 1392 -34 0 1367 1384 -16 0 1367 1384 -21 0 301 -2 302 303 -33 0 -2 1372 1373 -9 0 301 -3 302 303 -65 0 1367 1371 -27 1372 1383 -34 1368 1371 1373 -16 0 1404 1383 -16 1368 1384 -4 0 1367 -10 1368 1384 -4 0 1367 -10 1368 1384 -4 0 1367 -10 1368 1384 -4 0 1367 -10 1368 1384 -4 0 1367 -10 1368 1384 -4 0 1367 -5 1368 -2 1401 1384 -2 0 1370 1384 -9 0 1370 1384 -2 0 1370 1384 -9 0 1367 1368 1371 -64 1372 1373 -16 0 1404 -16 1372 1406 1377 -4 0 1374 1394 -8 1372 1406 1377 -4 0 1374 1394 -8 1372 1406 1377 -4 0 1374 1394 -8 1372 1406 1377 -4 0 1374 1394 -8 1372 1406 1377 -4 0 1374 1394 -8 1372 1406 1377 -4 0 1374 1394 -6 1372 1373 -2 0 1404 1373 -4 0 1568 -4 0 1404 1373 -2 0 1404 1373 -4 0 1568 -4 0 1404 -65 1372 1406 1410 -16 0 1397 1394 -12 1372 1406 -2 1376 1377 -6 0 1374 -2 1376 1394 -2 1372 1406 -2 1376 1377 -6 0 1374 -2 1376 1394 -2 1372 1406 -2 1376 1377 -6 0 1374 -2 1376 1394 -2 1372 1406 -2 1376 1377 -6 0 1374 -2 1376 1394 -2 1372 1406 -2 1376 1377 -6 0 1374 -2 1376 1394 -2 1372 1406 -2 1376 1377 -6 0 1374 -2 1376 1394 -3 1372 1373 -2 174 1404 1373 -9 174 1404 1373 -2 174 1404 1373 -9 174 1404 -65 1372 1373 -18 0 1404 -12 1372 1373 -12 0 1404 -2 1372 1373 -12 0 1404 -2 1372 1373 -12 0 1404 -2 1372 1373 -12 0 1404 -2 1372 1373 -12 0 1404 -2 1372 1373 -12 0 1404 -3 1372 1373 -2 173 1404 1373 -9 173 1404 1373 -2 173 1404 1373 -9 173 1404 -65 1372 1383 1380 -16 0 1370 1371 -12 1372 1373 -12 0 1404 1372 1394 1373 -12 0 1404 -2 1372 1373 -12 0 1404 -2 1372 1373 -12 0 1404 -2 1372 1373 -12 0 1404 -2 1372 1373 -12 0 1404 -3 1372 1383 -2 1402 1371 1383 -9 1402 1371 1383 -2 1402 1371 1383 -9 1402 1371 -65 1372 1406 1410 -16 0 1397 1394 -12 1372 1373 1408 -4 1412 1388 -6 0 1404 -2 1372 -13 0 1404 -2 1372 1373 -12 0 1404 -2 1372 1373 -12 0 1404 -2 1372 1373 -12 0 1404 -2 1372 1373 -12 0 1404 -98 1372 1373 -18 0 1404 -12 1372 1373 -28 0 1404 -2 1372 1373 44 -11 0 1404 -2 1372 1373 -12 0 1404 -2 1372 1373 -12 0 1404 -2 1372 1373 -12 0 1404 -98 1372 1383 1380 -16 0 1370 1371 -12 1372 1373 -24 0 83 102 83 0 1404 -2 1372 1373 -2 44 -10 0 1404 -2 1372 1373 -11 0 44 1404 -2 1372 1373 -12 0 1404 -2 1372 1373 -12 0 1404 -98 1372 1406 1410 -16 0 1397 1394 -12 1372 1373 -14 0 1372 1373 -12 0 1404 -2 1372 1373 -2 44 1568 -9 0 1404 -2 1372 1373 -10 0 -2 44 1404 -2 1372 1373 -2 44 -10 0 1404 -2 1372 1373 44 -10 0 44 1404 -98 1372 1373 -18 0 1404 -12 1372 1373 -12 0 1404 -2 1372 1373 -12 0 1404 -2 1372 1373 44 -3 1568 -7 0 1568 1404 -2 1372 1373 -9 0 -2 1568 44 1404 -2 1372 1373 -3 44 -6 0 -2 1568 0 1404 -2 1372 1373 -2 44 1568 -7 0 -2 44 1404 -98 1372 1383 1380 -16 0 1370 1371 -12 1372 1383 1368 1379 1368 1416 1388 -2 0 1408 1415 -4 1368 -2 1372 1383 1368 -6 0 1408 1415 -3 1368 1371 -2 1372 1383 1368 1379 1368 1416 1388 -2 0 1408 1415 -3 1368 1371 -2 1372 1383 1368 1379 1368 1416 1388 -2 0 1408 1415 -3 1368 1371 -2 1372 1383 1368 1379 1368 1416 1388 -2 0 1408 1415 -3 1368 1371 -2 1372 1383 1368 1379 1368 1416 1388 -2 0 1408 1415 -3 1368 1371 -99 1372 1373 -16 0 1404 -13 1372 1406 -3 1376 1377 -4 0 1374 -3 1376 1394 -2 1372 1406 -2 1376 -6 0 1374 -2 1376 1386 1394 -2 1372 1406 -3 1376 1377 -4 0 1374 -2 1376 1386 1394 -2 1372 1406 -3 1376 1377 -4 0 1374 -2 1376 1386 1394 -2 1372 1406 -3 1376 1377 -4 0 1374 -2 1376 1386 1394 -2 1372 1406 -3 1376 1377 -4 0 1374 -2 1376 1386 1394 -99 1372 1373 -16 0 1404 -13 1372 1373 -12 0 1404 -2 1372 1373 -12 0 1404 -2 1372 1373 -12 0 1404 -2 1372 1373 -12 0 1404 -2 1372 1373 -12 0 1404 -2 1372 1373 -12 0 1404 -99 1372 1373 -16 0 1404 -13 1372 1373 -12 0 1404 -2 1372 1373 -12 0 1404 1372 1394 1373 -12 0 1404 -2 1372 1373 -12 0 1404 -2 1372 1373 -12 0 1404 -2 1372 1373 -12 0 1404 -99 1372 1383 1416 1388 -14 0 1404 1372 1405 -11 1372 1373 -12 0 1404 -2 1372 1373 -2 0 1568 -9 0 1404 1372 -14 0 1404 -2 1372 1373 -12 0 1404 -2 1372 1373 -12 0 1404 -2 1372 1373 -12 0 1404 -99 1372 1406 1377 -15 0 1404 -13 1372 1373 -12 0 1404 -2 1372 1373 -28 0 1404 -2 1372 1373 -12 0 1404 -2 1372 1373 -12 0 1404 -2 1372 1373 -12 0 1404 -99 1372 1373 -16 0 1404 -13 1372 1373 -12 0 1404 -2 1372 1373 -28 0 1404 -2 1372 1373 -12 0 1404 -2 1372 1373 -12 0 1404 -2 1372 1373 1568 -11 0 1404 -99 1372 1373 -16 0 1404 -13 1372 1373 -2 1568 -9 0 44 1404 -2 1372 1373 1568 -13 0 1372 1373 -11 0 1568 1404 -2 1372 1373 -11 0 44 1404 -2 1372 1373 -11 0 1568 1404 -2 1372 1373 -2 1568 -10 0 1404 -99 1372 1373 -16 0 1404 -13 1372 1373 -3 1568 -7 0 -2 44 1404 -2 1372 1373 -2 1568 -7 0 1568 -2 0 1404 -2 1372 1373 -2 44 -8 0 -2 1568 1404 -2 1372 1373 -10 0 1568 44 1404 -2 1372 1373 -10 0 -2 1568 1404 -2 1372 1373 -3 1568 -9 0 1404 -99 1372 1373 -16 0 1404 -13 1372 1383 1368 1379 1384 1568 -5 0 1400 -2 1368 1371 -2 1372 1383 1368 1379 1384 1568 -4 0 1568 1400 -2 1368 1371 -2 1372 1383 1368 1379 1384 -6 0 1400 -2 1368 1371 -2 1372 1383 1368 1379 1384 -6 0 1400 -2 1368 1371 -2 1372 1383 1368 1379 1384 -6 0 1400 -2 1368 1371 -2 1372 1383 1368 1379 1384 1568 -5 0 1400 -2 1368 1371 -99 1372 1373 -16 0 1404 -16 1372 1381 1388 -4 0 1408 1396 -8 1372 1381 1388 -4 0 1408 1396 -8 1372 1381 1388 -4 0 1408 1396 -8 1372 1381 1388 -4 0 1408 1396 -8 1372 1381 1388 -4 0 1408 1396 -8 1372 1381 1388 -4 0 1408 1396 -66 1372 1406 -34 1376 1394 1373 -16 0 1404 1406 -15 1376 1377 -6 0 1374 -8 1376 1377 -6 0 1374 -8 1376 1377 -6 0 1374 -8 1376 1377 -6 0 1374 -8 1376 1377 -6 0 1374 -8 1376 1377 -6 0 1374 -4 1376 1394 -61 1372 1373 -34 0 1397 1407 -16 0 1397 1407 -59 0 -2 1568 -46 0 1404 -61 1372 1383 1369 -54 0 -2 44 -23 0 -2 44 -14 0 -2 44 -14 0 -3 1568 -13 0 -2 44 -14 0 -2 44 -15 0 1404 -62 1372 1383 1380 -32 0 1367 1384 -16 0 1367 1384 -4 44 -27 0 301 303 -24 0 -5 1568 -44 0 1568 1404 -62 1372 1394 1383 -32 1368 1371 1373 -16 0 1404 1383 -16 1368 1384 -4 0 1367 -10 1368 1384 -4 0 1367 -10 1368 1369 -4 0 1367 -10 1368 1369 -4 0 1367 -10 1368 1369 -4 0 1367 -10 1368 1369 -4 0 1367 -5 1368 1371 -97 1372 1373 -16 0 1404 -16 1372 1406 1377 -4 0 1374 1394 -8 1372 1406 1377 -4 0 1374 1394 -8 1372 1406 1377 -4 0 1374 1394 -8 1372 1406 1377 -4 0 1374 1394 -8 1372 1406 1377 -4 0 1374 1394 -8 1372 1406 1377 -4 0 1374 1394 -102 1372 1373 -16 0 1404 -13 1372 1406 -2 1376 1377 -6 0 1374 -2 1376 1394 -2 1372 1406 -2 1376 1377 -6 0 1397 -2 1376 1394 -2 1372 1406 -2 1376 1377 -6 0 1397 -2 1376 1394 -2 1372 1406 -2 1376 1377 -6 0 1397 -2 1376 1394 -2 1372 1406 -2 1376 1377 -6 0 1397 -2 1376 1394 -2 1372 1406 -2 1376 1377 -6 0 1397 -2 1376 1394 -99 1372 1373 -16 0 1404 -13 1372 1373 -12 0 1404 -2 1372 1373 -12 0 1404 -2 1372 1373 -12 0 1404 -2 1372 1373 -12 0 1404 -2 1372 1373 -12 0 1404 -2 1372 1373 -12 0 1404 -99 1372 1373 -16 0 1404 -13 1372 1373 -12 0 1404 -2 1372 1373 -12 0 1404 1372 1394 1373 -12 0 1404 -2 1372 1373 -12 0 1404 -2 1372 1373 -12 0 1404 -2 1372 1373 -12 0 1404 -98 1372 1406 1377 -16 0 1374 1394 -12 1372 1373 -12 0 1404 -2 1372 1373 -13 0 -2 1372 1373 -7 0 1408 -3 1412 1388 1404 -2 1372 1373 -12 0 1404 -2 1372 1373 -12 0 1404 -2 1372 1373 -12 0 1404 -96 1372 1406 1376 1407 -18 0 1374 1376 1394 -10 1372 1373 -12 0 1404 -2 1372 1373 -28 0 1404 -2 1372 1373 -12 0 1404 -2 1372 1373 -12 0 1404 -2 1372 1373 -12 0 1404 -93 1372 1406 -2 1376 1407 -22 0 1374 1376 1375 1394 -7 1372 1373 0 83 102 83 -7 0 44 1404 -2 1372 1373 0 -2 83 -25 0 1404 -2 1372 1373 -12 0 1404 -2 1372 1373 -12 0 1404 -2 1372 1373 44 -10 0 44 1404 -91 1372 1406 1376 1407 -28 0 1374 1394 -6 1372 1373 -9 0 -3 44 1404 -2 1372 1373 -12 0 1404 -2 1372 -13 0 1404 -2 1372 1373 44 -10 0 44 1404 -2 1372 1373 -12 0 1404 -2 1372 1373 -2 44 -8 0 -2 44 1404 -90 1372 1406 1377 -31 0 1374 1394 -5 1372 1373 -8 0 44 -2 1568 44 1404 -2 1372 1373 -12 0 1404 -2 1372 1373 -12 0 1404 -2 1372 1373 1568 44 -7 0 -2 1568 44 1404 -2 1372 1373 -2 0 1568 -8 0 1568 1404 -2 1372 1373 -3 44 -6 0 -2 1568 44 1404 -89 1372 1406 1377 -33 0 1374 1394 -4 1372 1383 -3 1368 1416 1388 -2 0 1408 1415 -3 1368 1371 -2 1372 1383 -3 1368 1416 -3 0 1408 1415 -3 1368 1371 -2 1372 1383 -3 1368 1416 1388 -2 0 1408 1415 -3 1368 1371 -2 1372 1383 -3 1368 1416 1388 -2 0 1408 1415 -3 1368 1371 -2 1372 1383 -3 1368 1416 1388 -2 0 1408 1415 -3 1368 1371 -2 1372 1383 -3 1368 1416 1388 -2 0 1408 1415 -3 1368 1371 -88 1372 1406 1377 -35 0 1374 1394 -7 1372 1373 -4 0 1404 -8 1372 1395 1372 1373 -4 0 1404 -10 1372 1373 -4 0 1404 -10 1372 1373 -4 0 1404 -10 1372 1373 -4 0 1404 -10 1372 1373 -4 0 1404 -81 1372 1406 -10 1376 1377 -37 0 1374 -6 1376 1386 1399 -4 0 1397 -9 1376 1386 1399 1388 -3 0 1397 -9 1376 1386 1399 -4 0 1397 -9 1376 1386 1399 -4 0 1397 -9 1376 1386 1399 -4 0 1397 -9 1376 1386 1399 -4 0 1397 -35 1376 1394 -45 1372 1373 -152 0 -2 1568 -23 0 1404 -45 1372 1373 -2 0 -4 44 -145 0 -3 1568 -23 0 1404 -45 1372 1383 1392 -149 0 -5 1568 -21 201 1370 1371 -46 1372 1383 -9 1368 1380 -37 0 1367 -127 1368 1396 -57 1372 1383 1380 -36 0 1404 -186 1372 1373 -36 0 1404 -186 1372 1373 -2 0 1367 1384 -28 0 1367 1384 -2 0 1404 -186 1372 1373 -2 0 1404 1383 -12 1368 1392 -2 0 1400 -12 1368 1371 1373 -2 0 1404 -186 1372 1373 -2 0 1404 -13 1372 1383 -2 1368 1371 -13 1372 1373 -2 0 1404 -186 1372 1373 -2 0 1404 -16 1372 1405 -13 1372 1373 -2 0 1404 -186 1372 1373 -2 0 1404 -30 1372 1373 -2 0 1404 -186 1372 1373 -2 0 1404 -30 1372 1373 -2 0 1404 -186 1372 1373 -2 0 1404 -30 1372 1373 -2 0 1404 -186 1372 1373 -2 0 1404 -30 1372 1373 -2 0 1404 -186 1372 1373 -2 0 1404 -30 1372 1373 -2 0 1404 -186 1372 1373 -2 0 1404 -30 1372 1373 -2 0 1404 -186 1372 1373 -2 0 1404 -30 1372 1373 -2 0 1404 -145 1372)
    )
    (tilemap
      (solid #f)
      (z-pos 100)
      (width 224)
      (height 80)
      (tiles -14560 0 -224 201 -3136 200)
    )
    (unstable_tile
      (sprite "images/objects/unstable_tile/castleblock.sprite")
      (z-pos 0)
      (x 928)
      (y 480)
    )
    (unstable_tile
      (sprite "images/objects/unstable_tile/castleblock.sprite")
      (z-pos 0)
      (x 5888)
      (y 832)
    )
    (unstable_tile
      (sprite "images/objects/unstable_tile/castleblock.sprite")
      (z-pos 0)
      (x 960)
      (y 480)
    )
    (unstable_tile
      (sprite "images/objects/unstable_tile/castleblock.sprite")
      (z-pos 0)
      (x 992)
      (y 480)
    )
    (unstable_tile
      (sprite "images/objects/unstable_tile/castleblock.sprite")
      (z-pos 0)
      (x 1024)
      (y 480)
    )
    (unstable_tile
      (sprite "images/objects/unstable_tile/castleblock.sprite")
      (z-pos 0)
      (x 1184)
      (y 480)
    )
    (unstable_tile
      (sprite "images/objects/unstable_tile/castleblock.sprite")
      (z-pos 0)
      (x 1088)
      (y 480)
    )
    (unstable_tile
      (sprite "images/objects/unstable_tile/castleblock.sprite")
      (z-pos 0)
      (x 1120)
      (y 480)
    )
    (unstable_tile
      (sprite "images/objects/unstable_tile/castleblock.sprite")
      (z-pos 0)
      (x 1152)
      (y 480)
    )
    (unstable_tile
      (sprite "images/objects/unstable_tile/castleblock.sprite")
      (z-pos 0)
      (x 6144)
      (y 832)
    )
    (unstable_tile
      (sprite "images/objects/unstable_tile/castleblock.sprite")
      (z-pos 0)
      (x 5952)
      (y 832)
    )
    (unstable_tile
      (sprite "images/objects/unstable_tile/castleblock.sprite")
      (z-pos 0)
      (x 5920)
      (y 832)
    )
    (unstable_tile
      (sprite "images/objects/unstable_tile/castleblock.sprite")
      (z-pos 0)
      (x 5984)
      (y 832)
    )
    (unstable_tile
      (sprite "images/objects/unstable_tile/castleblock.sprite")
      (z-pos 0)
      (x 6560)
      (y 832)
    )
    (unstable_tile
      (sprite "images/objects/unstable_tile/castleblock.sprite")
      (z-pos 0)
      (x 6048)
      (y 832)
    )
    (unstable_tile
      (sprite "images/objects/unstable_tile/castleblock.sprite")
      (z-pos 0)
      (x 6112)
      (y 832)
    )
    (unstable_tile
      (sprite "images/objects/unstable_tile/castleblock.sprite")
      (z-pos 0)
      (x 6080)
      (y 832)
    )
    (unstable_tile
      (sprite "images/objects/unstable_tile/castleblock.sprite")
      (z-pos 0)
      (x 6368)
      (y 832)
    )
    (unstable_tile
      (sprite "images/objects/unstable_tile/castleblock.sprite")
      (z-pos 0)
      (x 6400)
      (y 832)
    )
    (unstable_tile
      (sprite "images/objects/unstable_tile/castleblock.sprite")
      (z-pos 0)
      (x 6528)
      (y 832)
    )
    (unstable_tile
      (sprite "images/objects/unstable_tile/castleblock.sprite")
      (z-pos 0)
      (x 6432)
      (y 832)
    )
    (unstable_tile
      (sprite "images/objects/unstable_tile/castleblock.sprite")
      (z-pos 0)
      (x 6592)
      (y 832)
    )
    (unstable_tile
      (sprite "images/objects/unstable_tile/castleblock.sprite")
      (z-pos 0)
      (x 6624)
      (y 832)
    )
    (unstable_tile
      (sprite "images/objects/unstable_tile/castleblock.sprite")
      (z-pos 0)
      (x 6464)
      (y 832)
    )
    (weak_block
      (type "hay")
      (z-pos 60)
      (x 2624)
      (y 1568)
    )
    (weak_block
      (type "hay")
      (z-pos 60)
      (x 2752)
      (y 576)
    )
    (weak_block
      (type "hay")
      (z-pos 60)
      (x 2592)
      (y 1568)
    )
    (weak_block
      (type "hay")
      (z-pos 60)
      (x 2624)
      (y 1536)
    )
    (weak_block
      (type "hay")
      (z-pos 60)
      (x 2912)
      (y 608)
    )
    (weak_block
      (type "hay")
      (z-pos 60)
      (x 2752)
      (y 608)
    )
    (willowisp
      (z-pos 150)
      (path-ref "gen1772935734109743288690576")
      (adapt-speed #f)
      (handle
        (scale_x 0)
        (scale_y 0)
        (offset_x 0)
        (offset_y 0)
      )
      (sector "main")
      (spawnpoint "chute1")
      (color 0 1 0)
    )
  )
)
