(supertux-level
  (version 3)
  (name (_ "A Mouldy Grotto"))
  (author "Christoph Sommer")
  (license "GPL 2+ / CC-by-sa 3.0")
  (allow-item-pocket "inherit")
  (icon "")
  (icon-locked "")
  (statistics
    (enable-coins #t)
    (enable-secrets #t)
  )
  (sector
    (name "main")
    (ambient-light
      (color 1 1 1)
    )
    (background
      (color 1 1 1)
      (speed 0.8)
      (image "images/background/BlueRock_Forest/blue-top.jpg")
    )
    (camera
      (name "Camera")
      (mode "normal")
    )
    (firefly
      (z-pos 0)
      (x 1533)
      (y 1768)
    )
    (firefly
      (z-pos 0)
      (x 1194)
      (y 1439)
    )
    (firefly
      (z-pos 0)
      (x 3728)
      (y 640)
    )
    (igel
      (z-pos 50)
      (x 784)
      (y 1456)
      (glinting #f)
    )
    (jumpy
      (type "wooden")
      (z-pos 50)
      (x 894)
      (y 2713)
      (glinting #f)
    )
    (jumpy
      (type "wooden")
      (z-pos 50)
      (x 1232)
      (y 2560)
      (glinting #f)
    )
    (jumpy
      (type "wooden")
      (z-pos 50)
      (x 848)
      (y 1952)
      (glinting #f)
    )
    (jumpy
      (type "wooden")
      (z-pos 50)
      (x 1105)
      (y 853)
      (glinting #f)
    )
    (jumpy
      (type "wooden")
      (z-pos 50)
      (x 1157)
      (y 1864)
      (glinting #f)
    )
    (jumpy
      (type "wooden")
      (z-pos 50)
      (x 1514)
      (y 890)
      (glinting #f)
    )
    (mrbomb
      (z-pos 50)
      (x 1656)
      (y 1906)
      (glinting #f)
    )
    (mrtree
      (z-pos 50)
      (x 3408)
      (y 640)
      (glinting #f)
    )
    (mrtree
      (z-pos 50)
      (x 1935)
      (y 680)
      (glinting #f)
    )
    (mrtree
      (z-pos 50)
      (x 5296)
      (y 640)
      (glinting #f)
    )
    (music
      (file "music/cave.music")
    )
    (particles-clouds
    )
    (path
      (name "gen17730103092845995073424")
      (path
        (adapt_speed #f)
        (node
          (x 4256)
          (y 672)
          (time 5)
        )
        (node
          (x 4256)
          (y 576)
          (time 5)
        )
      )
    )
    (path
      (name "gen17730103092845995071248")
      (path
        (adapt_speed #f)
        (node
          (x 4544)
          (y 800)
          (time 3)
        )
        (node
          (x 4544)
          (y 704)
          (time 3)
        )
      )
    )
    (path
      (name "gen17730103092845995072880")
      (path
        (adapt_speed #f)
        (node
          (x 3968)
          (y 800)
          (time 4)
        )
        (node
          (x 3968)
          (y 704)
          (time 4)
        )
      )
    )
    (path
      (name "gen17730103092845995070704")
      (path
        (adapt_speed #f)
        (node
          (x 1408)
          (y 2656)
          (time 2)
        )
        (node
          (x 1408)
          (y 2304)
          (time 2)
        )
        (node
          (x 1408)
          (y 2304)
          (time 2)
        )
      )
    )
    (path
      (name "gen17730103092845995071792")
      (path
        (adapt_speed #f)
        (node
          (x 512)
          (y 1888)
          (time 2)
        )
        (node
          (x 512)
          (y 1536)
          (time 2)
        )
        (node
          (x 512)
          (y 1536)
          (time 2)
        )
      )
    )
    (path
      (name "gen17730103092845995070976")
      (path
        (adapt_speed #f)
        (node
          (x 2560)
          (y 1920)
          (time 3)
        )
        (node
          (x 2560)
          (y 1280)
          (time 2)
        )
        (node
          (x 2560)
          (y 1280)
          (time 3)
        )
      )
    )
    (path
      (name "gen17730103092845995072064")
      (path
        (adapt_speed #f)
        (node
          (x 1472)
          (y 1472)
        )
        (node
          (x 1472)
          (y 1408)
        )
        (node
          (x 1472)
          (y 1408)
        )
        (node
          (x 1472)
          (y 1376)
        )
        (node
          (x 1472)
          (y 1376)
        )
        (node
          (x 1472)
          (y 1344)
        )
        (node
          (x 1472)
          (y 1344)
        )
      )
    )
    (path
      (name "gen17730103092846001427184")
      (path
        (adapt_speed #f)
        (node
          (x 1824)
          (y 1792)
        )
      )
    )
    (path
      (name "gen17730103092846001427728")
      (path
        (mode "oneshot")
        (adapt_speed #f)
        (node
          (x 1040)
          (y 1248)
        )
      )
    )
    (path
      (name "gen17730103092846001427456")
      (path
        (mode "oneshot")
        (adapt_speed #f)
        (node
          (x 688)
          (y 2192)
        )
      )
    )
    (platform
      (z-pos 50)
      (handle
        (scale_x 0)
        (scale_y 0)
        (offset_x 0)
        (offset_y 0)
      )
      (path-ref "gen17730103092845995073424")
    )
    (platform
      (z-pos 50)
      (handle
        (scale_x 0)
        (scale_y 0)
        (offset_x 0)
        (offset_y 0)
      )
      (path-ref "gen17730103092845995071248")
    )
    (platform
      (z-pos 50)
      (handle
        (scale_x 0)
        (scale_y 0)
        (offset_x 0)
        (offset_y 0)
      )
      (path-ref "gen17730103092845995072880")
    )
    (platform
      (z-pos 50)
      (handle
        (scale_x 0)
        (scale_y 0)
        (offset_x 0)
        (offset_y 0)
      )
      (running #f)
      (name "lift1")
      (path-ref "gen17730103092845995070704")
      (sprite "images/objects/platforms/big.sprite")
    )
    (platform
      (z-pos 50)
      (handle
        (scale_x 0)
        (scale_y 0)
        (offset_x 0)
        (offset_y 0)
      )
      (running #f)
      (name "lift2")
      (path-ref "gen17730103092845995071792")
      (sprite "images/objects/platforms/big.sprite")
    )
    (platform
      (z-pos 50)
      (handle
        (scale_x 0)
        (scale_y 0)
        (offset_x 0)
        (offset_y 0)
      )
      (running #f)
      (name "lift3")
      (path-ref "gen17730103092845995070976")
      (sprite "images/objects/platforms/big.sprite")
    )
    (platform
      (z-pos 50)
      (handle
        (scale_x 0)
        (scale_y 0)
        (offset_x 0)
        (offset_y 0)
      )
      (running #f)
      (name "lift4")
      (path-ref "gen17730103092845995072064")
      (sprite "images/objects/platforms/big.sprite")
    )
    (scripttrigger
      (script "lift3.goto_node(1);
lift3.goto_node(0);")
      (button #f)
      (width 96)
      (height 32)
      (x 2592)
      (y 1888)
    )
    (scripttrigger
      (script "lift1.goto_node(1);
lift1.goto_node(0);")
      (button #f)
      (width 96)
      (height 32)
      (x 1440)
      (y 2624)
    )
    (scripttrigger
      (script "lift4.goto_node(1);
lift4.goto_node(0);")
      (button #f)
      (width 96)
      (height 32)
      (x 1504)
      (y 1440)
    )
    (scripttrigger
      (script "lift2.goto_node(1);
lift2.goto_node(0);")
      (button #f)
      (width 96)
      (height 32)
      (x 512)
      (y 1856)
    )
    (secretarea
      (fade-tilemap "secret1")
      (width 1120.507)
      (height 1084.175)
      (x 1844)
      (y 847.5534)
    )
    (sequencetrigger
      (sequence "endsequence")
      (width 444)
      (height 220)
      (x 5952)
      (y 512)
    )
    (sequencetrigger
      (sequence "stoptux")
      (width 72)
      (height 220)
      (x 6324)
      (y 512)
    )
    (snail
      (z-pos 50)
      (x 972)
      (y 1972)
      (glinting #f)
    )
    (spawnpoint
      (name "main")
      (x 128)
      (y 2208)
    )
    (spawnpoint
      (name "wow1")
      (x 1040)
      (y 1248)
    )
    (spawnpoint
      (name "wow2")
      (x 688)
      (y 2192)
    )
    (tilemap
      (solid #f)
      (z-pos -150)
      (width 200)
      (height 100)
      (tiles -95 1353 -105 0 -95 1353 -105 0 -95 1353 -105 0 -95 1353 -105 0 -95 1353 -105 0 -95 1353 -105 0 -95 1353 -105 0 -95 1353 -105 0 -95 1353 -105 0 -95 1353 -105 0 -95 1353 -105 0 -95 1353 -105 0 -95 1353 -105 0 -95 1353 -105 0 -95 1353 -105 0 -95 1353 -105 0 -95 1353 -105 0 -94 1353 -106 0 -93 1353 2012 -106 0 -93 1353 2012 -106 0 -93 1353 2012 -106 0 -93 1353 2013 -106 0 -94 1353 -20 0 212 -85 0 -94 1353 -106 0 -95 1353 -105 0 -95 1353 -105 0 -95 1353 -105 0 -95 1353 -105 0 -95 1353 -105 0 -95 1353 -105 0 -95 1353 -105 0 -95 1353 -105 0 -95 1353 -105 0 -95 1353 -105 0 -95 1353 -105 0 -95 1353 -105 0 -95 1353 -105 0 -95 1353 -105 0 -95 1353 -105 0 -95 1353 -105 0 -95 1353 -105 0 -95 1353 -105 0 -95 1353 -105 0 -95 1353 -105 0 -95 1353 -105 0 -95 1353 -105 0 -95 1353 -105 0 -95 1353 -105 0 -95 1353 -105 0 -95 1353 -105 0 -95 1353 -105 0 -95 1353 -105 0 -95 1353 -105 0 -95 1353 -105 0 -95 1353 -105 0 -95 1353 -105 0 -95 1353 -105 0 -95 1353 -105 0 -95 1353 -105 0 -95 1353 -105 0 -95 1353 -105 0 -95 1353 -105 0 -95 1353 -105 0 -95 1353 -105 0 -95 1353 -105 0 -95 1353 -105 0 -95 1353 -105 0 -95 1353 -105 0 -95 1353 -105 0 -95 1353 -105 0 -95 1353 -105 0 -95 1353 -105 0 -95 1353 -105 0 -95 1353 -105 0 -95 1353 -105 0 -95 1353 -105 0 -95 1353 -105 0 -95 1353 -105 0 -95 1353 -105 0 -95 1353 -105 0 -95 1353 -105 0 -95 1353 -105 0 -95 1353 -105 0 -95 1353 -105 0 -95 1353 -105 0 -95 1353 -105 0 -95 1353 -105 0 -95 1353 -105 0 -95 1353 -105 0 -95 1353 -105 0 -95 1353 -105 0 -95 1353 -105 0 -95 1353 -105 0 -95 1353 -105 0 -95 1353 -105 0 -95 1353 -105 0 -95 1353 -105 0 -95 1353 -105 0 -95 1353 -105 0 -95 1353 -105 0)
    )
    (tilemap
      (solid #f)
      (z-pos -100)
      (width 200)
      (height 100)
      (tiles -1256 0 79 -5 0 79 0 323 324 -180 0 323 324 -8 0 79 -5 0 79 0 325 326 -180 0 79 -9 0 79 -5 0 79 0 327 328 -180 0 79 -9 0 79 -5 0 79 -183 0 79 -9 0 79 -5 0 79 -171 0 79 -11 0 79 -9 0 79 -5 0 79 -171 0 79 -11 0 79 -9 0 79 -5 0 79 -171 0 79 -11 0 79 -9 0 79 -5 0 79 -122 0 130 -48 0 79 -11 0 79 -9 0 1347 -5 0 1347 -122 0 129 -48 0 79 -11 0 79 -48 0 402 403 404 405 -68 0 402 403 404 405 -14 0 129 -48 0 79 -11 0 79 -48 0 406 407 408 409 -56 0 402 403 404 405 -8 0 406 407 408 409 -14 0 129 -48 0 79 -11 0 79 -44 0 402 403 404 405 410 411 420 421 -56 0 406 407 408 409 -8 0 410 411 412 413 402 403 404 405 -10 0 129 -5 0 402 403 404 405 -39 0 1347 -11 0 1347 -44 0 406 407 408 409 414 415 424 425 -56 0 410 411 412 413 402 403 404 405 -4 0 414 415 416 417 406 407 408 409 -10 0 129 -5 0 406 407 408 409 -96 0 410 411 426 427 428 429 412 413 402 403 404 405 -52 0 414 415 416 417 406 407 408 409 402 403 404 405 410 411 426 427 428 429 420 421 -10 0 129 -5 0 410 411 412 413 402 403 404 405 -92 0 414 415 430 431 432 433 416 417 406 407 408 409 -48 0 402 403 404 405 410 411 426 427 428 429 412 413 406 407 408 409 414 415 430 431 432 433 424 425 -4 0 402 403 404 405 -2 0 129 -5 0 414 415 416 417 406 407 408 409 -92 0 418 419 442 443 444 445 426 427 428 429 412 413 -11 0 211 -2 0 141 142 -32 0 406 407 408 409 414 415 430 431 432 433 416 417 410 411 426 427 428 429 442 443 444 445 412 413 402 403 404 405 406 407 408 409 -2 0 129 0 402 403 404 405 410 411 426 427 428 429 420 421 -92 0 422 423 446 447 448 449 430 431 432 433 416 417 -11 0 1002 -2 0 143 144 -32 0 410 411 420 421 410 411 442 443 444 445 412 413 414 415 430 431 432 433 446 447 448 449 416 417 406 407 408 409 410 411 426 427 404 405 129 0 406 407 408 409 414 415 430 431 432 433 424 425 -92 0 410 411 442 -197 0 422 423 -387 0 79 -2 0 79 -196 0 79 -2 0 79 -161 0 1608 1609 -33 0 79 -2 0 79 -161 0 1610 1611 -33 0 79 -2 0 79 -196 0 79 -2 0 79 -196 0 79 -2 0 79 -162 0 79 -2 0 79 -30 0 79 -2 0 79 -162 0 79 -2 0 79 -30 0 79 -2 0 79 -162 0 79 -2 0 79 -30 0 79 -2 0 79 -158 0 322 -3 0 79 -2 0 79 -30 0 79 -2 0 79 -147 0 191 192 193 194 -11 0 1349 -2 0 1349 -30 0 79 -2 0 79 -147 0 191 192 193 194 -11 0 79 -2 0 79 -30 0 79 -2 0 79 -162 0 79 -2 0 79 -30 0 79 -2 0 79 -158 0 323 324 -2 0 79 -2 0 79 -30 0 1349 -2 0 1349 -158 0 325 326 -2 0 79 -2 0 79 -30 0 79 -2 0 79 -135 0 79 -22 0 327 328 -2 0 79 -2 0 79 -30 0 79 -2 0 79 -135 0 79 -26 0 79 -2 0 79 -30 0 79 -2 0 79 -132 0 79 -2 0 79 -26 0 79 -2 0 79 -30 0 79 -2 0 79 -132 0 79 -2 0 79 -26 0 79 -2 0 79 -30 0 79 -2 0 79 -132 0 79 -2 0 79 -26 0 79 -2 0 79 -30 0 79 -2 0 79 -132 0 79 -2 0 79 -26 0 1349 -2 0 1349 -30 0 79 -2 0 79 -131 0 48 1349 -2 0 1349 -60 0 79 -2 0 79 -132 0 79 -2 0 79 -3 0 1012 -2 1009 -54 0 79 -2 0 79 -132 0 79 -2 0 79 -60 0 79 -2 0 79 -132 0 79 -2 0 79 -60 0 79 -2 0 79 -132 0 79 -2 0 79 -60 0 79 -2 0 79 -132 0 79 -2 0 79 -9 0 323 324 -49 0 79 -2 0 79 -132 0 79 -2 0 79 -9 0 325 326 -49 0 79 -2 0 79 -132 0 79 -2 0 79 -9 0 327 328 -49 0 79 -2 0 79 -132 0 79 -2 0 79 -22 0 323 324 -36 0 79 -2 0 79 -130 0 322 0 79 -2 0 79 -22 0 325 326 -36 0 79 -2 0 79 -132 0 79 -2 0 79 -22 0 327 328 0 1608 1609 -33 0 79 -2 0 79 -132 0 79 -2 0 79 -25 0 1610 1611 -33 0 79 -2 0 79 -132 0 1349 -2 0 1349 -18 0 322 -41 0 79 -2 0 79 -139 0 -17 201 -40 0 1349 -2 0 1349 -140 0 -15 200 -8 0 79 -11 0 324 -165 0 -12 200 -7 0 79 -2 0 79 -10 0 323 324 -167 0 -10 200 -7 0 79 -2 0 79 -10 0 325 326 -167 0 -6 200 -11 0 79 -2 0 79 -10 0 327 328 -184 0 79 -2 0 79 -172 0 191 192 193 192 -20 0 79 -2 0 79 -172 0 191 -2 0 194 -20 0 79 -2 0 79 -160 0 323 324 -34 0 79 -2 0 79 -160 0 325 326 -34 0 79 -2 0 79 -160 0 327 328 -14 0 323 324 -14 0 48 -3 0 79 -2 0 79 -176 0 325 326 -18 0 1349 -2 0 1349 -176 0 327 328 -18 0 79 -2 0 79 -196 0 79 -2 0 79 -196 0 79 -2 0 79 -196 0 79 -2 0 79 -196 0 79 -2 0 79 -196 0 79 -2 0 79 -166 0 323 324 -28 0 79 -2 0 79 -166 0 325 326 -28 0 79 -2 0 79 -166 0 327 328 -28 0 79 -2 0 79 -194 0 1604 1605 79 -2 0 79 -188 0 322 -5 0 1606 1607 79 -2 0 79 -196 0 1349 -2 0 1349 -167 0 322 -199 0 -21 201 -181 0 -17 200 -190 0 -7 200 -2569 0)
    )
    (tilemap
      (solid #t)
      (z-pos 0)
      (width 200)
      (height 100)
      (tiles 1013 1014 1013 1014 -8 1009 1013 -8 1009 1014 -94 1009 1011 -83 0 -24 1009 1014 1013 -15 1009 1014 -27 1009 1014 -7 1009 1013 1014 -37 1009 1011 -83 0 -27 1009 1013 1014 1013 1014 -7 1009 1014 -11 1009 1013 1014 -4 1009 1014 -59 1009 1011 -83 0 -10 1009 1014 1013 -56 1009 1013 -47 1009 1019 -83 0 -13 1009 1013 1014 1013 1014 -48 1009 1014 -5 1009 1014 -6 1009 1013 1014 -35 1009 1019 -84 0 -40 1009 1013 -3 1009 1014 -6 1009 1013 1014 -31 1009 1013 -28 1009 1017 1019 -85 0 -42 1009 1013 1014 -7 1009 1018 1017 -10 1018 1017 1018 -46 1009 1018 1019 -87 0 -5 1009 -2 1014 -37 1009 -2 1017 1018 1017 1018 1017 1019 -14 0 1016 -2 1017 1018 -2 1017 1018 -38 1009 1019 -89 0 -6 1009 1013 -35 1009 1017 1019 -28 0 1016 1018 -2 1009 1013 1014 -30 1009 1018 1019 -90 0 -39 1009 1017 1018 1019 -15 0 -3 83 102 83 -12 0 1016 1018 -30 1009 1018 1019 -92 0 1009 1014 -33 1009 -3 1018 1019 -27 0 -2 44 -8 0 1016 -28 1009 1019 -94 0 -4 1009 1014 1013 -4 1009 -2 1014 -6 1009 -2 1014 -12 1009 -2 1018 1019 -31 0 -2 44 -9 0 1016 -26 1009 1019 -95 0 1014 -6 1009 1013 -3 1009 1013 -7 1009 1013 -11 1009 1019 -46 0 1016 -22 1009 -2 1017 1019 -21 0 -2 44 -7 0 -2 44 -7 0 -2 44 -55 0 -30 1009 1011 -5 0 -2 83 -2 77 83 -2 77 -2 83 -10 0 27 -7 28 29 -15 0 1016 -20 1009 1019 -24 0 -2 44 -7 0 -2 44 -7 0 -2 44 -55 0 -14 1009 1014 -15 1009 1019 -49 0 1012 1013 1009 1014 -14 1009 1017 1019 -100 0 -9 1009 1014 1013 -6 1009 1014 1013 -10 1009 1019 -50 0 1016 -16 1009 1019 -102 0 -12 1009 1013 1014 -6 1009 1013 1014 1013 1014 -4 1009 1019 -52 0 1012 -14 1009 1015 -9 0 -5 44 -89 0 -27 1009 1011 -5 0 27 -13 28 29 -2 0 -2 44 -29 0 1008 -6 1009 1018 1017 -2 1018 -4 1009 1019 -103 0 -9 1009 1014 -17 1009 1019 -22 0 -2 44 -29 0 1016 -5 1009 1019 -4 0 1016 1018 1017 1019 -10 0 83 102 -3 83 -23 0 -2 44 -15 0 102 -48 0 -26 1009 1015 -55 0 1016 -3 1009 1019 -47 0 -2 44 -64 0 -8 1009 1014 -17 1009 1820 1726 -4 0 84 -50 0 1012 1009 1019 -114 0 -27 1009 1820 1726 -54 0 1016 1019 -8 0 1000 1001 1002 1003 -17 0 1311 -85 0 -28 1009 1820 -64 0 1004 1005 1006 1037 1001 -16 1002 1311 1002 1001 1002 1003 -6 0 -2 44 -16 0 -2 44 -5 0 1000 1001 -48 1002 -23 1009 1020 1021 1022 -2 1009 1011 83 -20 0 1723 1725 -36 0 1723 -4 1724 1817 -2 1009 1041 1005 -18 1006 1005 1006 1007 -6 0 -2 44 -16 0 -2 44 -5 0 1004 1005 -48 1006 -23 1009 1023 1024 1025 -2 1009 1011 -21 0 1008 1820 1724 -35 1725 1817 -28 1009 1017 1019 -31 0 1016 -72 1009 1026 1027 1028 -2 1009 1015 -21 0 1008 -65 1009 1011 -34 0 1012 -76 1009 1820 1725 1726 -19 0 1012 -28 1009 1018 1017 1018 1017 1018 -2 1009 1013 -29 1009 1019 -34 0 1016 -78 1009 1820 1726 -16 0 -2 44 1012 -25 1009 1017 1018 1019 -5 0 1016 1017 1018 -28 1009 1015 -36 0 1008 -78 1009 1820 -16 0 -2 44 1008 -12 1009 1020 1021 1022 -8 1009 1017 1019 -4 0 -3 44 -4 0 1016 1018 -26 1009 1011 -36 0 1012 -78 1009 1820 1724 -4 1725 1726 -7 0 1723 1724 -3 1725 1817 -12 1009 1023 1024 1025 -5 1009 1013 1009 1019 -15 0 1016 -25 1009 1019 -36 0 1012 -52 1009 1013 -10 1009 1013 -20 1009 1820 1724 1726 -5 0 1008 -17 1009 1026 1027 1028 -6 1009 1015 -2 0 -3 44 -2 0 -3 83 -2 0 -3 44 -2 0 1012 -22 1009 1014 1015 -37 0 1012 -82 1009 1013 -3 1009 1820 -5 0 1008 -7 1009 1013 -18 1009 1019 -17 0 1016 -23 1009 1011 -37 0 1016 -86 1009 1820 1725 1726 -3 0 1016 -5 1017 1018 -12 1009 1013 1014 -5 1009 1015 -3 0 83 128 83 -2 0 -3 44 -2 0 83 128 83 -3 0 1012 1009 1013 -20 1009 1019 -38 0 1012 -87 1009 1820 -10 0 1012 1013 -17 1009 1011 -19 0 1008 -21 1009 1015 -39 0 1008 -46 1009 1013 -10 1009 1013 -29 1009 1011 -10 0 1016 1018 -17 1009 1019 -3 0 -3 44 -2 0 -3 83 -2 0 -3 44 -3 0 1016 -21 1009 1011 -39 0 1016 -87 1009 1820 1726 -11 0 1016 -13 1009 1014 1009 1015 -21 0 1012 -20 1009 1015 -40 0 1012 -77 1009 -2 1018 -8 1009 1820 1724 1725 1726 -9 0 1012 -14 1009 1015 -4 0 -3 83 -7 0 -3 83 -4 0 1008 -20 1009 1011 -40 0 1008 -76 1009 1019 -2 0 1016 -10 1009 1820 -8 0 1723 1817 -11 1009 1013 -2 1009 1820 1726 -19 0 1723 1817 -20 1009 1015 -40 0 1012 -47 1009 -3 1013 -25 1009 1011 -4 0 1008 -9 1009 1019 -8 0 1008 -16 1009 1820 1724 1726 -15 0 1723 1725 1817 -21 1009 1011 -40 0 1012 -47 1009 -6 1013 -22 1009 1015 -4 0 1012 -7 1009 1018 1019 -7 0 1723 1725 1817 -18 1009 1820 1724 -3 1725 1726 -5 0 1723 1724 -3 1725 1817 -23 1009 1015 -40 0 1012 -46 1009 -7 1013 -22 1009 1011 -4 0 1012 -6 1009 1019 -9 0 1008 -25 1009 1820 -5 0 1008 -28 1009 1011 -40 0 1012 -45 1009 -8 1013 -10 1009 1018 1017 1018 1017 1018 -4 1009 1020 1022 1009 1011 -4 0 1012 -5 1009 1015 -9 0 1723 1817 -25 1009 1011 -5 0 1012 -28 1009 1015 -40 0 1016 -45 1009 -8 1013 -9 1009 1019 -5 0 1008 -3 1009 1026 1028 1009 1019 -4 0 1016 -6 1009 -8 0 1723 1817 -26 1009 1015 -5 0 1012 -28 1009 1011 -41 0 1012 -60 1009 1019 -6 0 1016 1018 1017 1018 1017 1018 1019 -6 0 1016 1017 1018 -2 1017 1019 -8 0 1008 -16 1009 1013 1014 -5 1009 1013 -2 1009 1014 1011 -5 0 1012 -28 1009 1015 -41 0 1016 -59 1009 1015 -34 0 1008 -27 1009 1015 -5 0 1012 -28 1009 1011 -42 0 1016 -58 1009 1011 -28 0 1723 1726 -4 0 1008 -15 1009 1014 -11 1009 1011 -5 0 1008 1014 -6 1009 1013 1014 -19 1009 1019 -43 0 1016 -57 1009 1015 -7 0 1723 1724 -5 1725 1726 -4 0 1723 1724 -7 1725 1817 1820 -2 1725 1724 1725 1817 -27 1009 1015 -5 0 1012 -27 1009 1015 -45 0 1012 -56 1009 1011 -7 0 1008 -6 1009 1820 0 -2 44 0 1008 -42 1009 1011 -5 0 1008 -27 1009 1011 -45 0 1012 -56 1009 1015 -4 0 27 -4 28 29 -4 1009 1011 0 -2 44 0 1008 -42 1009 1015 -5 0 1012 1013 1014 -6 1009 1013 1014 -17 1009 1015 -45 0 1016 -56 1009 1011 -7 0 1012 -6 1009 1015 0 -2 44 0 1012 1013 -41 1009 1011 -5 0 1008 -27 1009 1011 -46 0 1012 -54 1009 1014 1015 -7 0 1012 -6 1009 1011 0 -2 44 0 1008 -30 1009 1013 -11 1009 1015 -5 0 1012 -27 1009 1019 -46 0 1008 -55 1009 1019 -7 0 1008 -6 1009 1011 0 -2 44 0 1016 -3 1017 1018 -38 1009 1011 -5 0 1008 -4 1009 1014 -21 1009 1015 -47 0 1012 -54 1009 1019 -8 0 1012 1013 -5 1009 1019 -9 0 1016 -37 1009 1015 -5 0 1012 -26 1009 1011 -47 0 1012 -53 1009 1015 -9 0 1012 -3 1009 1018 1017 1019 -11 0 1016 -4 1009 1018 -3 1017 1018 -27 1009 1011 -5 0 1008 -26 1009 1011 -47 0 1016 -53 1009 1015 -9 0 1008 -2 1009 1011 -15 0 1012 -2 1009 1019 -5 0 1012 -22 1009 1013 -3 1009 1015 -5 0 1012 -26 1009 1019 -48 0 1012 1013 -51 1009 1015 -9 0 1016 -2 1018 1019 -15 0 1016 1018 1019 -6 0 1016 1009 1013 -24 1009 1011 -5 0 1008 -25 1009 1011 -49 0 1008 -52 1009 1820 1726 -37 0 1016 1017 1018 1017 1018 -4 1017 1018 -6 1017 1018 -4 1017 1018 -4 1017 1019 -5 0 1012 -25 1009 1019 -49 0 1012 1013 -52 1009 1820 1726 -68 0 1008 -23 1009 1014 1011 -50 0 1012 -54 1009 1820 -4 0 1723 -2 1725 1726 -17 0 1723 1724 -3 1725 1726 -37 0 1012 -24 1009 1011 -50 0 1016 -54 1009 1820 1724 -3 1725 1817 -2 1009 1820 -14 0 1723 1724 1725 1817 -4 1009 1820 1726 -9 0 1723 -2 1724 1725 -6 1724 1725 -4 1724 1725 -6 1724 1726 -4 0 1008 -24 1009 1015 -51 0 1012 -61 1009 1820 1726 -13 0 1008 -8 1009 1820 -9 0 1012 -21 1009 1820 -2 1725 1724 1725 1817 -24 1009 1011 -51 0 1008 -62 1009 1820 1726 -10 0 1723 1725 1817 -7 1009 1017 1019 -2 0 -2 83 102 83 -3 0 1016 -51 1009 1019 -51 0 1016 -63 1009 1820 1725 1726 0 -6 44 0 1008 -7 1009 1018 1019 -12 0 1016 -21 1009 1013 -2 1014 1013 1014 -22 1009 1014 1015 -53 0 1008 -64 1009 1820 1724 1725 -4 1724 -2 1725 1817 -6 1009 1011 -15 0 1012 -48 1009 1820 1726 -52 0 1008 -80 1009 1011 -12 0 1723 -2 1725 1817 -15 1009 1014 -7 1009 1013 -23 1009 1014 1009 1820 -52 0 1008 -7 1009 1014 -72 1009 1019 -10 0 1723 1725 1817 -52 1009 1011 -52 0 1008 -58 1009 -2 1018 -13 1009 1020 1022 -4 1009 1011 -8 0 1723 1724 1725 1817 -54 1009 1011 -52 0 1008 -37 1009 1017 1018 1017 1018 1017 1018 -14 1009 1019 -2 0 1016 -12 1009 1026 1028 -4 1009 1015 -8 0 1008 -57 1009 1015 -52 0 1008 -37 1009 -6 0 1016 1018 1017 -10 1009 1015 -4 0 1012 -5 1009 1018 -2 1017 1018 -8 1009 1011 -7 0 83 1008 -57 1009 1011 -52 0 1008 -37 1009 -9 0 1016 -2 1017 1018 -6 1009 1011 -4 0 1012 1013 -3 1009 1019 -4 0 1008 -6 1009 1018 1019 -8 0 1012 -32 1009 1013 1014 -23 1009 1015 -52 0 1008 -37 1009 -13 0 1016 -5 1017 1019 -4 0 1016 1017 1018 1017 1019 -5 0 1012 -5 1009 1011 -10 0 1012 -33 1009 1013 -23 1009 1011 -52 0 1008 -37 1009 -4 1725 -30 0 1008 -4 1009 1018 1019 -7 0 1723 1724 1725 1817 -18 1009 1014 -12 1009 1014 -25 1009 1011 -52 0 1008 -40 1009 1820 1724 -4 1725 -22 0 1723 1724 1725 1817 -3 1009 1019 -9 0 1008 -60 1009 1011 -52 0 1008 -45 1009 1820 1724 -9 1725 1726 -4 0 1723 1724 -5 1725 1817 -4 1009 1014 1015 -10 0 1008 -7 1009 -3 1013 -14 1009 1013 -35 1009 1019 -52 0 1008 -56 1009 1820 0 -2 44 0 1008 -11 1009 1018 1019 -10 0 1008 -7 1009 -2 1013 -27 1009 1013 -2 1014 1013 1014 -18 1009 1015 -53 0 1008 -56 1009 1011 -4 0 1008 -10 1009 1011 -12 0 1008 -28 1009 1013 -30 1009 1015 -53 0 1008 -56 1009 1015 0 -2 44 0 1008 -10 1009 1019 -12 0 1008 -31 1009 1014 -7 1009 1013 -19 1009 1011 -53 0 1008 -49 1009 1020 1022 -5 1009 1011 -4 0 1012 -9 1009 1019 -13 0 1008 -29 1009 -2 1014 1009 1013 -26 1009 1015 -53 0 1008 -49 1009 1026 1028 1009 -2 1018 -2 1017 1019 0 -2 44 0 1016 -2 1009 1017 1018 1017 1018 -2 1009 1011 -14 0 1008 -27 1009 1013 -2 1009 1013 -28 1009 1019 -53 0 1008 -51 1009 1019 -10 0 1016 1019 -4 0 1016 1018 1019 -14 0 1008 -14 1009 1013 1014 -6 1009 1013 1014 -34 1009 1011 -54 0 1008 -50 1009 1011 -34 0 1008 -10 1009 1014 -8 1009 1013 -38 1009 1015 -54 0 1008 -50 1009 1019 -23 0 1723 1724 -2 1725 1726 -6 0 1008 -58 1009 1011 -54 0 1008 -49 1009 1011 -23 0 1723 1817 -3 1009 1820 1725 1726 -4 0 1008 -58 1009 1015 -54 0 1008 -49 1009 1820 1725 1726 -21 0 1008 -6 1009 1820 -2 1725 1724 1725 1817 -58 1009 1011 -54 0 1008 -51 1009 1820 1726 -19 0 1723 1817 -70 1009 1015 -54 0 1012 1013 -51 1009 1820 1725 1726 -15 0 1723 1725 1817 -5 1009 1020 1021 1022 -63 1009 1011 -54 0 1012 1013 -53 1009 1820 -7 1725 1726 0 -2 44 0 1723 1724 1725 1817 -7 1009 1023 1024 1025 -63 1009 1015 -54 0 1008 -62 1009 1820 1724 -3 1725 1817 -10 1009 1026 1027 1028 -63 1009 1011 -54 0 1012 1013 -143 1009 1015 -54 0 1012 -144 1009 1011 -54 0 1012 -144 1009 1019 -54 0 1008 -143 1009 1015 -55 0 1012 -143 1009 1011 -55 0 1012 -143 1009 1015 -55 0 1008 -143 1009 1011 -55 0 1012 -143 1009 1011 -55 0 1012 -143 1009 1019 -55 0 1008 -142 1009 1011 -56 0 1012 -142 1009 1015 -56 0 1012 -142 1009 1011 -56 0 1008 -37 1009)
    )
    (tilemap
      (solid #f)
      (z-pos 100)
      (width 200)
      (height 100)
      (tiles -1646 0 325 326 -198 0 327 328 -834 0 330 -1344 0 360 -265 0 360 -3160 0 360 -176 0 191 192 193 194 -196 0 191 192 193 194 -196 0 191 192 193 194 -196 0 191 192 193 194 -196 0 191 192 193 194 -196 0 191 192 193 194 -196 0 191 192 193 194 -196 0 191 192 193 194 -196 0 191 192 193 194 -196 0 191 192 193 194 -196 0 191 192 193 194 -196 0 191 192 193 194 -196 0 191 192 193 194 -196 0 191 192 193 194 -196 0 191 192 193 194 -196 0 191 192 193 194 -196 0 191 192 193 194 -196 0 191 192 193 194 -196 0 187 188 189 190 -196 0 183 184 185 186 -196 0 179 180 181 182 -195 0 195 175 176 177 178 196 -194 0 197 -4 198 199 -1385 0 192 193 -197 0 191 192 193 194 -196 0 191 192 193 194 -196 0 191 192 193 194 -196 0 191 192 193 194 -26 0 360 -169 0 191 192 193 194 -196 0 191 192 193 194 -196 0 191 192 193 194 -196 0 191 192 193 194 -196 0 191 192 193 194 -196 0 191 192 193 194 -196 0 191 192 193 194 -196 0 191 192 193 194 -196 0 191 192 193 194 -196 0 187 188 189 190 -196 0 183 184 185 186 -196 0 179 180 181 182 -195 0 195 175 176 177 178 196 -194 0 197 -4 198 199 -2975 0)
    )
    (tilemap
      (handle
        (scale_x 0)
        (scale_y 0)
        (offset_x 0)
        (offset_y 0)
      )
      (solid #f)
      (z-pos 101)
      (name "secret1")
      (path-ref "gen17730103092846001427184")
      (width 22)
      (height 5)
      (tiles -21 1009 1011 1008 -20 1009 1011 1008 -20 1009 1011 1008 -20 1009 1011 1008 -21 1009)
    )
    (tilemap
      (solid #f)
      (z-pos -101)
      (width 200)
      (height 100)
      (tiles -1446 0 79 -18553 0)
    )
    (viciousivy
      (z-pos 50)
      (x 1762)
      (y 729)
      (glinting #f)
    )
    (viciousivy
      (z-pos 50)
      (x 2136)
      (y 743)
      (glinting #f)
    )
    (viciousivy
      (z-pos 50)
      (x 2489)
      (y 732)
      (glinting #f)
    )
    (viciousivy
      (z-pos 50)
      (x 2320)
      (y 736)
      (glinting #f)
    )
    (viciousivy
      (z-pos 50)
      (x 3024)
      (y 640)
      (glinting #f)
    )
    (willowisp
      (z-pos 150)
      (path-ref "gen17730103092846001427728")
      (adapt-speed #f)
      (handle
        (scale_x 0)
        (scale_y 0)
        (offset_x 0)
        (offset_y 0)
      )
      (sector "main")
      (spawnpoint "wow1")
      (color 0 1 0)
    )
    (willowisp
      (z-pos 150)
      (path-ref "gen17730103092846001427456")
      (adapt-speed #f)
      (handle
        (scale_x 0)
        (scale_y 0)
        (offset_x 0)
        (offset_y 0)
      )
      (sector "main")
      (spawnpoint "wow2")
      (color 0 1 0)
    )
  )
)
