(supertux-level
  (version 3)
  (name (_ "Owls' Revenge"))
  (author "Christoph Sommer")
  (license "CC-BY-SA 4.0 International")
  (allow-item-pocket "inherit")
  (icon "")
  (icon-locked "")
  (statistics
    (enable-coins #t)
    (enable-secrets #t)
  )
  (sector
    (name "main")
    (ambient-light
      (color 0.9764706 0.9686275 0.9686275)
    )
    (background
      (color 1 1 1)
      (alignment "top")
      (speed 0.5)
      (image-top "images/background/bridgecloud-light.png")
      (image "images/background/bridgecloud-light.png")
      (image-bottom "images/background/bridgecloud-light.png")
      (z-pos -190)
    )
    (background
      (scroll-offset-y -10)
      (color 1 1 1)
      (alignment "bottom")
      (speed 0.5)
      (image-top "images/background/forest_para2.png")
      (image "images/background/forest_para2.png")
      (image-bottom "images/background/forest_para2.png")
      (z-pos -190)
    )
    (camera
      (name "Camera")
      (mode "normal")
    )
    (gradient
      (top_color 0 0.5843138 1)
      (bottom_color 0 0.5843138 1)
    )
    (mrbomb
      (z-pos 50)
      (x 1436.136)
      (y 1022.007)
      (glinting #f)
    )
    (music
      (file "music/greatgigantic.music")
    )
    (owl
      (z-pos 51)
      (glinting #f)
      (carry "skydive")
      (x 1614)
      (y 807)
    )
    (secretarea
      (width 1116)
      (height 156)
      (x 160)
      (y 64)
    )
    (spawnpoint
      (name "main")
      (x 200)
      (y 981.0001)
    )
    (tilemap
      (solid #f)
      (z-pos -100)
      (name "Background")
      (width 100)
      (height 35)
      (tiles -1442 0 85 86 87 88 -96 0 89 90 91 92 -204 0 85 86 87 88 -96 0 89 90 91 92 -87 0 85 86 87 88 -13 0 85 86 87 88 -52 0 85 86 87 88 -23 0 89 90 91 92 -13 0 89 90 91 92 -23 0 85 86 87 88 -25 0 89 90 91 92 -11 0 85 86 87 88 -31 0 85 86 87 88 -17 0 89 90 91 92 -7 0 85 86 87 88 85 86 87 88 -25 0 89 90 91 92 -31 0 89 90 91 92 -28 0 89 90 91 92 89 90 91 92 -743 0 402 403 404 405 -78 0 402 403 404 405 -14 0 406 407 408 409 -14 0 402 403 404 405 -4 0 402 403 404 405 -15 0 317 318 402 403 404 68 -2 0 402 403 404 405 -8 0 402 403 404 405 -3 0 402 403 404 405 0 360 -4 0 406 407 408 409 -4 0 402 403 404 405 -3 0 360 0 360 410 411 412 413 -12 0 360 0 406 407 408 409 -4 0 406 407 408 409 0 322 -13 0 319 320 406 407 408 68 1354 -30 0 410 411 412 413 -14 0 414 415 416 417 -14 0 410 411 412 413 -4 0 410 411 412 413 -17 0 410 411 412 413 -31 0 414 415 416 417 -32 0 414 415 416 417 -4 0 414 415 416 417 -17 0 414 415 416 417 -2 0)
    )
    (tilemap
      (solid #t)
      (z-pos 0)
      (name "Interactive")
      (width 100)
      (height 35)
      (tiles -208 0 44 -5 0 44 -15 0 44 -5 0 44 -70 0 -3 44 -3 0 -3 44 -4 0 128 -3 44 128 -4 0 -3 44 -3 0 -3 44 -68 0 -3 44 0 44 0 -3 44 0 44 -11 0 -3 44 0 44 0 -3 44 0 44 -68 0 44 0 44 -3 0 44 0 44 -13 0 44 0 44 -3 0 44 0 44 -70 0 44 -5 0 44 -15 0 44 -5 0 44 -66 0 48 27 -35 28 29 48 -259 0 48 -41 0 48 -259 0 48 -37 0 48 -201 0 -2 1311 -306 0 -2 1311 -206 0 -2 1311 -204 0 -2 1311 -34 0 -2 1311 -213 0 77 102 77 -12 0 -2 44 -32 0 83 -2 77 -2 83 77 -59 0 -4 77 -20 0 77 102 77 -33 0 44 -91 0 48 -6 0 44 -91 0 -2 48 -5 0 44 -26 0 77 83 77 -2 83 77 -34 0 44 -9 0 83 -2 77 83 0 77 -9 0 -3 48 -4 0 44 -9 0 65 0 65 -27 0 57 58 -6 0 57 58 -15 0 48 -2 0 48 -2 0 48 -20 0 -4 48 -3 0 44 -10 0 68 64 69 -27 0 59 60 -6 0 59 60 -14 0 -2 48 -2 0 48 -2 0 -2 48 -19 0 -4 48 -14 0 133 1353 132 -27 1002 59 60 -6 1002 59 60 -3 1002 1003 -2 0 1000 -6 1002 -3 48 -2 0 48 -2 0 -3 48 -18 1002 -4 48 1003 -2 0 1038 -2 0 1038 -2 0 1000 -4 1002 133 1002 132 -40 1006 1007 -2 0 1004 1005 -7 1006 1007 -2 0 1044 -2 0 1004 1005 -23 1006 1007 -2 0 1044 -2 0 1044 -2 0 1004 1005 -6 1006 -4 1009 1010 -25 1009 1010 -9 1009 1011 -2 0 1008 -2 1009 1010 -5 1009 1011 -2 0 1738 -2 0 1008 -6 1009 1010 -17 1009 1011 -2 0 1738 -2 0 1738 -2 0 1008 -2 1009 1010 -4 1009)
    )
    (tilemap
      (solid #f)
      (z-pos 100)
      (name "Foreground")
      (width 100)
      (height 35)
      (tiles -3199 0 69 -27 0 -2 1002 -6 0 -2 1002 -13 0 -2 1002 1003 -2 0 1038 -2 0 1000 -2 1002 -18 0 -4 1002 -14 0 1001 0 69 -10 0 317 318 -98 0 319 320 -88 0)
    )
    (tilemap
      (solid #f)
      (z-pos -110)
      (name "back2")
      (width 100)
      (height 35)
      (tiles -2505 0 1073 1074 1075 -16 0 1240 1241 1242 -78 0 1081 1082 1083 1084 -14 0 1243 1244 1245 1246 -77 0 1088 1089 1090 1091 1092 1093 -13 0 1247 1248 1249 1250 -76 0 1095 1096 1097 1098 1099 1100 1101 -13 0 1251 1252 1253 1254 -76 0 1103 1104 1105 1106 1107 1108 1109 1110 -12 0 1255 1256 1257 1258 -16 0 402 403 404 405 -24 0 402 403 404 405 -28 0 1111 1112 1113 1114 1115 1116 1117 1118 -12 0 1259 1260 1261 1262 -4 0 402 403 404 405 -8 0 406 407 408 409 -20 0 402 403 404 405 406 407 408 409 -21 0 402 403 404 405 -3 0 1119 1120 1121 1122 1123 1124 1125 1126 -5 0 402 403 404 405 -3 0 1263 1264 1265 1266 -4 0 406 407 408 409 -8 0 410 411 412 413 -20 0 406 407 408 409 410 411 412 413 -21 0 406 407 408 409 -3 0 1127 1128 1129 1130 1131 1132 1133 1134 -5 0 406 407 408 409 -3 0 1267 1268 1269 1270 -4 0 410 411 412 413 -8 0 414 415 416 417 -20 0 410 411 412 413 414 415 416 417 -21 0 410 411 412 413 -16 0 410 411 412 413 -11 0 414 415 416 417 -32 0 414 415 416 417 -25 0 414 415 416 417 -16 0 414 415 416 417 -80 0)
    )
    (tilemap
      (solid #f)
      (z-pos -120)
      (name "cave")
      (width 100)
      (height 35)
      (tiles -3145 0 402 403 404 405 -20 0 402 403 404 405 -67 0 -4 1351 0 406 407 408 409 -3 0 -7 1351 -10 0 406 407 408 409 -10 0 -10 1351 -47 0 -4 1352 0 410 411 412 413 -3 0 -7 1352 -10 0 410 411 412 413 -10 0 -10 1352 -47 0 -4 1353 0 414 415 416 417 -3 0 -7 1353 -10 0 414 415 416 417 -10 0 -10 1353 -7 0)
    )
    (torch
      (z-pos 0)
      (x 1296)
      (y 228)
    )
    (torch
      (z-pos 0)
      (x 176)
      (y 228)
    )
    (unstable_tile
      (sprite "images/objects/unstable_tile/castleblock.sprite")
      (z-pos 0)
      (x 1824)
      (y 960)
    )
    (unstable_tile
      (sprite "images/objects/unstable_tile/castleblock.sprite")
      (z-pos 0)
      (x 1728)
      (y 960)
    )
    (unstable_tile
      (sprite "images/objects/unstable_tile/castleblock.sprite")
      (z-pos 0)
      (x 1696)
      (y 960)
    )
    (unstable_tile
      (sprite "images/objects/unstable_tile/castleblock.sprite")
      (z-pos 0)
      (x 1792)
      (y 960)
    )
    (viciousivy
      (z-pos 50)
      (x 665)
      (y 1017)
      (glinting #f)
    )
    (viciousivy
      (z-pos 50)
      (x 958)
      (y 1020)
      (glinting #f)
    )
    (viciousivy
      (z-pos 50)
      (x 2199)
      (y 1018)
      (glinting #f)
    )
    (viciousivy
      (z-pos 50)
      (x 2289.456)
      (y 1016.586)
      (glinting #f)
    )
  )
)
