(supertux-level
  (version 3)
  (name (_ "Penguins don't grow on Trees"))
  (author "Wolfgang Becker")
  (license "GPL 2+ / CC-by-sa 3.0")
  (allow-item-pocket "inherit")
  (icon "")
  (icon-locked "")
  (statistics
    (enable-coins #t)
    (enable-secrets #t)
  )
  (sector
    (name "main")
    (ambient-light
      (color 1 1 1)
    )
    (background
      (color 1 1 1)
      (speed 0.5)
      (image-top "images/background/BlueRock_Forest/blue-top.jpg")
      (image "images/background/BlueRock_Forest/blue-middle.jpg")
      (image-bottom "images/background/BlueRock_Forest/blue-bottom.jpg")
    )
    (bonusblock
      (type "purple")
      (z-pos 51)
      (x 1472)
      (y 448)
    )
    (camera
      (name "Camera")
      (mode "normal")
    )
    (candle
      (z-pos -99)
      (x 1376)
      (y 512)
    )
    (door
      (z-pos -99)
      (sector "tree house")
      (locked #f)
      (spawnpoint "InsideTreeHouse")
      (x 1296)
      (y 477)
    )
    (firefly
      (z-pos 0)
      (x 352)
      (y 576)
    )
    (fish-jumping
      (z-pos 50)
      (x 1036.815)
      (y 530.593)
      (glinting #f)
    )
    (mrtree
      (z-pos 50)
      (direction "left")
      (x 1696)
      (y 382)
      (glinting #f)
    )
    (music
      (file "music/forest2.ogg")
    )
    (secretarea
      (width 222.2549)
      (height 61)
      (x 192)
      (y 1026)
    )
    (snail
      (z-pos 50)
      (direction "right")
      (x 1056)
      (y 992)
      (glinting #f)
    )
    (spawnpoint
      (name "main")
      (x 3090.94)
      (y 842.3616)
    )
    (spawnpoint
      (name "ExitTreeHouse")
      (x 1296)
      (y 544)
    )
    (spawnpoint
      (name "roof")
      (x 1392)
      (y 256)
    )
    (tilemap
      (solid #f)
      (z-pos -100)
      (width 100)
      (height 40)
      (tiles -12 0 1073 1074 1075 -97 0 1081 1082 1083 1084 -95 0 1088 1089 1090 1091 1092 1093 -93 0 1095 1096 1097 1098 1099 1100 1101 -93 0 1103 1104 1105 1106 1107 1108 1109 1110 -4 0 1073 1074 1075 -59 0 -8 48 -18 0 1111 1112 1113 1114 1115 1116 1117 1118 -4 0 1081 1082 1083 1084 -25 0 1073 1074 1075 -31 0 27 -4 28 29 -19 0 1103 1104 1105 1106 1107 1108 1109 1110 -3 0 1088 1089 1090 1091 1092 1093 -14 0 1168 1169 1170 -7 0 1081 1082 1083 1084 -30 0 27 -4 28 29 -19 0 1111 1112 1113 1114 1115 1116 1117 1118 -2 0 1095 1096 1097 1098 1099 1100 1101 -14 0 1174 1175 1176 1177 -5 0 1088 1089 1090 1091 1092 1093 -29 0 27 -4 28 29 -19 0 1103 1104 1105 1106 1107 1108 1109 1110 -2 0 1103 1104 1105 1106 1107 1108 1109 1110 -12 0 1179 1180 1181 1182 1183 -4 0 1095 1096 1097 1098 1099 1100 1101 -54 0 1111 1112 1113 1114 1115 1116 1117 1118 -2 0 1111 1112 1113 1114 1115 1116 1117 1118 -12 0 1185 1186 1187 1188 1189 1190 -3 0 1103 1104 1105 1106 1107 1108 1109 1110 -53 0 1103 1104 1105 1106 1107 1108 1109 1110 -2 0 1103 1104 1105 1106 1107 1108 1109 1110 -21 0 1111 1112 1113 1114 1115 1116 1117 1118 -53 0 1111 1112 1113 1114 1115 1116 1117 1118 -2 0 1111 1112 1113 1114 1115 1116 1117 1118 -12 0 27 -4 28 29 -3 0 1119 1120 1121 1122 -57 0 1103 1104 1105 1106 1107 1108 1109 1110 -2 0 1119 1120 1121 1122 1123 1124 1125 1126 -12 0 27 -4 28 29 -3 0 1127 1128 1129 1130 -57 0 1111 1112 1113 1114 1115 1116 1117 1118 -2 0 1127 1128 1129 1130 1131 1132 1133 1134 -12 0 27 -4 28 29 -64 0 1103 1104 1105 1106 1107 1108 1109 1110 -4 0 1137 1138 1139 1140 -14 0 27 -4 28 29 -64 0 1111 1112 1113 1114 1115 1116 1117 1118 -4 0 1145 1146 1147 1148 -14 0 212 -4 28 29 -64 0 1119 1120 1121 1122 1123 1124 1125 1126 -4 0 1137 1138 1139 1140 -14 0 212 -4 28 29 -14 0 1168 1169 1170 -47 0 1127 1128 1129 1130 1131 1132 1133 1134 -4 0 1145 1146 1147 1148 -14 0 213 -4 28 29 -14 0 1174 1175 1176 1177 -48 0 1137 1138 1139 1140 -6 0 1137 1138 1139 1140 -4 0 48 -4 0 48 -13 0 1168 1169 1170 -7 0 1179 1180 1181 1182 1183 -9 0 1240 1241 1242 -36 0 1145 1146 1147 1148 -6 0 1137 1138 1139 1140 -4 0 48 -4 0 48 -6 0 1217 1218 -5 0 1174 1175 1176 1177 -6 0 1185 1186 1187 1188 1189 1190 -3 0 1240 1241 1242 0 1243 1244 1245 1246 -4 0 1240 1241 1242 -29 0 1137 1138 1139 1140 -6 0 1137 1138 1139 1140 -4 0 1217 1218 -2 0 1272 1273 -6 0 1223 1224 -4 0 1179 1180 1181 1182 1183 -6 0 1191 1192 1193 1194 1195 1196 -2 0 1243 1244 1245 1246 0 1247 1248 1249 1250 -3 0 1243 1244 1245 1246 -29 0 1145 1146 1147 1148 -6 0 1145 1146 1147 1148 -4 0 1223 1224 -2 0 1223 1224 -6 0 1217 1218 -4 0 1185 1186 1187 1188 1189 1190 -5 0 1197 1198 1199 1200 1201 1202 -2 0 1247 1248 1249 1250 0 1251 1252 1253 1254 -3 0 1247 1248 1249 1250 -29 0 1137 1138 1139 1140 -6 0 1137 1138 1139 1140 -4 0 1217 1218 -2 0 1217 1218 -6 0 1223 1224 -4 0 1191 1192 1193 1194 1195 1196 -5 0 1203 1204 1205 1206 1207 1208 -2 0 1251 1252 1253 1254 0 1255 1256 1257 1258 -3 0 1251 1252 1253 1254 -29 0 1145 1146 1147 1148 -6 0 1145 1146 1147 1148 -4 0 1223 1224 -2 0 1223 1224 -6 0 1217 1218 -4 0 1197 1198 1199 1200 1201 1202 -5 0 1209 1210 1211 1212 1213 1214 -2 0 1255 1256 1257 1258 0 1259 1260 1261 1262 -3 0 1255 1256 1257 1258 -29 0 1137 1138 1139 1140 -6 0 1137 1138 1139 1140 -4 0 1217 1218 -2 0 1217 1218 -6 0 1223 1224 -4 0 1203 1204 1205 1206 1207 1208 -7 0 1223 1224 -4 0 1259 1260 1261 1262 0 1263 1264 1265 1266 -3 0 1259 1260 1261 1262 -29 0 1145 1146 1147 1148 -6 0 1145 1146 1147 1148 -4 0 1223 1224 -2 0 1223 1224 -6 0 1217 1218 -4 0 1209 1210 1211 1212 1213 1214 -7 0 1217 1218 -4 0 1263 1264 1265 1266 0 1267 1268 1269 1270 -3 0 1263 1264 1265 1266 -29 0 1137 1138 1139 1140 -6 0 1137 1138 1139 1140 -3 0 2045 1219 1220 -2 0 1217 1218 -6 0 1223 1224 -5 0 2045 1219 1220 -9 0 1223 1224 -4 0 1267 1268 1269 1270 0 1271 1272 1273 1274 -3 0 1267 1268 1269 1270 -22 0 402 403 404 405 -3 0 1145 1146 1147 1148 -6 0 1145 1146 1147 1148 -3 0 2046 1225 1226 -2 0 1223 1224 -5 0 1228 1229 1230 -5 0 2046 1225 1226 -9 0 1217 1218 -4 0 1271 1272 1273 1274 0 1275 1276 1277 1278 -3 0 1271 1272 1273 1274 -17 0 1001 1002 1001 1002 0 406 407 408 409 -3 0 1137 1138 1139 1140 -6 0 1137 1138 1139 1140 -4 0 1217 1218 -2 0 1217 1218 -5 0 1234 1235 1236 -6 0 1223 1224 -9 0 1223 1224 -4 0 1275 1276 1277 1278 0 1279 1280 1281 1282 -3 0 1275 1276 1277 1278 -17 0 1005 1006 1005 1006 0 410 411 412 413 -3 0 1145 1146 1147 1148 -6 0 1145 1146 1147 1148 -4 0 1223 1224 -2 0 1223 1224 -13 0 1228 1229 1230 -9 0 1217 1218 -4 0 1279 1280 1281 1282 0 1283 1284 1285 1286 -3 0 1279 1280 1281 1282 -17 0 -3 1009 1533 0 414 415 416 417 -3 0 1153 1154 1155 1156 -6 0 1153 1154 1155 1156 -3 0 1228 1229 1230 0 1228 1229 1230 -13 0 1234 1235 1236 -9 0 1223 1224 -4 0 1283 1284 1285 1286 -8 0 1283 1284 1285 1286 -17 0 -7 1009 -5 0 1161 1162 1163 1164 -6 0 1161 1162 1163 1164 -3 0 1234 1235 1236 0 1234 1235 1236 -24 0 1228 1229 1230 -37 0 -3 1009 1533 1534 1535 1009 -53 0 1234 1235 1236 -37 0 -3 1009 1536 1537 1538 1009 -93 0 -7 1009 -593 0)
    )
    (tilemap
      (solid #f)
      (z-pos -90)
      (width 100)
      (height 40)
      (tiles -389 0 1348 -195 0 211 0 -2 28 29 211 -94 0 212 0 29 0 47 212 -94 0 213 0 -2 28 29 213 -358 0 1119 1120 1121 1122 1123 1124 1125 1126 -92 0 1127 1128 1129 1130 1131 1132 1133 1134 -94 0 1137 1138 1139 1140 -96 0 1145 1146 1147 1148 -87 0 -2 28 29 -6 0 1137 1138 1139 1140 -29 0 1287 1288 -56 0 29 0 47 -6 0 1145 1146 1147 1148 -22 0 1287 1288 -5 0 1289 1290 0 1287 1288 -14 0 1240 1241 1242 -36 0 -2 28 29 -6 0 1137 1138 1139 1140 -22 0 1289 1290 -5 0 1291 1292 0 1289 1290 -13 0 1243 1244 1245 1246 -21 0 1287 1288 1168 -21 0 1145 1146 1147 1148 -22 0 1291 1292 -5 0 1293 1294 0 1291 1292 -13 0 1247 1248 1249 1250 -21 0 1289 1290 -22 0 1137 1138 1139 1140 -16 0 1287 1288 -4 0 1293 1294 -5 0 1295 1296 0 1293 1294 -13 0 1251 1252 1253 1254 -15 0 1240 1241 1242 -3 0 1291 1292 -8 0 1240 1241 1242 -11 0 1145 1146 1147 1148 -16 0 1289 1290 -4 0 1295 1296 -5 0 1297 1298 0 1295 1296 -13 0 1255 1256 1257 1258 -14 0 1243 1244 1245 1246 -3 0 1293 1294 -7 0 1243 1244 1245 1246 -11 0 1137 1138 1139 1140 -16 0 1291 1292 -4 0 1297 1298 -5 0 1299 1300 0 1297 1298 -13 0 1259 1260 1261 1262 -14 0 1247 1248 1249 1250 -3 0 1295 1296 -2 0 1287 1288 -3 0 1247 1248 1249 1250 -11 0 1145 1146 1147 1148 -16 0 1293 1294 -4 0 1299 1300 -5 0 1297 1298 0 1299 1300 -13 0 1263 1264 1265 1266 -14 0 1251 1252 1253 1254 -3 0 1297 1298 -2 0 1289 1290 -3 0 1251 1252 1253 1254 -11 0 1137 1138 1139 1140 -16 0 1295 1296 -4 0 1301 1302 -5 0 1299 1300 0 1301 1302 -13 0 1267 1268 1269 1270 -14 0 1255 1256 1257 1258 -3 0 1299 1300 -2 0 1291 1292 -3 0 1255 1256 1257 1258 -11 0 1145 1146 1147 1148 -16 0 1297 1298 -4 0 1305 1306 -5 0 1301 1302 0 1303 1304 -13 0 1271 1272 1273 1274 -14 0 1259 1260 1261 1262 -3 0 1301 1302 -2 0 1293 1294 -3 0 1259 1260 1261 1262 -11 0 1137 1138 1139 1140 -16 0 1299 1300 -4 0 1303 1304 -5 0 1305 1306 0 1305 1306 -13 0 1275 1276 1277 1278 -14 0 1263 1264 1265 1266 -3 0 1303 1304 -2 0 1295 1296 -3 0 1263 1264 1265 1266 -11 0 1145 1146 1147 1148 -16 0 1301 1302 -4 0 1305 1306 -5 0 1303 1304 0 1307 1308 -13 0 1279 1280 1281 1282 -14 0 1267 1268 1269 1270 -3 0 1305 1306 -2 0 1297 1298 -3 0 1267 1268 1269 1270 -5 0 402 403 404 405 -2 0 1137 1138 1139 1140 -16 0 1303 1304 -4 0 1303 1304 -5 0 1305 1306 0 1309 1310 -13 0 1283 1284 1285 1286 -14 0 1271 1272 1273 1274 -3 0 1303 1304 -2 0 1299 1300 -3 0 1271 1272 1273 1274 -5 0 406 407 408 409 -2 0 1145 1146 1147 1148 -16 0 1305 1306 -4 0 1305 1306 -5 0 1307 1308 -34 0 1275 1276 1277 1278 -3 0 1305 1306 -2 0 1301 1302 -3 0 1275 1276 1277 1278 -5 0 426 427 428 429 404 405 1153 1154 1155 1156 -16 0 1307 1308 360 -3 0 1307 1308 -5 0 1309 1310 -30 0 402 403 404 405 1279 1280 1281 1282 -3 0 1307 1308 -2 0 1307 1308 -3 0 1279 1280 1281 1282 -5 0 430 431 432 433 408 409 1161 1162 1163 1164 -16 0 1309 1310 -4 0 1309 1310 -4 0 360 -32 0 406 407 408 409 1283 1284 1285 1286 -3 0 1309 1310 -2 0 1309 1310 -3 0 1283 1284 1285 1286 -860 0)
    )
    (tilemap
      (solid #t)
      (z-pos 0)
      (width 100)
      (height 40)
      (tiles -473 0 -2 44 -9 0 -8 48 -92 0 133 -5 0 211 -75 0 -2 44 -11 0 -2 44 -3 0 133 -5 0 212 -81 0 -4 2153 -8 0 133 -4 0 132 213 -92 0 27 -8 28 29 -50 0 57 58 -17 0 -2 44 0 -4 2153 -9 0 -4 2153 -9 0 -4 2153 -44 0 -8 48 -93 0 211 27 29 27 29 211 -94 0 212 27 28 29 47 212 -11 0 317 318 -2 0 -4 2153 -75 0 212 47 27 28 29 212 -11 0 319 320 -81 0 212 27 29 27 29 212 -4 0 27 -7 28 29 -62 0 47 -4 0 47 -15 0 -2 28 29 212 -75 0 47 -4 44 47 -15 0 29 0 47 212 -70 0 128 -4 0 47 -4 44 47 -3 0 47 -4 0 47 -6 0 -2 28 29 213 -75 0 27 -4 28 29 -3 0 47 -4 76 47 -2 0 27 -9 28 29 -63 0 1746 1747 -16 0 47 -4 75 47 -75 0 1760 1748 1749 1752 1753 -14 0 27 -4 28 29 -76 0 1750 1751 1754 1755 1757 -95 0 1746 0 1758 1759 -98 0 1752 1753 -96 0 1750 0 1754 1755 1756 1757 -68 0 -2 83 102 83 -24 0 1758 1759 -196 0 1746 1747 0 1759 -35 0 -4 83 -13 0 -2 44 -15 0 1051 1001 1002 1001 1002 1001 1052 -8 0 1003 -2 0 1000 1001 1002 1003 -3 0 1760 1761 1748 1749 -26 0 1051 1001 1002 1001 1002 1052 -21 0 44 0 44 -15 0 1053 1005 1006 1005 1006 1005 1054 -7 0 1000 1007 -2 0 1004 1005 1006 1007 -5 0 1750 1751 -26 0 1053 1005 1006 1005 1006 1054 -16 0 1569 -6 0 44 -2 0 1060 -2 1001 1061 -8 0 1045 1055 -5 1009 1056 1002 1001 1002 1001 1002 1001 1002 1036 1011 -2 0 1008 1009 1010 1035 1002 1001 1002 1001 1002 1001 1061 -24 0 1060 1002 1055 1009 -2 1013 1009 1056 1002 1001 1002 1001 1002 1001 1002 1001 1002 1001 1002 1001 1003 0 1569 0 1572 0 1000 1002 1001 1002 1001 1002 1001 1063 1064 -2 1005 1065 1066 1001 1002 1001 1002 1001 1002 1001 1047 1057 -5 1013 1058 1006 1005 1006 1005 1006 1005 1006 1040 1015 -2 0 1016 1017 1018 1041 1006 1005 1006 1005 1006 1005 1048 1001 1002 1001 1002 1001 1002 1001 1002 1001 1002 1001 1002 1001 1002 1001 1002 1001 1002 1001 1002 1001 1002 1001 1063 1064 1006 1057 1009 -2 1014 1009 1058 1006 1005 1006 1005 1006 1005 1006 1005 1006 1005 1006 1005 1007 1569 1572 1569 1573 1569 1004 1006 1005 1006 1005 1006 1005 1067 -4 1068 1043 1005 1006 1005 1006 1005 1006 1005 1057 -15 1009 1011 -6 0 -6 44 1050 1005 1006 1005 1006 1005 1006 1005 1006 1005 1006 1005 1006 1005 1006 1005 1006 1005 1006 1005 1006 1005 1006 1005 1067 1068 1010 -11 1014 -7 1009 1035 1571 1570 1572 1571 1572 1034 -4 1013 -17 1009 -14 1013 1015 1724 1725 1724 1725 1724 1725 -6 44 -38 1009 -7 1013 1041 1006 1005 1006 1005 1006 1040 -13 1009 1013 -3 1009 -2 1013 1009 1013 -14 1009 1014 1013 1014 1013 1014 1013 1014 -11 1013 -17 1009 -5 1013 -17 1009 1013 1014 1013 1014 1013 1014 1013 1014 -6 1013 -2 1009 -9 1013 -45 1009 1013 -3 1009 -2 1013 1009 1013 -14 1009 1013 -3 1009 -2 1013 1009 1013 -14 1009 -3 1013 -5 1009 1013 -18 1009 1013 -10 1009 1013 -3 1009 1013 -4 1009 -2 1013 -2 1009 -9 1013 1009 -2 1013 -6 1009 -2 1013 -2 1009 -9 1013 1009 -2 1013 -4 1009 1013 -8 1009 -2 1013 -2 1009 -2 1013 -2 1009 -7 1013 -5 1009 -2 1013 -2 1009 -9 1013 -2 1009 -9 1013 -7 1009 -3 1013 -5 1009 1013 -4 1009 1013 1009 1013 -2 1009 -2 1013 -2 1009 -3 1013 -5 1009 1013 -4 1009 1013 1009 -9 1013 -2 1009 -9 1013 1009 -2 1013 -11 1009 -3 1013 -5 1009 1013 -2 1009 -3 1013 -5 1009 1013 -3 1009 -2 1013 -2 1009 -2 1013 -2 1009 -2 1013 -2 1009 -9 1013 1009 -3 1013 1009 -2 1013 -2 1009 -2 1013 -2 1009 -9 1013 -4 1009 1013 -4 1009 -3 1013 -5 1009 1013 -4 1009 1013 -2 1009 -4 1013 -2 1009 -3 1013 -2 1009 -2 1013 -2 1009 -5 1013 -2 1009 -2 1013 -2 1009 -6 1013 -2 1009 -3 1013 -5 1009 1013 -4 1009 1013 1009 -5 1013 -2 1009 -2 1013 -2 1009 -11 1013 -2 1009 -2 1013 -2 1009 -7 1013 -2 1009 -2 1013 -2 1009 -12 1013 -2 1009 -3 1013 -5 1009 1013 -4 1009 1013)
    )
    (tilemap
      (solid #f)
      (z-pos 100)
      (width 100)
      (height 40)
      (tiles -101 0 1311 -3 0 1311 -3 0 -2 1311 -6 0 1311 -4 0 1311 -2 0 1311 -3 0 1311 -3 0 1311 -3 0 1311 -63 0 1311 0 1311 0 1311 -3 0 1311 0 1311 -4 0 1311 -4 0 -2 1311 0 1311 0 1311 0 1311 0 1311 0 1311 0 1311 0 1311 -64 0 1311 0 1311 0 1311 -3 0 -2 1311 -5 0 -2 1311 -3 0 1311 -4 0 1311 0 1311 0 1311 0 1311 0 1311 0 -2 1311 -63 0 -5 1311 -3 0 1311 0 1311 -4 0 1311 0 1311 0 1311 -4 0 1311 -2 0 1311 0 1311 0 1311 0 1311 0 1311 0 1311 -63 0 1311 0 1311 -2 0 1311 0 -2 1311 -2 0 1311 -3 0 1311 -2 0 1311 -3 0 -3 1311 -2 0 1311 -3 0 1311 -3 0 1311 -49 0 211 27 29 211 -81 0 85 86 87 88 -11 0 212 0 47 212 -81 0 89 90 91 92 -11 0 213 27 29 213 -74 0 85 86 87 88 -9 0 85 86 87 88 0 27 85 86 87 88 -3 28 85 86 87 88 -70 0 89 90 91 92 -9 0 89 90 91 92 -2 0 89 90 91 92 -3 0 89 90 91 92 -166 0 85 86 87 88 -96 0 89 90 91 92 -465 0 47 -4 0 47 -94 0 47 -4 201 47 -94 0 47 -4 200 47 -94 0 27 -4 28 29 -858 0 1608 1609 -98 0 1610 1611 -110 0 1041 1006 1005 1006 1005 1006 1005 1048 -92 0 1008 1009 -5 1013 1050 -45 0 1002 1001 1002 1001 1002 -42 0 1012 1013 -6 1009 -92 0 1009 -7 1013 -586 0)
    )
    (viciousivy
      (z-pos 50)
      (x 738)
      (y 548)
      (glinting #f)
    )
    (viciousivy
      (z-pos 50)
      (direction "right")
      (x 514)
      (y 996)
      (glinting #f)
    )
    (viciousivy
      (z-pos 50)
      (direction "right")
      (x 2210)
      (y 964)
      (glinting #f)
    )
    (walkingleaf
      (z-pos 50)
      (direction "right")
      (x 1346)
      (y 900)
      (glinting #f)
    )
    (zeekling
      (z-pos 50)
      (direction "right")
      (x 584.8937)
      (y 706.1041)
      (glinting #f)
    )
  )
  (sector
    (name "tree house")
    (ambient-light
      (color 1 1 1)
    )
    (background
      (color 1 1 1)
      (speed 0.5)
      (image "images/background/BlueRock_Forest/blue-top.jpg")
    )
    (camera
      (name "Camera")
      (mode "normal")
    )
    (candle
      (z-pos -99)
      (x 640)
      (y 512)
    )
    (door
      (z-pos -99)
      (sector "main")
      (locked #f)
      (spawnpoint "ExitTreeHouse")
      (x 192)
      (y 477)
    )
    (mrbomb
      (z-pos 50)
      (direction "left")
      (x 421)
      (y 424)
      (glinting #f)
    )
    (music
      (file "music/forest.music")
    )
    (particles-clouds
    )
    (scripttrigger
      (script "Level.spawn(\"main\", \"roof\");")
      (button #f)
      (width 64)
      (height 32)
      (x 832)
      (y 96)
    )
    (spawnpoint
      (name "InsideTreeHouse")
      (x 192)
      (y 512)
    )
    (spawnpoint
      (name "main")
      (x 192)
      (y 512)
    )
    (tilemap
      (solid #f)
      (z-pos -100)
      (width 34)
      (height 35)
      (tiles -11 0 1111 1112 1113 1114 1115 1116 1117 1118 -26 0 1119 1120 1121 1122 1123 1124 1125 1126 -26 0 1127 1128 1137 1138 1139 1140 1133 1134 -20 0 -24 1160 -10 0 -24 1160 -10 0 -24 1160 -10 0 -24 1160 -10 0 -24 1160 -10 0 -24 1160 -10 0 -24 1160 -10 0 -24 1160 -10 0 -24 1160 -3 0 1141 -6 0 -24 1160 -10 0 -24 1160 -10 0 -24 1160 -10 0 -24 1160 -10 0 -24 1160 -10 0 -24 1160 -18 0 1137 1138 1139 1140 -8 0 -3 1160 -19 0 1145 1146 1147 1148 -527 0)
    )
    (tilemap
      (solid #t)
      (z-pos 0)
      (width 34)
      (height 35)
      (tiles -70 0 -30 48 -6 0 211 -20 0 2820 2819 2820 2819 211 -8 0 212 -24 0 212 -8 0 212 -24 0 212 -8 0 212 -7 0 44 -8 0 44 -7 0 212 -8 0 212 -6 0 -3 44 -6 0 -3 44 -2 0 27 28 29 0 212 -8 0 212 -24 0 212 -8 0 212 -3 0 27 -6 28 29 -4 0 27 28 29 -6 0 212 -8 0 212 -24 0 212 -8 0 212 -24 0 212 -8 0 212 -13 0 47 -10 0 212 -8 0 212 -24 0 212 -8 0 212 -5 0 -3 83 -2 77 -2 83 -6 0 -2 83 102 83 -2 0 212 -8 0 212 -24 0 212 -8 0 212 -24 0 212 -8 0 213 -15 0 104 -8 0 213 -4 0 27 -32 28 29 -47 0 1145 1146 1147 1148 -30 0 1145 1146 1147 1148 -30 0 1145 1146 1147 1148 -30 0 1145 1146 1147 1148 -30 0 1145 1146 1147 1148 -30 0 1145 1146 1147 1148 -30 0 1145 1146 1147 1148 -30 0 1145 1146 1147 1148 -30 0 1145 1146 1147 1148 -30 0 1145 1146 1147 1148 -30 0 1145 1146 1147 1148 -30 0 1145 1146 1147 1148 -30 0 1145 1146 1147 1148 -30 0 1145 1146 1147 1148 -30 0 1145 1146 1147 1148 -17 0)
    )
    (tilemap
      (solid #f)
      (z-pos 100)
      (width 34)
      (height 35)
      (tiles -60 0 57 58 -66 0 1742 1743 -66 0 1620 1621 -32 0 1622 1623 -958 0)
    )
    (tilemap
      (solid #f)
      (z-pos -150)
      (name "Black")
      (width 34)
      (height 35)
      (tiles -106 0 -26 131 -8 0 -26 131 -8 0 -26 131 -8 0 -26 131 -8 0 -26 131 -8 0 -26 131 -8 0 -26 131 -8 0 -26 131 -8 0 -26 131 -8 0 -26 131 -8 0 -26 131 -8 0 -26 131 -8 0 -26 131 -8 0 -26 131 -8 0 -26 131 -8 0 -26 131 -548 0)
    )
    (viciousivy
      (z-pos 50)
      (direction "left")
      (x 768)
      (y 544)
      (glinting #f)
    )
    (viciousivy
      (z-pos 50)
      (direction "left")
      (x 482)
      (y 548)
      (glinting #f)
    )
    (walkingleaf
      (z-pos 50)
      (direction "left")
      (x 320)
      (y 256)
      (glinting #f)
    )
    (walkingleaf
      (z-pos 50)
      (direction "right")
      (x 770)
      (y 420)
      (glinting #f)
    )
  )
)
