(supertux-level
  (version 3)
  (name (_ "Shocking"))
  (author "Christoph Sommer")
  (license "GPL 2+ / CC-by-sa 3.0")
  (allow-item-pocket "inherit")
  (icon "")
  (icon-locked "")
  (statistics
    (enable-coins #t)
    (enable-secrets #t)
  )
  (sector
    (name "main")
    (ambient-light
      (color 0.5735561 0.4489815 0.5647517)
    )
    (background
      (color 1 1 1)
      (alignment "top")
      (speed 0.5)
      (image "images/background/ocean.jpg")
      (image-bottom "images/background/bluemountain-bottom.png")
    )
    (camera
      (name "Camera")
      (mode "normal")
    )
    (firefly
      (z-pos 0)
      (x 4480)
      (y 448)
    )
    (jumpy
      (type "wooden")
      (z-pos 50)
      (x 2752)
      (y 480)
      (glinting #f)
    )
    (jumpy
      (type "wooden")
      (z-pos 50)
      (x 7056)
      (y 400)
      (glinting #f)
    )
    (mrbomb
      (z-pos 50)
      (x 1824)
      (y 496)
      (glinting #f)
    )
    (mrbomb
      (z-pos 50)
      (x 5440)
      (y 432)
      (glinting #f)
    )
    (mrtree
      (z-pos 50)
      (x 1088)
      (y 512)
      (glinting #f)
    )
    (mrtree
      (z-pos 50)
      (x 5792)
      (y 448)
      (glinting #f)
    )
    (music
      (file "music/cave.music")
    )
    (particles-rain
    )
    (powerup
      (z-pos 50)
      (script "add_key(\"water\");
Tux.deactivate();
wait(0.5);
Tux.do_cheer();
end_level();")
      (sprite "images/objects/keys/key_water.sprite")
      (x 7968)
      (y 416)
    )
    (spawnpoint
      (name "main")
      (x 96)
      (y 416)
    )
    (thunderstorm
      (interval 5)
    )
    (thunderstorm
      (interval 7)
    )
    (tilemap
      (solid #f)
      (z-pos -100)
      (name "TileBG")
      (width 256)
      (height 32)
      (tiles -2625 0 1353 2012 -239 0 -2 1353 -3 0 -11 1353 2012 -238 0 -17 1353 2012 -236 0 -19 1353 2012 -235 0 -20 1353 2012 -235 0 -20 1353 2012 -234 0 2007 -20 1353 -235 0 2007 -20 1353 -235 0 2007 -6 1353 -249 0 2007 -6 1353 -3276 0)
    )
    (tilemap
      (solid #t)
      (z-pos 0)
      (name "Interactive")
      (width 256)
      (height 32)
      (tiles -1079 0 128 -3 83 -760 0 1000 1001 -9 1002 1003 -242 0 1000 1002 1036 1005 -9 1006 1037 1001 -2 1002 1003 -235 0 1000 1001 1002 1036 1006 1040 -9 1009 1010 1041 1005 -2 1006 1007 -234 0 1000 1036 1005 1006 1040 -16 1009 1019 -234 0 1004 1040 1020 1022 -7 1009 -2 1017 1018 -2 1017 1018 1017 -2 1018 1019 -4 0 112 -24 0 -2 83 -204 0 1008 1009 1026 1028 1009 1017 1018 1017 -2 1018 1019 -245 0 1008 -3 1009 1019 -218 0 317 318 -31 0 1008 1009 1018 1019 -16 0 1000 -8 1002 1003 -145 0 1000 1002 1003 -33 0 -12 1002 319 320 -8 1002 1003 -7 0 -2 83 102 83 -11 0 1008 1015 -5 0 313 314 -6 0 1723 1724 1726 -2 0 1004 -8 1006 1037 1003 -18 0 83 102 -2 83 -15 0 1000 1001 -3 1002 1003 -29 0 -3 83 -4 0 1000 1001 -2 1002 1003 0 83 102 -2 0 317 318 -3 0 -2 83 -3 0 1000 1003 -8 0 1000 1002 1003 -26 0 1000 -5 1002 1036 1006 1037 1003 -14 0 1000 1001 -16 1002 -2 1006 1005 -2 1006 1005 -2 1006 1005 -2 1006 1005 -2 1006 1005 -4 1006 1005 -2 1006 1037 1001 -2 1002 1003 -10 0 1000 1001 1003 -5 0 1016 1019 -4 0 1723 315 316 1725 -5 1724 1817 1013 1820 -2 1724 1817 -8 1009 1041 1037 1001 1002 1003 -33 0 1000 1036 1005 -3 1006 1037 1001 1002 1003 -15 0 1000 -5 1002 1003 -10 0 1000 1036 1005 -2 1006 1007 -5 0 319 320 1003 -6 0 1000 1036 1037 1001 -7 1002 1036 1006 1037 1003 -25 0 1004 1006 1005 -3 1006 1040 1009 1041 1007 -14 0 1004 1005 -2 1006 1005 1006 1005 1006 1005 1006 1005 1006 1005 1006 1005 1006 1005 1006 -20 1009 1020 1022 1041 1005 -2 1006 1007 -10 0 1004 1005 1007 -11 0 1817 -2 1013 1014 -5 1013 -3 1009 -2 1013 -4 1009 1020 -4 1021 1022 1041 1005 1006 1007 -33 0 1004 1040 1009 1533 1534 1535 1041 1005 1006 1007 -15 0 1004 -5 1005 1007 -10 0 1004 1040 1009 1010 1009 1019 -5 0 1004 1005 1007 -6 0 1004 1040 1041 1005 -7 1006 1040 1010 1041 1007 -25 0 1016 -8 1009 1019 -14 0 1016 -11 1009 1010 -25 1009 1026 1028 -4 1009 1035 1001 -9 1002 1034 1009 1035 1001 -10 1002 1034 -17 1009 1023 -4 1024 1025 -3 1009 1035 1001 -31 1002 1000 1034 -2 1009 1536 1537 1538 -3 1009 1035 1001 -14 1002 1034 -5 1009 1035 -10 1002 1034 -3 1009 1035 1001 -5 1002 1034 1009 1035 1001 -4 1002 1000 1034 -13 1009 1035 -26 1002 1034 1014 -5 1009 1035 1002 1001 -14 1002 1034 1014 -41 1009 1041 1005 1006 1005 -2 1006 1005 -2 1006 1005 1006 1040 1009 1041 1005 -2 1006 1005 -2 1006 1005 1006 1005 -2 1006 1040 -17 1009 1026 -4 1027 1028 -3 1009 1041 1005 1006 1005 1006 1005 1006 1005 1006 1005 1006 1005 1006 1005 1006 1005 1006 1005 1006 1005 1006 1005 1006 1005 1006 1005 1006 1005 1006 1005 1006 1005 -2 1006 1040 -8 1009 1041 1005 -2 1006 1005 -2 1006 1005 -2 1006 1005 -2 1006 1005 -2 1006 1040 -5 1009 1041 -4 1006 1005 -2 1006 1005 -2 1006 1040 -3 1009 1041 1005 -2 1006 1005 -2 1006 1040 1014 1041 1005 -2 1006 1005 -2 1006 1040 -13 1009 1041 -2 1006 1005 -2 1006 1005 -2 1006 1005 -2 1006 1005 -2 1006 1005 -2 1006 1005 -2 1006 1005 -2 1006 1005 -2 1006 1040 1013 -5 1009 1041 1006 1005 -2 1006 1005 -2 1006 1005 -2 1006 1005 -2 1006 1005 -2 1006 1040 1013 -3087 1009)
    )
    (tilemap
      (solid #f)
      (z-pos 100)
      (name "Foreground")
      (width 256)
      (height 32)
      (tiles -8192 0)
    )
    (tilemap
      (solid #t)
      (z-pos 90)
      (name "Water")
      (width 256)
      (height 32)
      (tiles -4608 0 -256 201 -3328 200)
    )
    (tilemap
      (solid #f)
      (z-pos -90)
      (name "DecoBG")
      (width 256)
      (height 32)
      (tiles -840 0 1240 1241 1242 -252 0 1243 1244 1245 1246 -81 0 1240 1241 1242 -120 0 1073 1074 1075 -45 0 1247 1248 1249 1250 -43 0 1073 1074 1075 -34 0 1243 1244 1245 1246 -22 0 1073 1074 1075 -95 0 1081 1082 1083 1084 -44 0 1251 1252 1253 1254 -43 0 1081 1082 1083 1084 -33 0 1247 1248 1249 1250 -22 0 1081 1082 1083 1084 -93 0 1088 1089 1090 1091 1092 1093 -43 0 1255 1256 1257 1258 -42 0 1088 1089 1090 1091 1092 1093 -32 0 1251 1252 1253 1254 -21 0 1088 1089 1090 1091 1092 1093 -91 0 1095 1096 1097 1098 1099 1100 1101 -19 0 402 403 404 405 -20 0 1259 1260 1261 1262 -41 0 1095 1096 1097 1098 1099 1100 1101 -32 0 1255 1256 1257 1258 -20 0 1095 1096 1097 1098 1099 1100 1101 -91 0 1103 1104 1105 1106 1107 1108 1109 1110 -18 0 406 407 408 409 -20 0 1263 1264 1265 1266 -41 0 1103 1104 1105 1106 1107 1108 1109 1110 -31 0 1259 1260 1261 1262 -20 0 1103 1104 1105 1106 1107 1108 1109 1110 -90 0 1111 1112 1113 1114 1115 1116 1117 1118 -18 0 410 411 412 413 -20 0 1267 1268 1269 1270 -41 0 1111 1112 1113 1114 1115 1116 1117 1118 -31 0 1263 1264 1265 1266 -20 0 1111 1112 1113 1114 1115 1116 1117 1118 -90 0 1119 1120 1121 1122 1123 1124 1125 1126 -42 0 1271 1272 1273 1274 -41 0 1119 1120 1121 1122 1123 1124 1125 1126 -31 0 1267 1268 1269 1270 -20 0 1119 1120 1121 1122 1123 1124 1125 1126 -90 0 1127 1128 1129 1130 1131 1132 1133 1134 -22 0 323 324 -18 0 1275 1276 1277 1278 -41 0 1127 1128 1129 1130 1131 1132 1133 1134 -31 0 1271 1272 1273 1274 -20 0 1127 1128 1129 1130 1131 1132 1133 1134 -92 0 1137 1138 1139 1140 1141 -23 0 325 326 -18 0 1279 1280 1281 1282 -43 0 1137 1138 1139 1140 1141 -32 0 1275 1276 1277 1278 -22 0 1137 1138 1139 1140 1141 -93 0 1145 1146 1147 1148 -24 0 327 328 -18 0 1283 1284 1285 402 403 404 405 -40 0 1145 1146 1147 1148 -33 0 1279 1280 1281 1282 -17 0 402 403 404 405 0 1145 1146 1147 1148 -83 0 -2 1002 -9 0 1153 1154 1155 1156 -24 0 329 330 -7 0 360 -13 0 406 407 408 409 -40 0 1153 1154 1155 1156 -33 0 1283 1284 1285 1286 -17 0 406 407 408 409 0 1153 1154 1155 1156 -94 0 1161 1162 1163 1164 -24 0 322 -2 1724 -20 0 410 411 412 413 -32 0 402 403 404 405 -4 0 1161 1162 1163 1164 -36 0 402 403 404 405 -3 0 1000 1001 -9 0 410 411 412 413 0 1161 1162 1163 1164 -3 0 322 -24 0 402 403 404 405 -5 0 402 403 404 405 -64 0 402 403 404 405 -72 0 406 407 408 409 -44 0 406 407 408 409 -51 0 406 407 408 409 -5 0 406 407 408 409 -64 0 406 407 408 409 -72 0 410 411 412 413 -44 0 410 411 412 413 -51 0 410 411 412 413 -5 0 410 411 412 413 -64 0 410 411 412 413 -3290 0)
    )
    (viciousivy
      (z-pos 50)
      (x 656)
      (y 464)
      (glinting #f)
    )
    (viciousivy
      (z-pos 50)
      (x 4096)
      (y 560)
      (glinting #f)
    )
    (viciousivy
      (z-pos 50)
      (x 5200)
      (y 560)
      (glinting #f)
    )
    (viciousivy
      (z-pos 50)
      (x 6720)
      (y 560)
      (glinting #f)
    )
    (viciousivy
      (z-pos 50)
      (x 6544)
      (y 560)
      (glinting #f)
    )
    (viciousivy
      (z-pos 50)
      (x 7456)
      (y 560)
      (glinting #f)
    )
    (walkingleaf
      (z-pos 50)
      (x 992)
      (y 432)
      (glinting #f)
    )
    (walkingleaf
      (z-pos 50)
      (x 2160)
      (y 432)
      (glinting #f)
    )
    (walkingleaf
      (z-pos 50)
      (x 3040)
      (y 432)
      (glinting #f)
    )
    (walkingleaf
      (z-pos 50)
      (x 3680)
      (y 464)
      (glinting #f)
    )
    (walkingleaf
      (z-pos 50)
      (x 4768)
      (y 432)
      (glinting #f)
    )
    (walkingleaf
      (z-pos 50)
      (x 6896)
      (y 464)
      (glinting #f)
    )
  )
)
