(supertux-level
  (version 3)
  (name (_ "The Silent Walls"))
  (author "Christoph Sommer")
  (license "GPL 2+ / CC-by-sa 3.0")
  (allow-item-pocket "inherit")
  (icon "")
  (icon-locked "")
  (statistics
    (enable-coins #t)
    (enable-secrets #t)
  )
  (sector
    (name "main")
    (ambient-light
      (color 1 1 1)
    )
    (camera
      (name "Camera")
      (mode "normal")
    )
    (firefly
      (z-pos 0)
      (x 464)
      (y 1520)
    )
    (firefly
      (z-pos 0)
      (x 3040)
      (y 256)
    )
    (flame
      (z-pos 150)
      (x 1408)
      (y 640)
    )
    (flame
      (z-pos 150)
      (x 1808)
      (y 2016)
    )
    (flame
      (z-pos 150)
      (x 960)
      (y 1184)
    )
    (hurting_platform
      (z-pos 50)
      (handle
        (scale_x 0)
        (scale_y 0)
        (offset_x 0)
        (offset_y 0)
      )
      (path-ref "gen1772929895104989834074976")
    )
    (hurting_platform
      (z-pos 50)
      (handle
        (scale_x 0)
        (scale_y 0)
        (offset_x 0)
        (offset_y 0)
      )
      (path-ref "gen1772929895104989800916496")
    )
    (hurting_platform
      (z-pos 50)
      (handle
        (scale_x 0)
        (scale_y 0)
        (offset_x 0)
        (offset_y 0)
      )
      (path-ref "gen1772929895104989797870000")
    )
    (ispy
      (z-pos 5)
      (script "door2a.goto_node(1);
door2b.goto_node(1);
")
      (direction "down")
      (x 288)
      (y 1792)
    )
    (ispy
      (z-pos 5)
      (script "lift3a.goto_node(1);
lift3a.goto_node(0);

")
      (direction "right")
      (x 2162)
      (y 1218)
    )
    (ispy
      (z-pos 5)
      (script "lift3a.goto_node(1);
lift3a.goto_node(0);

")
      (x 2364)
      (y 1218)
    )
    (ispy
      (z-pos 5)
      (script "trap1a.goto_node(1);
trap1b.goto_node(1);
trap1a.goto_node(0);
trap1b.goto_node(0);
")
      (x 2044.5)
      (y 1218)
    )
    (ispy
      (z-pos 5)
      (script "door4a.goto_node(0);
door4b.goto_node(0);
door3a.goto_node(1);
door3b.goto_node(1);
")
      (direction "down")
      (x 960)
      (y 1376)
    )
    (ispy
      (z-pos 5)
      (script "door4a.goto_node(1);
door4b.goto_node(1);
door3a.goto_node(0);
door3b.goto_node(0);
")
      (direction "down")
      (x 1376)
      (y 1440)
    )
    (ispy
      (z-pos 5)
      (script "door6a.goto_node(1);
door6b.goto_node(1);
")
      (direction "down")
      (x 3104)
      (y 160)
    )
    (jumpy
      (type "wooden")
      (z-pos 50)
      (x 759)
      (y 1192)
      (glinting #f)
    )
    (jumpy
      (type "wooden")
      (z-pos 50)
      (x 2098)
      (y 1075)
      (glinting #f)
    )
    (jumpy
      (type "wooden")
      (z-pos 50)
      (x 2162)
      (y 355)
      (glinting #f)
    )
    (jumpy
      (type "wooden")
      (z-pos 50)
      (x 2354)
      (y 355)
      (glinting #f)
    )
    (jumpy
      (type "wooden")
      (z-pos 50)
      (x 679)
      (y 1896)
      (glinting #f)
    )
    (music
      (file "music/darkforestkeep.ogg")
    )
    (path
      (name "gen1772929895104989740598208")
      (path
        (adapt_speed #f)
        (node
          (x 0)
          (y 1760)
        )
      )
    )
    (path
      (name "gen1772929895104989801375408")
      (path
        (adapt_speed #f)
        (node
          (x 0)
          (y 1888)
        )
      )
    )
    (path
      (name "gen1772929895104989843248176")
      (path
        (adapt_speed #f)
        (node
          (x 352)
          (y 1760)
        )
        (node
          (x 352)
          (y 1696)
        )
        (node
          (x 352)
          (y 1696)
        )
      )
    )
    (path
      (name "gen1772929895104989805421152")
      (path
        (adapt_speed #f)
        (node
          (x 352)
          (y 1888)
        )
        (node
          (x 352)
          (y 1952)
        )
        (node
          (x 352)
          (y 1952)
        )
      )
    )
    (path
      (name "gen1772929895104989798625968")
      (path
        (adapt_speed #f)
        (node
          (x 1312)
          (y 1408)
          (time 2)
        )
        (node
          (x 1312)
          (y 1344)
          (time 2)
        )
      )
    )
    (path
      (name "gen1772929895104989798626240")
      (path
        (adapt_speed #f)
        (node
          (x 1312)
          (y 1536)
          (time 2)
        )
        (node
          (x 1312)
          (y 1600)
          (time 2)
        )
      )
    )
    (path
      (name "gen1772929895104989797370112")
      (path
        (adapt_speed #f)
        (node
          (x 608)
          (y 1536)
        )
        (node
          (x 608)
          (y 1600)
        )
      )
    )
    (path
      (name "gen1772929895104989797370384")
      (path
        (adapt_speed #f)
        (node
          (x 608)
          (y 1408)
        )
        (node
          (x 608)
          (y 1344)
        )
      )
    )
    (path
      (name "gen1772929895104989798681088")
      (path
        (adapt_speed #f)
        (node
          (x 2912)
          (y 256)
        )
        (node
          (x 2912)
          (y 320)
        )
      )
    )
    (path
      (name "gen1772929895104989798681360")
      (path
        (adapt_speed #f)
        (node
          (x 2912)
          (y 128)
        )
        (node
          (x 2912)
          (y 64)
        )
      )
    )
    (path
      (name "gen1772929895104989805480128")
      (path
        (adapt_speed #f)
        (node
          (x 3168)
          (y 128)
        )
        (node
          (x 3168)
          (y 64)
        )
      )
    )
    (path
      (name "gen1772929895104989822892064")
      (path
        (adapt_speed #f)
        (node
          (x 3168)
          (y 256)
        )
        (node
          (x 3168)
          (y 320)
        )
      )
    )
    (path
      (name "gen1772929895104989805401152")
      (path
        (adapt_speed #f)
        (node
          (x 1696)
          (y 1248)
          (time 0.2)
        )
        (node
          (x 1696)
          (y 1312)
          (time 0.5)
        )
        (node
          (x 1568)
          (y 1312)
          (time 2)
        )
        (node
          (x 1696)
          (y 1312)
        )
      )
    )
    (path
      (name "gen1772929895104989741543664")
      (path
        (adapt_speed #f)
        (node
          (x 1824)
          (y 1248)
          (time 0.2)
        )
        (node
          (x 1824)
          (y 1312)
          (time 0.5)
        )
        (node
          (x 1952)
          (y 1312)
          (time 2)
        )
        (node
          (x 1824)
          (y 1312)
        )
      )
    )
    (path
      (name "gen1772929895104989822999536")
      (path
        (adapt_speed #f)
        (node
          (x 2208)
          (y 1248)
          (time 6)
        )
        (node
          (x 2208)
          (y 416)
          (time 3)
        )
        (node
          (x 2208)
          (y 416)
          (time 6)
        )
      )
    )
    (path
      (name "gen1772929895104989823017904")
      (path
        (adapt_speed #f)
        (node
          (x 1824)
          (y 1952)
          (time 3)
        )
        (node
          (x 1824)
          (y 1440)
        )
        (node
          (x 1696)
          (y 1440)
          (time 3)
        )
        (node
          (x 1696)
          (y 1952)
        )
      )
    )
    (path
      (name "gen1772929895104989814542752")
      (path
        (adapt_speed #f)
        (node
          (x 1696)
          (y 1440)
          (time 3)
        )
        (node
          (x 1696)
          (y 1952)
        )
        (node
          (x 1824)
          (y 1952)
          (time 3)
        )
        (node
          (x 1824)
          (y 1440)
        )
      )
    )
    (path
      (name "gen1772929895104989814391216")
      (path
        (adapt_speed #f)
        (node
          (x 1088)
          (y 1408)
        )
        (node
          (x 1088)
          (y 1248)
          (time 3)
        )
        (node
          (x 800)
          (y 1248)
        )
        (node
          (x 800)
          (y 1408)
          (time 3)
        )
      )
    )
    (path
      (name "gen1772929895104989843023264")
      (path
        (adapt_speed #f)
        (node
          (x 800)
          (y 1248)
        )
        (node
          (x 800)
          (y 1408)
          (time 3)
        )
        (node
          (x 1088)
          (y 1408)
        )
        (node
          (x 1088)
          (y 1248)
          (time 3)
        )
      )
    )
    (path
      (name "gen1772929895104989834074976")
      (path
        (adapt_speed #f)
        (node
          (x 200.5807)
          (y 1523.238)
        )
      )
    )
    (path
      (name "gen1772929895104989800916496")
      (path
        (adapt_speed #f)
        (node
          (x 375.7565)
          (y 1299.277)
        )
      )
    )
    (path
      (name "gen1772929895104989797870000")
      (path
        (adapt_speed #f)
        (node
          (x 311.0601)
          (y 1363.076)
        )
      )
    )
    (platform
      (z-pos 50)
      (handle
        (scale_x 0)
        (scale_y 0)
        (offset_x 0)
        (offset_y 0)
      )
      (running #f)
      (name "door1a")
      (path-ref "gen1772929895104989740598208")
      (sprite "images/objects/platforms/vertical-wood.sprite")
    )
    (platform
      (z-pos 50)
      (handle
        (scale_x 0)
        (scale_y 0)
        (offset_x 0)
        (offset_y 0)
      )
      (running #f)
      (name "door1b")
      (path-ref "gen1772929895104989801375408")
      (sprite "images/objects/platforms/vertical-wood.sprite")
    )
    (platform
      (z-pos 50)
      (handle
        (scale_x 0)
        (scale_y 0)
        (offset_x 0)
        (offset_y 0)
      )
      (running #f)
      (name "door2a")
      (path-ref "gen1772929895104989843248176")
      (sprite "images/objects/platforms/vertical-wood.sprite")
    )
    (platform
      (z-pos 50)
      (handle
        (scale_x 0)
        (scale_y 0)
        (offset_x 0)
        (offset_y 0)
      )
      (running #f)
      (name "door2b")
      (path-ref "gen1772929895104989805421152")
      (sprite "images/objects/platforms/vertical-wood.sprite")
    )
    (platform
      (z-pos 50)
      (handle
        (scale_x 0)
        (scale_y 0)
        (offset_x 0)
        (offset_y 0)
      )
      (running #f)
      (name "door3a")
      (path-ref "gen1772929895104989798625968")
      (sprite "images/objects/platforms/vertical-wood.sprite")
    )
    (platform
      (z-pos 50)
      (handle
        (scale_x 0)
        (scale_y 0)
        (offset_x 0)
        (offset_y 0)
      )
      (running #f)
      (name "door3b")
      (path-ref "gen1772929895104989798626240")
      (sprite "images/objects/platforms/vertical-wood.sprite")
    )
    (platform
      (z-pos 50)
      (handle
        (scale_x 0)
        (scale_y 0)
        (offset_x 0)
        (offset_y 0)
      )
      (running #f)
      (name "door4b")
      (path-ref "gen1772929895104989797370112")
      (sprite "images/objects/platforms/vertical-wood.sprite")
    )
    (platform
      (z-pos 50)
      (handle
        (scale_x 0)
        (scale_y 0)
        (offset_x 0)
        (offset_y 0)
      )
      (running #f)
      (name "door4a")
      (path-ref "gen1772929895104989797370384")
      (sprite "images/objects/platforms/vertical-wood.sprite")
    )
    (platform
      (z-pos 50)
      (handle
        (scale_x 0)
        (scale_y 0)
        (offset_x 0)
        (offset_y 0)
      )
      (running #f)
      (name "door5b")
      (path-ref "gen1772929895104989798681088")
      (sprite "images/objects/platforms/vertical-wood.sprite")
    )
    (platform
      (z-pos 50)
      (handle
        (scale_x 0)
        (scale_y 0)
        (offset_x 0)
        (offset_y 0)
      )
      (running #f)
      (name "door5a")
      (path-ref "gen1772929895104989798681360")
      (sprite "images/objects/platforms/vertical-wood.sprite")
    )
    (platform
      (z-pos 50)
      (handle
        (scale_x 0)
        (scale_y 0)
        (offset_x 0)
        (offset_y 0)
      )
      (running #f)
      (name "door6a")
      (path-ref "gen1772929895104989805480128")
      (sprite "images/objects/platforms/vertical-wood.sprite")
    )
    (platform
      (z-pos 50)
      (handle
        (scale_x 0)
        (scale_y 0)
        (offset_x 0)
        (offset_y 0)
      )
      (running #f)
      (name "door6b")
      (path-ref "gen1772929895104989822892064")
      (sprite "images/objects/platforms/vertical-wood.sprite")
    )
    (platform
      (z-pos 50)
      (handle
        (scale_x 0)
        (scale_y 0)
        (offset_x 0)
        (offset_y 0)
      )
      (running #f)
      (name "trap1a")
      (path-ref "gen1772929895104989805401152")
      (sprite "images/objects/platforms/big.sprite")
    )
    (platform
      (z-pos 50)
      (handle
        (scale_x 0)
        (scale_y 0)
        (offset_x 0)
        (offset_y 0)
      )
      (running #f)
      (name "trap1b")
      (path-ref "gen1772929895104989741543664")
      (sprite "images/objects/platforms/big.sprite")
    )
    (platform
      (z-pos 50)
      (handle
        (scale_x 0)
        (scale_y 0)
        (offset_x 0)
        (offset_y 0)
      )
      (running #f)
      (name "lift3a")
      (path-ref "gen1772929895104989822999536")
      (sprite "images/objects/platforms/big.sprite")
    )
    (platform
      (z-pos 50)
      (handle
        (scale_x 0)
        (scale_y 0)
        (offset_x 0)
        (offset_y 0)
      )
      (name "lift1a")
      (path-ref "gen1772929895104989823017904")
      (sprite "images/objects/platforms/big.sprite")
    )
    (platform
      (z-pos 50)
      (handle
        (scale_x 0)
        (scale_y 0)
        (offset_x 0)
        (offset_y 0)
      )
      (name "lift1b")
      (path-ref "gen1772929895104989814542752")
      (sprite "images/objects/platforms/big.sprite")
    )
    (platform
      (z-pos 50)
      (handle
        (scale_x 0)
        (scale_y 0)
        (offset_x 0)
        (offset_y 0)
      )
      (name "lift2b")
      (path-ref "gen1772929895104989814391216")
      (sprite "images/objects/platforms/small.sprite")
    )
    (platform
      (z-pos 50)
      (handle
        (scale_x 0)
        (scale_y 0)
        (offset_x 0)
        (offset_y 0)
      )
      (name "lift2a")
      (path-ref "gen1772929895104989843023264")
      (sprite "images/objects/platforms/small.sprite")
    )
    (scripttrigger
      (script "Level.spawn(\"boss\",\"main\")")
      (button #f)
      (width 32)
      (height 156)
      (x 3168)
      (y 192)
    )
    (snail
      (z-pos 50)
      (x 1250)
      (y 1555)
      (glinting #f)
    )
    (snail
      (z-pos 50)
      (x 1474)
      (y 1203)
      (glinting #f)
    )
    (snail
      (z-pos 50)
      (x 1506)
      (y 275)
      (glinting #f)
    )
    (snail
      (z-pos 50)
      (x 1778)
      (y 275)
      (glinting #f)
    )
    (snail
      (z-pos 50)
      (x 1570)
      (y 1907)
      (glinting #f)
    )
    (spawnpoint
      (name "main")
      (x 96)
      (y 1856)
    )
    (spiky
      (z-pos 50)
      (x 1958)
      (y 1194)
      (glinting #f)
    )
    (spiky
      (z-pos 50)
      (x 1158)
      (y 2106)
      (glinting #f)
    )
    (spiky
      (z-pos 50)
      (x 2134)
      (y 1562)
      (glinting #f)
    )
    (spiky
      (z-pos 50)
      (x 2262)
      (y 1194)
      (glinting #f)
    )
    (spiky
      (z-pos 50)
      (x 2726)
      (y 282)
      (glinting #f)
    )
    (switch
      (z-pos 1)
      (script "door3a.goto_node(1);
door3b.goto_node(1);
")
      (sprite "images/objects/switch/left.sprite")
      (x 2323.485)
      (y 1541.536)
    )
    (switch
      (z-pos 1)
      (script "door5a.goto_node(1);
door5b.goto_node(1);
")
      (sprite "images/objects/switch/left.sprite")
      (x 1426.071)
      (y 964.1213)
    )
    (tilemap
      (solid #f)
      (speed-x 0.5)
      (speed-y 0.5)
      (z-pos -150)
      (name "TileBG")
      (width 100)
      (height 70)
      (tiles -7000 1478)
    )
    (tilemap
      (solid #f)
      (z-pos -100)
      (name "Background")
      (width 100)
      (height 70)
      (tiles -889 0 1731 1732 -98 0 1733 1734 -2051 0 1731 1732 -98 0 1733 1734 -3501 0 2138 -4 0 2139 -12 0 2136 -336 0)
    )
    (tilemap
      (solid #t)
      (z-pos 0)
      (name "Interactive")
      (width 100)
      (height 70)
      (tiles -33 1368 1371 -294 1372 1371 -96 1372 1382 -5 1372 1406 -11 1376 1394 -44 1372 1406 1376 1394 0 -4 1372 1406 1376 1394 0 -22 1372 1382 -4 1372 1406 -3 1376 1407 -11 0 1397 1376 1375 -9 1376 1375 -32 1376 1410 0 1397 0 -4 1376 1410 0 1397 0 -24 1372 1406 -2 1376 1407 -72 0 -3 1372 1371 -17 1372 1406 -2 1376 1407 -75 0 -19 1372 1406 1376 1407 -78 0 -17 1372 1406 1376 1407 -25 0 77 -15 0 -2 77 -16 0 77 -20 0 1372 1395 -13 1372 1406 1376 1407 -27 0 1367 -18 1368 1380 -12 0 1367 -13 1368 0 -7 1368 0 -4 1372 1371 -8 1372 1406 1376 1377 -29 0 1404 -18 1372 1383 1380 -10 0 1367 1371 -13 1372 0 -7 1372 0 -13 1372 1373 -30 0 1408 1396 -19 1372 1383 1380 -8 0 1367 1371 -35 1372 1406 1377 -31 0 1404 -20 1372 1383 1416 1388 -4 0 1408 1415 1371 -36 1372 1373 -30 0 -2 44 1404 -20 1372 1406 1407 -6 0 1374 1394 -35 1372 1406 1377 -32 0 1404 -20 1372 1373 0 44 -4 0 44 0 1404 -33 1372 1406 1376 1407 -32 0 1408 1396 -20 1372 1373 -8 0 1404 -33 1372 1373 -35 0 1404 -20 1372 1373 -8 0 1404 -31 1372 1406 1376 1377 -33 0 -2 44 1404 -20 1372 1373 -8 0 1404 -29 1372 1406 1376 1377 -37 0 1404 -20 1372 1373 -8 0 1404 -29 1372 1373 -38 0 1408 1396 -20 1372 1373 -8 0 1404 -29 1372 1373 -39 0 1404 -20 1372 1373 0 44 -4 0 44 0 1404 -29 1372 1373 -37 0 -2 44 1404 -20 1372 1373 -8 0 1404 -29 1372 1373 -39 0 1404 -20 1372 1373 -8 0 1404 -27 1372 1406 1376 1377 -38 0 1408 1396 -20 1372 1373 -8 0 1404 -27 1372 1373 -41 0 1404 -20 1372 1373 -8 0 1404 -27 1372 1373 -39 0 -2 44 1404 -20 1372 1373 -8 0 1404 -27 1372 1373 -41 0 1404 -20 1372 1373 0 44 -4 0 44 0 1404 -27 1372 1373 -40 0 1408 1396 -20 1372 1373 -8 0 1404 -27 1372 1373 -41 0 1404 -8 1372 1406 1376 1375 -9 1376 1377 -8 0 1404 -27 1372 1373 -41 0 1404 -6 1372 1406 1376 1407 -20 0 1404 -27 1372 1373 -41 0 1404 -5 1372 1406 1407 -22 0 1404 -27 1372 1373 -38 0 1408 -2 1412 1413 1394 -3 1372 1406 1407 -23 0 1404 -27 1372 1373 -42 0 1404 -3 1372 1373 -24 0 1404 -27 1372 1373 -42 0 1374 -3 1376 1377 -24 0 1404 -27 1372 1373 -12 0 83 102 83 0 -2 83 -53 0 1404 -27 1372 1373 -59 0 1370 -4 1368 1384 -4 0 1370 1368 1371 -27 1372 1373 -25 0 44 0 44 -31 0 1374 1394 -2 1372 1406 1377 -4 0 1374 1394 -28 1372 1373 -34 0 -2 77 -10 0 77 -3 0 -2 44 -2 0 -2 44 -4 0 1404 -2 1372 1373 -6 0 1404 -28 1372 1373 -9 0 1367 -10 1368 1384 -11 0 1370 -15 1368 1380 -8 0 1367 -2 1368 1371 -2 1372 1383 1369 -4 0 1378 1371 -28 1372 1373 -9 0 1404 -9 1372 1406 1377 -2 0 64 2136 2137 2138 2139 2136 64 -2 0 1404 -11 1372 1406 -3 1376 1377 -8 0 1374 -3 1376 1394 -2 1372 1383 -4 1368 1371 -26 1372 1371 -2 1372 1373 -7 0 1367 1368 1371 -9 1372 1373 -3 0 -7 64 -2 0 1374 1376 1394 -9 1372 1373 -5 0 -2 44 -2 0 -2 44 -5 0 1404 -37 1372 1373 -7 0 1404 -10 1372 1406 1377 -4 0 -5 64 -5 0 1404 -9 1372 1383 -2 1368 1384 -10 0 1370 -2 1368 1371 -37 1372 1373 -5 0 1367 1368 1371 -10 1372 1373 -2 0 -2 44 -2 0 64 0 64 -2 0 -2 44 -2 0 1404 -12 1372 1373 -10 0 1404 -40 1372 1373 -5 0 1374 1376 1394 -7 1372 0 1372 1406 1377 -15 0 1374 1394 1372 0 1406 1376 1394 -3 1372 1382 -2 1372 1373 -10 0 1404 -40 1372 1373 -7 0 1397 -7 1376 0 1376 1377 -17 0 1397 1376 0 1410 0 1397 -6 1376 1377 -10 0 1374 -9 1376 1394 -30 1372 1383 1368 1380 -66 0 1374 1394 -31 1372 1373 -67 0 1404 -31 1372 1383 1368 1380 -34 0 1727 1728 -26 0 1727 1728 0 1404 -33 1372 1373 -17 0 -2 77 -15 0 1729 1730 -19 0 77 -6 0 1729 1730 0 1404 -33 1372 1383 -11 1368 0 -21 1368 0 -9 1368 1380 -10 0 1367 -10 1368 1371 -45 1372 0 -21 1372 0 -9 1372 1373 -10 0 1404 -87 1372 1406 1377 -10 0 1374 1394 -55 1372 1406 -3 1386 1394 -15 1372 1406 1376 1375 -2 1376 1394 -4 1372 1406 1407 -12 0 1374 1394 -54 1372 1373 -3 0 1404 -14 1372 1406 1377 -4 0 1374 1394 -3 1372 1373 -14 0 1374 1394 -34 1372 0 -7 1372 1406 1376 1394 0 -7 1372 1373 -3 0 1404 -13 1372 1406 1407 -6 0 1397 1394 1372 1406 1377 -15 0 1397 -2 1376 1394 -31 1372 0 -7 1376 1377 -3 0 -7 1376 1377 0 44 0 1374 -13 1376 1407 -3 0 -2 44 -3 0 1397 1376 1407 -19 0 1374 1394 -30 1372 -63 0 83 102 -2 83 -2 0 1404 -30 1372 -69 0 1404 -30 1372 -69 0 1404 -30 1372 -30 0 77 -15 0 77 -4 0 77 -17 0 1404 -30 1372 0 -10 1368 0 -12 1368 1380 -4 0 1408 1415 -6 1368 1416 1388 -6 0 1408 1415 -4 1368 1416 1388 -8 0 1367 -7 1368 1371 -30 1372 0 -10 1372 0 -12 1372 1383 1403 -4 0 1397 1394 -4 1372 1406 1407 -8 0 1397 1394 -2 1372 1406 1407 -9 0 1404 -63 1372 1383 1403 -4 0 1397 -2 1376 1375 1376 1407 -4 0 1367 1380 -4 0 1397 -2 1376 1407 -10 0 1374 1376 1394 -62 1372 1383 1380 -12 0 1367 1371 1383 1380 -19 0 1404 -63 1372 1383 1403 -2 0 44 0 -2 44 0 44 -2 0 1367 1371 -2 1372 1383 1403 -18 0 1404 -64 1372 1383 1380 -8 0 1367 1371 -4 1372 1383 1380 2139 2136 2137 2138 2139 2136 2137 2138 2139 2136 2137 2138 2139 2136 2137 2138 2139 1404 -65 1372 1383 -8 1368 1371 -6 1372 1383 -17 1368 1371 -236 1372)
    )
    (tilemap
      (solid #f)
      (z-pos 100)
      (name "Foreground")
      (width 100)
      (height 70)
      (tiles -291 0 1372 -7 0 1372 -90 0 -3 1372 -5 0 -2 1372 -90 0 1394 -2 1372 -5 0 1394 1372 -90 0 1397 -2 1376 -5 0 1397 1376 -490 0 -3 1368 -5 0 -2 1368 -90 0 -3 1372 -5 0 -2 1372 -90 0 -3 1372 -5 0 -2 1372 -91 0 1372 -7 0 1372 -2603 0 1373 -9 0 1404 -89 0 1373 -7 0 1367 1368 1371 -89 0 1373 -7 0 1404 -2 1372 -5 0 1372 -21 0 1372 -61 0 1373 -5 0 1367 1368 1371 -2 1372 -4 0 -3 1372 -19 0 -3 1372 -60 0 1373 -5 0 1374 1376 1394 -2 1372 -4 0 -3 1372 -19 0 -2 1372 1406 -60 0 1373 -7 0 1397 -2 1376 -4 0 -3 1376 -19 0 -2 1376 1410 -60 0 1383 1368 1380 -97 0 -2 1372 1373 -97 0 -2 1372 1383 1368 1380 -95 0 -4 1372 1373 -95 0 -4 1372 1383 -6 1368 -4 0 -3 1368 -19 0 -3 1368 -75 0 -3 1372 -19 0 -3 1372 -75 0 -3 1372 -19 0 -3 1372 -57 0 1372 -9 0 -3 1372 -6 0 1406 -3 1386 1394 -15 0 1406 1376 1375 -2 1376 1394 -55 0 -2 1372 -8 0 -3 1372 -87 0 -2 1372 -8 0 1394 -2 1372 -87 0 -2 1376 -8 0 1374 -2 1376 -487 0 -2 1368 -8 0 -3 1368 -87 0 -2 1372 -8 0 -3 1372 -87 0 -2 1372 -8 0 -3 1372 -87 0 1372 -10 0 1372 -588 0)
    )
  )
  (sector
    (name "boss")
    (ambient-light
      (color 0.7529412 0.5019608 0.5019608)
    )
    (background
      (scroll-offset-y 832)
      (color 1 1 1)
      (speed 0.5)
      (image-top "images/background/BlueRock_Forest/blue-top.jpg")
      (image "images/background/BlueRock_Forest/rolling-middle.jpg")
      (image-bottom "images/background/BlueRock_Forest/rolling-bottom.jpg")
    )
    (camera
      (name "Camera")
      (mode "normal")
    )
    (ghosttree
      (z-pos 40)
      (dead-script "sector.Tux.trigger_sequence(\"fireworks\")")
      (x 1126)
      (y 908)
      (hud-icon "images/creatures/ghosttree/hudlife.png")
    )
    (lantern
      (z-pos 50)
      (color 0 0 0)
      (x 528)
      (y 904)
    )
    (lantern
      (z-pos 50)
      (color 0 0 0)
      (x 1552)
      (y 776)
    )
    (lantern
      (z-pos 50)
      (color 0 0 0)
      (x 1840)
      (y 968)
    )
    (lantern
      (z-pos 50)
      (color 0 0 0)
      (x 688)
      (y 552)
    )
    (music
      (file "music/treeboss.music")
    )
    (spawnpoint
      (name "main")
      (x 32)
      (y 960)
    )
    (tilemap
      (solid #f)
      (z-pos -100)
      (name "Background")
      (width 75)
      (height 35)
      (tiles -1595 0 1145 1146 1147 1148 -71 0 1137 1138 1139 1140 -28 0 1137 1138 1139 1140 -39 0 1145 1146 1147 1148 -28 0 1145 1146 1147 1148 -39 0 1137 1138 1139 1140 -28 0 1137 1138 1139 1140 -39 0 1145 1146 1147 1148 -28 0 1145 1146 1147 1148 -39 0 1137 1138 1139 1140 -28 0 1137 1138 1139 1140 -19 0 -11 1477 -9 0 1145 1146 1147 1148 -24 0 1223 1224 -2 0 1145 1146 1147 1148 -19 0 -11 1477 -9 0 1137 1138 1139 1140 -4 0 1217 1218 -18 0 1217 1218 -2 0 1137 1138 1139 1140 -19 0 -11 1477 -9 0 1145 1146 1147 1148 -4 0 1223 1224 -18 0 1223 1224 -2 0 1145 1146 1147 1148 -19 0 -11 1477 -9 0 1153 1154 1155 1156 -3 0 1228 1229 1230 -17 0 1228 1229 1230 -2 0 1153 1154 1155 1156 -19 0 -11 1477 1423 -8 0 1161 1162 1163 1164 -3 0 1234 1235 1236 -17 0 1234 1235 1236 -2 0 1161 1162 1163 1164 -19 0 -11 1477 1427 -63 0 -11 1477 1431 -63 0 -11 1477 1431 -63 0)
    )
    (tilemap
      (solid #t)
      (z-pos 0)
      (name "Interactive")
      (width 75)
      (height 35)
      (tiles -601 0 1367 1368 1384 0 1367 1368 1384 0 1367 1368 1384 -64 0 1404 1372 1373 0 1404 1372 1373 0 1404 1372 1373 -63 0 1368 1371 1372 1383 1368 1371 1372 1383 1368 1371 1372 1373 -63 0 -11 1372 1373 -63 0 -11 1372 1373 -63 0 -11 1372 1373 -63 0 -11 1372 1373 -63 0 -11 1372 1373 -63 0 -11 1372 1373 -63 0 -11 1372 1373 -63 0 -11 1372 1373 -63 0 -11 1372 1373 -8 0 1423 1424 1425 1426 -51 0 -11 1372 1373 -8 0 1427 1428 1429 1430 -28 0 1423 1424 1425 1426 -19 0 -11 1372 1373 -8 0 1439 1440 1441 1442 -28 0 1427 1428 1429 1430 -19 0 -11 1372 1373 -40 0 1439 1440 1441 1442 -19 0 -11 1372 1373 -10 0 1752 1753 -51 0 -11 1372 1373 -10 0 1754 1755 1756 1757 -49 0 -11 1372 1373 -10 0 1758 1759 -23 0 1423 1424 1425 1426 -24 0 -11 1372 1373 -15 0 1423 1424 1425 1426 -16 0 1427 1428 1429 1430 -24 0 -11 1376 1377 -15 0 1427 1428 1429 1430 -16 0 1439 1440 1441 1442 -3 0 1752 1753 -46 0 1439 1440 1441 1442 -23 0 1754 1755 1756 1757 -71 0 1758 1759 -106 0 -52 1424 1426 -10 0 -11 1368 1369 -52 1428 1430 -10 0 -11 1372 1373 1437 -6 1432 -3 1436 1432 1436 -4 1432 1436 -6 1432 -3 1436 -4 1432 1433 -3 1432 1436 1437 1436 -2 1432 -2 1436 1432 1436 -3 1432 1436 1437 1432 1436 1437 1432 1434 -10 0 -11 1372 1373 1432 1437 1432 1433 -5 1432 1436 1432 1436 1432 1433 -3 1432 -2 1436 -3 1432 1436 -2 1432 1437 -2 1432 1436 -2 1432 1437 -9 1432 -2 1437 -3 1432 1436 -5 1432 1434 -10 0)
    )
    (tilemap
      (solid #f)
      (z-pos 100)
      (name "Foreground")
      (width 75)
      (height 35)
      (tiles -2625 0)
    )
  )
)
