(supertux-level
  (version 3)
  (name (_ "Three sheets to the wind"))
  (author "Christoph Sommer")
  (license "GPL 2+ / CC-by-sa 3.0")
  (allow-item-pocket "inherit")
  (icon "")
  (icon-locked "")
  (statistics
    (enable-coins #t)
    (enable-secrets #t)
  )
  (sector
    (name "main")
    (ambient-light
      (color 1 1 1)
    )
    (background
      (scroll-offset-y -450)
      (color 1 1 1)
      (speed 0.5)
      (image-top "images/background/BlueRock_Forest/blue-top.jpg")
      (image "images/background/BlueRock_Forest/blue-middle.jpg")
      (image-bottom "images/background/BlueRock_Forest/blue-bottom.jpg")
    )
    (camera
      (name "Camera")
      (mode "normal")
    )
    (dispenser
      (z-pos 55)
      (cycle 3)
      (objects
        (viciousivy
          (z-pos 50)
          (glinting #f)
        )
      )
      (direction "left")
      (x 3968)
      (y 1488)
    )
    (firefly
      (z-pos 0)
      (x 1712)
      (y 816)
    )
    (firefly
      (z-pos 0)
      (x 3344)
      (y 368)
    )
    (flame
      (z-pos 150)
      (speed 1)
      (x 3328)
      (y 1248)
    )
    (flame
      (z-pos 150)
      (speed 1)
      (x 3264)
      (y 1440)
    )
    (flame
      (z-pos 150)
      (speed 1)
      (x 3488)
      (y 1568)
    )
    (flame
      (z-pos 150)
      (speed 1)
      (x 3584)
      (y 1408)
    )
    (igel
      (z-pos 50)
      (x 1618.1)
      (y 998.1)
      (glinting #f)
    )
    (igel
      (z-pos 50)
      (x 1538.1)
      (y 1254.1)
      (glinting #f)
    )
    (igel
      (z-pos 50)
      (x 1506.1)
      (y 550.1)
      (glinting #f)
    )
    (igel
      (z-pos 50)
      (x 4736)
      (y 432)
      (glinting #f)
    )
    (igel
      (z-pos 50)
      (x 5264)
      (y 528)
      (glinting #f)
    )
    (mrbomb
      (z-pos 50)
      (x 2099)
      (y 1372)
      (glinting #f)
    )
    (mrtree
      (z-pos 50)
      (x 2144)
      (y 544)
      (glinting #f)
    )
    (music
      (file "music/forest2.ogg")
    )
    (path
      (name "gen1772930129104989819766048")
      (path
        (adapt_speed #f)
        (node
          (x 2304)
          (y 1344)
          (time 4)
        )
        (node
          (x 2880)
          (y 1344)
          (time 4)
        )
      )
    )
    (path
      (name "gen1772930129104989798174144")
      (path
        (adapt_speed #f)
        (node
          (x 2272)
          (y 832)
        )
      )
    )
    (platform
      (z-pos 50)
      (handle
        (scale_x 0)
        (scale_y 0)
        (offset_x 0)
        (offset_y 0)
      )
      (running #f)
      (path-ref "gen1772930129104989819766048")
    )
    (pushbutton
      (z-pos -99)
      (script "wind1a.start();
wind1b.start();
wind1c.start();
wind1d.start();
wind1e.start();
wind1f.start();
wind1g.start();
wind1h.start();
")
      (x 4257)
      (y 1714)
    )
    (scripttrigger
      (script "wind1a.start();
wind1b.start();
wind1c.start();
wind1d.start();
wind1e.start();
wind1f.start();
wind1g.start();
wind1h.start();
")
      (button #f)
      (width 124)
      (height 88)
      (x 1664)
      (y 804)
    )
    (secretarea
      (fade-tilemap "secret1")
      (width 172)
      (height 188)
      (x 2272)
      (y 832)
    )
    (secretarea
      (width 60)
      (height 124)
      (x 3808)
      (y 0)
    )
    (sequencetrigger
      (sequence "endsequence")
      (width 316)
      (height 188)
      (x 5888)
      (y 416)
    )
    (sequencetrigger
      (sequence "stoptux")
      (width 124)
      (height 136)
      (x 6016)
      (y 480)
    )
    (snail
      (z-pos 50)
      (x 866)
      (y 1283)
      (glinting #f)
    )
    (spawnpoint
      (name "main")
      (x 160)
      (y 288)
    )
    (tilemap
      (solid #f)
      (z-pos -190)
      (name "CaveBG")
      (width 192)
      (height 64)
      (tiles -2891 0 -23 1351 -169 0 -23 1352 -169 0 -23 1353 -169 0 -23 1353 -169 0 -23 1353 -169 0 -35 1353 -157 0 -35 1353 -157 0 -54 1353 -11 0 -14 1351 -113 0 -64 1353 0 -14 1352 -113 0 -88 1353 -104 0 -88 1353 -104 0 -88 1353 -104 0 -88 1353 -93 0 -99 1353 -93 0 -99 1353 -93 0 -99 1353 -93 0 -99 1353 -93 0 -99 1353 -93 0 -99 1353 -93 0 -99 1353 -93 0 -106 1353 -86 0 -106 1353 -86 0 -106 1353 -86 0 -111 1353 -81 0 -111 1353 -81 0 -111 1353 -81 0 -114 1353 -78 0 -114 1353 -78 0 -129 1353 -63 0 -129 1353 -63 0 -129 1353 -63 0 -129 1353 -63 0 -129 1353 -63 0 -129 1353 -63 0 -129 1353 -63 0 -137 1353 -55 0 -138 1353 -54 0 -138 1353 -54 0 -138 1353 -54 0 -138 1353 -54 0 -137 1353 -55 0 -131 1353 -61 0 -131 1353 -61 0 -131 1353 -61 0 -131 1353 -134 0 -20 1353 -31 0 -7 1353 -134 0 -20 1353 -31 0 -7 1353 -134 0 -20 1353 -31 0 -7 1353 -134 0 -20 1353 -31 0 -7 1353 -61 0)
    )
    (tilemap
      (solid #t)
      (z-pos 0)
      (name "Interactive")
      (width 192)
      (height 64)
      (tiles -22 0 1000 1001 -7 1002 1003 -88 0 128 -93 0 1004 1005 -3 1006 1005 1006 1005 1006 1007 -182 0 1016 -4 1009 1020 1022 -2 1009 1019 -183 0 1016 -2 1009 1013 1026 1028 1009 1019 -185 0 1012 1013 -3 1009 1015 -81 0 -2 1311 -6 0 -2 1311 -71 0 1001 1002 1003 -21 0 1008 -4 1009 1019 -162 0 1005 1006 1007 -21 0 1012 1013 1009 1013 1015 -163 0 -2 1009 1011 -21 0 1008 -3 1009 1011 -5 0 1000 1002 1003 -67 0 -2 112 -86 0 1009 1010 1011 -21 0 1012 1013 1009 1013 1015 -5 0 1004 1006 1037 1001 1003 -153 0 1009 1013 1015 -20 0 1000 1034 -2 1009 1013 1011 -5 0 1008 1009 1041 1005 1037 1003 -152 0 -2 1009 1011 -15 0 83 102 -3 0 1004 1040 -2 1013 1009 1015 -5 0 1012 1013 -2 1009 1041 1007 -152 0 1009 1013 1015 -2 0 317 318 -15 0 1000 1034 -4 1009 1011 -5 0 1008 -4 1009 1011 -152 0 -2 1009 1015 1984 0 319 320 -14 0 1000 1036 1040 1013 -3 1009 1019 -5 0 1012 1013 1010 -2 1009 1011 -152 0 1021 1022 1015 1980 1984 57 58 -10 0 1000 1001 -2 1002 1036 1040 -4 1009 1019 -6 0 1008 -4 1009 1015 -152 0 1024 1025 1035 1981 1985 -2 1002 1984 -2 1002 1003 -6 0 1004 -2 1005 1006 1040 -3 1009 1017 1019 -7 0 1012 1013 -3 1009 1015 -64 0 -2 83 -39 0 1000 1001 -3 1002 1003 -41 0 1027 1028 1041 1005 -3 1006 1005 -2 1006 1037 1003 0 -2 44 0 1000 1034 -5 1009 1018 1019 -8 0 1000 1034 -4 1009 1015 -20 0 83 102 -2 83 -72 0 83 102 -2 83 -5 0 1004 1005 -3 1006 1007 -41 0 -10 1009 1041 1007 0 -2 44 0 1004 1040 -4 1009 1019 -8 0 1000 1002 1036 1040 -4 1009 1035 1002 1061 -62 0 -2 44 -39 0 1008 -4 1009 1011 -41 0 -8 1009 1013 -2 1009 1011 0 -2 44 0 1008 -4 1009 1019 -9 0 1004 1006 1040 -5 1009 1041 1006 1065 1066 1001 -4 1002 1003 -11 0 -4 44 -38 0 1060 -4 1002 1003 -28 0 -4 44 -4 0 1060 1034 -4 1009 1035 1001 -4 1002 1061 -6 0 1000 1001 -3 1002 1003 -23 0 -2 1009 1013 1009 -3 1013 -4 1009 1011 -4 0 1012 -2 1013 1009 1015 -7 0 1723 1725 1723 1817 -9 1009 1069 1070 1005 1006 1005 -2 1006 1037 1001 1003 -8 0 1060 -4 1002 1003 -7 0 57 58 -26 0 1000 1063 1064 1006 1005 -2 1006 1007 -26 0 1000 1001 -7 1002 1063 1064 1040 1009 1014 -2 1009 1041 1005 -4 1006 1065 1066 1061 -4 0 1004 1005 -3 1006 1037 1001 -22 1002 -9 1009 1013 1009 1011 -4 0 1008 -3 1009 1011 -5 0 1723 1725 1817 -19 1009 1041 1005 1007 -6 0 1060 1063 1064 1006 1005 -2 1006 1037 1001 -6 1002 59 60 1003 -16 0 1000 -2 1002 1003 -2 0 1000 1001 1002 1036 1067 1068 -2 1009 1010 1009 1011 -13 0 -2 44 -11 0 1004 1005 -7 1006 1067 1068 -11 1009 1069 1070 1065 1066 1003 -2 0 1008 -4 1009 1041 1005 -22 1006 -11 1009 1011 -4 0 1012 -3 1013 1015 -4 0 1723 1817 -6 1009 1013 1009 -2 1013 -2 1009 1013 -10 1009 1035 1001 -4 1002 1063 1064 1067 1068 -4 1009 1041 1005 -3 1006 1005 -4 1006 1007 -16 0 1004 1005 1006 1007 -2 0 1004 1005 1006 1067 1068 -5 1009 1011 -13 0 -2 44 -11 0 1008 -24 1009 1070 1007 -2 0 1008 -29 1009 1013 1009 -2 1013 -4 1009 -2 1013 1015 -4 0 1008 -3 1009 1820 1726 -2 0 1723 1817 -7 1009 1017 1018 1017 -6 1009 1018 1017 1018 -5 1009 1041 1005 -2 1006 1005 1006 1067 1068 -16 1009 1035 1003 -14 0 1000 1034 -2 1009 1011 -2 0 1016 -2 1017 1018 1017 1018 1017 1018 -2 1017 1019 -26 0 1012 -25 1009 1035 -2 1002 1034 -39 1009 1011 -4 0 1012 1013 -3 1009 1011 -2 0 1008 -6 1009 1018 1019 -3 0 1016 -2 1017 -2 1018 1019 -3 0 1016 1018 -10 1009 -2 1013 -15 1009 1041 1037 1003 -12 0 1000 1036 1040 1013 1009 1011 -18 0 313 314 -17 0 53 55 1012 1013 -24 1009 1041 -2 1006 1040 -29 1009 -2 1013 -2 1009 1013 -4 1009 1013 1015 -4 0 1016 -4 1009 1011 -2 0 1008 -5 1009 1019 -16 0 1016 -7 1009 1018 -2 1017 1018 1009 1013 -11 1009 1017 1018 1009 1041 1007 -12 0 1004 1040 -3 1009 1011 -2 0 1000 -15 1002 315 316 -17 1002 54 56 1034 -68 1009 1011 -5 0 1008 -2 1009 1018 1019 -2 0 1016 -2 1017 -2 1018 1019 -18 0 1016 1018 -2 1017 1018 1017 1019 -4 0 1016 1017 1018 1009 1013 -7 1009 1015 -2 0 1008 1009 1011 -12 0 1008 -4 1009 1011 -2 0 1004 1006 1005 1006 1005 1006 1005 -2 1006 1005 -4 1006 1005 1006 1005 1006 -3 1005 1006 1005 1006 1005 1006 1005 -2 1006 1005 -2 1006 -5 1005 1040 1013 -66 1009 1013 1015 -5 0 1012 1009 1019 -42 0 1016 1017 1018 -6 1009 1820 -2 1725 1817 1009 1011 -12 0 1008 -4 1009 1011 57 58 1008 -100 1009 -2 1013 -3 1009 1011 -5 0 1008 1015 -46 0 1016 -10 1009 1019 -12 0 1008 -4 1009 1820 1724 1725 1817 -104 1009 1013 1015 -5 0 1012 1011 -47 0 1016 -6 1009 1017 128 1019 -13 0 1012 -107 1009 1013 1009 -2 1013 -2 1009 1011 -5 0 1008 1015 -11 0 1723 1724 -4 1725 1726 0 -2 44 0 -2 1725 1726 -8 0 -2 83 102 83 -11 0 1016 -4 1009 1019 -16 0 1008 -107 1009 1017 1018 1009 1013 -2 1009 1011 -5 0 1012 1820 1726 -2 0 57 58 -2 0 1723 1724 -2 1725 1817 -5 1009 1011 0 -2 44 0 1008 1009 1820 1724 1725 1726 -21 0 1012 -2 1009 1011 -17 0 1012 -5 1009 1017 1018 -98 1009 1013 1015 -2 0 1008 -3 1009 1019 -5 0 1008 1009 1820 -2 1725 59 60 -2 1725 1817 -9 1009 1011 0 -2 44 0 1008 -4 1009 1820 1724 1725 1726 -2 0 -4 44 -4 0 313 314 -4 0 1723 1725 1817 -2 1009 1820 1724 1725 -3 1724 1726 -11 0 1008 -4 1009 1011 -2 0 1008 -97 1009 1013 1820 -2 1725 1817 1009 1013 1015 -6 0 1012 -4 1009 1017 1018 -12 1009 1015 -4 0 1008 -7 1009 1820 1724 -6 1725 1726 -2 0 315 316 -4 1725 1817 -10 1009 1019 -11 0 1012 -4 1009 1820 -2 1725 1817 -95 1009 1013 1009 1013 -6 1009 1011 -6 0 1016 -3 1009 1015 -2 0 1008 -4 1009 1017 1018 1017 1018 1017 1018 1009 1011 -4 0 1008 1009 1017 -2 1018 -11 1009 1011 -2 0 1008 -15 1009 1019 -12 0 1016 -111 1009 1017 1019 -7 0 1016 1017 1009 1820 -2 1725 1817 -2 1009 1018 1019 -6 0 1016 1019 -4 0 1016 1019 -3 0 1016 -2 1018 -7 1009 1010 1011 -2 0 1008 1009 1010 -12 1009 1019 -14 0 1016 -102 1009 -2 1013 -4 1009 1018 1019 -11 0 1016 -5 1009 1019 -22 0 1016 -4 1017 1018 1009 1013 1015 -2 0 1008 -3 1009 1013 -9 1009 1015 -16 0 1012 -106 1009 1019 -14 0 1016 1017 -2 1018 1019 -29 0 1016 1018 1019 -2 0 1016 -2 1017 1018 1017 1018 1017 1018 1017 1018 1017 1018 1017 1018 1019 -16 0 1016 1017 1018 1017 1018 1017 1018 1017 1018 1017 1018 -94 1009 1018 1019 -31 0 57 58 57 58 -61 0 1016 -92 1009 1015 -30 0 1723 1724 1725 59 60 59 60 1724 1726 -60 0 1016 -91 1009 1019 0 -2 44 -4 0 1723 1724 -5 1725 1726 -13 0 1723 1725 1817 -7 1009 1820 1724 1725 1726 -49 0 83 102 83 -6 0 1012 -89 1009 1015 -2 0 -2 44 -2 0 1723 1725 1817 -6 1009 1820 1725 1726 -9 0 1723 1725 1817 -12 1009 1820 1724 -8 1725 1726 -25 0 -4 44 -19 0 1016 1009 -3 1013 -85 1009 1820 -6 1725 1817 -10 1009 1820 1724 -8 1725 1817 -24 1009 1820 1726 -48 0 1016 1017 1018 1017 1018 -138 1009 1820 -4 1725 1726 -8 0 1723 1726 -22 0 1723 1724 -2 1725 1726 -11 0 1016 -86 1009 1017 1018 -15 1009 1017 1018 -37 1009 1820 1726 -4 0 1723 1724 1725 1817 1015 -22 0 1008 -3 1009 1820 1725 1726 -10 0 1016 -84 1009 1015 -2 0 1008 -13 1009 1015 -2 0 1008 -37 1009 1820 -4 1725 1817 -3 1009 1820 1726 -20 0 1723 1817 -5 1009 1820 1726 -4 0 -2 44 -4 0 1012 -3 1009 1013 -79 1009 1820 -2 1725 1817 -13 1009 1820 -2 1725 1817 -47 1009 1820 1726 -18 0 1723 1008 -7 1009 1820 1726 -4 0 -2 44 -3 0 1016 1018 1017 1018 1017 1018 -4 1009 -2 1018 -105 1009 1017 1018 -34 1009 1011 -18 0 1008 -9 1009 1011 1725 1726 -13 0 1016 -2 1009 1019 -2 0 1016 -2 1018 -89 1009 1013 -11 1009 1015 -2 0 1008 -32 1009 1010 1011 -18 0 1008 -11 1009 1820 1724 1725 1726 -11 0 1016 1019 -6 0 1016 -84 1009 1013 -15 1009 1820 -2 1725 1817 -33 1009 1015 -18 0 1008 -14 1009 1820 1726 -19 0 1012 -136 1009 1011 -18 0 1012 -15 1009 1820 1724 1726 -17 0 1012 -136 1009 1015 -18 0 1008 -17 1009 1820 1726 -16 0 1012 -102 1009 1017 1018 -32 1009 1011 -18 0 1012 -18 1009 1011 -16 0 1016 -2 1009 1017 1018 1017 -2 1018 -94 1009 1015 -2 0 1008 -31 1009 1015 -18 0 1008 -18 1009 1820 1726 -16 0 1016 1019 -5 0 1016 -93 1009 1820 -2 1725 1817 -31 1009 1011 -18 0 1012 -19 1009 1011 -20 0 44 -3 0 1008 -59 1009 1017 1018 -15 1009 1017 1018 -49 1009 1015 -18 0 1008 -19 1009 1011 -23 0 1723 1817 -58 1009 1015 -2 0 1008 -13 1009 1015 -2 0 1008 -48 1009 1011 -18 0 1012 -19 1009 1820 1725 1726 -2 0 -4 44 -9 0 1723 -2 1725 48 -2 1725 1817 -59 1009 1820 -2 1725 1817 -13 1009 1820 -2 1725 1817 -48 1009 1015 -18 0 1008 -21 1009 1011 -14 0 1723 1817 -134 1009 1011 -18 0 1012 -21 1009 1011 -14 0 1817 -135 1009 1011 -18 0 1008 -21 1009 1820 1724 -8 1725 -5 0 1008 -135 1009 1011 -18 0 1008 -30 1009 1820 1725 -4 0 1008 -135 1009 1011 -18 0 1008 -31 1009 1820 1725 -3 0 1008 -135 1009 1011 -18 0 1008 -32 1009 1011 -3 0 1012 -135 1009 1011 -18 0 1008 -32 1009 1011 -3 0 1817 -135 1009 1011 -18 0 1008 -32 1009 1015 -3 0 1817 -135 1009 1011 -18 0 1008 -32 1009 1011 -3 0 1817 -62 1009)
    )
    (tilemap
      (solid #f)
      (z-pos 10)
      (name "Nearer")
      (width 192)
      (height 64)
      (tiles -2691 0 1001 1002 59 60 1002 -189 0 59 60 -11 0 1953 -178 0 59 60 -190 0 59 60 -190 0 59 60 -190 0 59 60 -32 0 1936 1937 -128 0 1945 -27 0 59 60 -32 0 1940 1941 -31 0 59 60 -25 0 1936 1937 -35 0 1938 -32 0 1949 -23 0 1358 1360 -2 0 59 60 -11 0 1939 -36 0 1944 -16 0 59 60 -25 0 1940 1941 -61 0 360 -30 0 1364 1366 -2 0 59 60 -11 0 1943 -34 0 1938 0 1948 -16 0 59 60 -123 0 59 60 -3 0 1953 -7 0 1947 -36 0 1952 -16 0 59 60 -39 0 -2 1002 -17 0 -2 1002 -63 0 59 60 -47 0 1939 -17 0 59 60 -123 0 59 60 -47 0 1943 -35 0 1939 -106 0 59 60 -47 0 1947 -35 0 1943 -4 0 59 60 -14 0 1942 -85 0 59 60 -83 0 1947 -4 0 59 60 -14 0 1946 -85 0 59 60 -88 0 59 60 -100 0 59 60 -88 0 59 60 -100 0 59 60 -26 0 1950 1951 -60 0 59 60 -28 0 1939 -88 0 59 60 -9 0 1954 1955 -25 0 1723 1724 -63 0 1943 -88 0 59 60 -31 0 1942 -69 0 1947 -75 0 1936 1937 -42 0 1945 0 1946 -145 0 1940 1941 -11 0 1938 -30 0 1949 1944 -159 0 1950 1951 -30 0 1948 -18 0 1936 1937 -62 0 1942 -76 0 1954 1955 -30 0 1952 -18 0 1940 1941 -62 0 1946 -283 0 59 60 59 60 -74 0 1942 -113 0 59 60 59 60 -67 0 1945 -6 0 1946 -109 0 1953 -3 0 59 60 59 60 0 1942 -63 0 1950 1951 1949 -94 0 1939 -4 0 1953 -20 0 59 60 59 60 0 1946 -63 0 1954 1955 -20 0 1950 1951 -73 0 1943 -25 0 59 60 59 60 -87 0 1954 1955 -73 0 1947 -10 0 59 60 -4 0 1950 1951 -7 0 59 60 59 60 -156 0 59 60 -15 0 59 60 -4 0 1954 1955 -7 0 59 60 59 60 -156 0 59 60 -15 0 59 60 -13 0 59 60 59 60 -27 0 1950 1951 -127 0 59 60 -15 0 59 60 -13 0 59 60 59 60 -27 0 1954 1955 -26 0 1942 -100 0 59 60 -15 0 59 60 -15 0 59 60 -55 0 1946 -38 0 1942 -61 0 59 60 -15 0 59 60 -15 0 59 60 -94 0 1946 -61 0 59 60 -15 0 59 60 -15 0 59 60 -64 0 1953 -91 0 59 60 -15 0 59 60 -15 0 59 60 -156 0 59 60 -15 0 59 60 -15 0 59 60 -156 0 59 60 -15 0 59 60 -71 0 1950 1951 -100 0 59 60 -15 0 59 60 -71 0 1954 1955 -37 0 1731 1732 -61 0 59 60 -15 0 59 60 -110 0 1733 1734 -1784 0)
    )
    (tilemap
      (solid #f)
      (z-pos -10)
      (name "Further")
      (width 192)
      (height 64)
      (tiles -2 0 85 86 87 88 -29 0 85 86 87 88 -134 0 85 86 87 88 -17 0 89 90 91 92 -7 0 85 86 87 88 -18 0 89 90 91 92 -8 0 85 86 87 88 -18 0 85 86 87 88 -65 0 85 86 87 88 -31 0 89 90 91 92 -11 0 85 86 87 88 -13 0 89 90 91 92 -30 0 89 90 91 92 -18 0 89 90 91 92 -17 0 85 86 87 88 -44 0 89 90 91 92 -12 0 85 86 87 88 -30 0 89 90 91 92 -58 0 85 86 87 88 -19 0 85 86 87 88 -5 0 89 90 91 92 -16 0 85 86 87 88 -4 0 85 86 87 88 -32 0 89 90 91 92 -34 0 404 405 -56 0 89 90 91 92 -19 0 89 90 91 92 -18 0 1073 1074 1075 -4 0 89 90 91 92 -4 0 89 90 91 92 -70 0 408 409 -101 0 1081 1082 1083 1084 -29 0 1073 1074 1075 -30 0 1073 1074 1075 -122 0 1088 1089 1090 1091 1092 1093 -28 0 1081 1082 1083 1084 -13 0 1240 1241 1242 -13 0 1081 1082 1083 1084 -72 0 1073 1074 1075 -45 0 1095 1096 1097 1098 1099 1100 1101 -2 0 1168 -24 0 1088 1089 1090 1091 1092 1093 -11 0 1243 1244 1245 1246 -12 0 1088 1089 1090 1091 1092 1093 -38 0 402 403 404 405 -29 0 1081 1082 1083 1084 -8 0 1168 1169 1170 -30 0 1240 1241 1242 1103 1104 1105 1106 1107 1108 1109 1110 -25 0 1095 1096 1097 1098 1099 1100 1101 -11 0 1247 1248 1249 1250 -11 0 1095 1096 1097 1098 1099 1100 1101 -38 0 406 407 408 409 -28 0 1088 1089 1090 1091 1092 1093 -7 0 1174 1175 1176 1177 -28 0 1243 1244 1245 1246 1111 1112 1113 1114 1115 1116 1117 1118 -25 0 1103 1104 1105 1106 1107 1108 1109 1110 -10 0 1251 1252 1253 1254 -11 0 1103 1104 1105 1106 1107 1108 1109 1110 -33 0 402 403 436 437 428 429 426 427 404 405 -25 0 1095 1096 1097 1098 1099 1100 1101 -6 0 1179 1180 1181 1182 1183 -28 0 1247 1248 1249 1250 1119 1120 1121 1122 1123 1124 1125 1126 -25 0 1111 1112 1113 1114 1115 1116 1117 1118 -10 0 1255 1256 1257 1258 -11 0 1111 1112 1113 1114 1115 1116 1117 1118 -8 0 130 -24 0 406 407 440 441 432 433 430 431 408 409 -25 0 1103 1104 1105 1106 1107 1108 1109 1110 -5 0 1185 1186 1187 1188 1189 1190 -27 0 1251 1252 1253 1254 1127 1128 1129 1130 1131 1132 1133 1134 -25 0 1119 1120 1121 1122 1123 1124 1125 1126 -3 0 402 403 404 405 -3 0 1259 1260 1261 1262 -11 0 1119 1120 1121 1122 1123 1124 1125 1126 -8 0 129 -10 0 1976 -13 0 410 411 442 443 444 445 442 -28 0 1111 1112 1113 1114 1115 1116 1117 1118 -5 0 1191 1192 1193 1194 1195 1196 -27 0 1255 1256 1257 1258 -2 0 1137 1138 1139 1140 1141 -26 0 1127 1128 1129 1130 1131 1132 1133 1134 -3 0 406 407 408 409 -3 0 1263 1264 1265 1266 -11 0 1127 1128 1129 1130 1131 1132 1133 1134 -8 0 129 -10 0 1981 1985 -12 0 414 415 446 447 448 449 -29 0 1119 1120 1121 1122 1123 1124 1125 1126 -5 0 1197 1198 1199 1200 1201 1202 -27 0 1259 1260 1261 1262 -2 0 1145 1146 1147 1148 -29 0 1137 1138 1139 1140 1141 402 403 436 437 428 429 426 427 404 405 0 1267 1268 1269 1270 -13 0 1137 1138 1139 1140 1141 -9 0 129 -10 0 1982 1986 1972 1976 1980 -9 0 418 419 -33 0 1127 1128 1129 1130 1131 1132 1133 1134 -5 0 1203 1204 1205 1206 1207 1208 -27 0 1263 1264 1265 1266 -2 0 1145 1146 1147 1148 -29 0 1145 1146 1147 1148 0 406 407 440 441 432 433 430 431 408 409 0 1271 1272 1273 1274 -13 0 1145 1146 1147 1148 -4 0 402 403 404 405 -2 0 129 -10 0 1983 1987 1973 1977 1981 1985 -8 0 422 423 -35 0 1137 1138 1139 1140 1141 -6 0 1209 1210 1211 1212 1213 1214 -27 0 1267 1268 1269 1270 -2 0 1145 1146 1147 1148 -29 0 1145 1146 1147 1148 0 410 411 442 443 444 -6 0 1275 1276 1277 1278 -13 0 1145 1146 1147 1148 -4 0 406 407 408 409 -2 0 129 -40 0 360 -20 0 1145 1146 1147 1148 -8 0 2045 1219 1220 -29 0 1271 1272 1273 1274 -2 0 1153 1154 1155 1156 -29 0 1145 1146 1147 1148 0 414 415 446 447 448 -7 0 1280 1281 1282 -13 0 1145 1146 1147 1148 402 403 436 437 428 429 426 427 404 405 129 -61 0 1145 1146 1147 1148 -8 0 2046 1225 1226 -29 0 1275 1276 1277 1278 -2 0 1161 1162 1163 1164 -29 0 1153 1154 1155 1156 0 418 419 450 451 452 -7 0 1284 1285 1286 -13 0 1153 1154 1155 1156 406 407 440 441 432 433 430 431 408 409 129 -61 0 1145 1146 1147 1148 -8 0 1228 1229 1230 -29 0 1279 1280 1281 1282 -35 0 1161 1162 1163 1164 0 422 423 454 455 -24 0 1161 1162 1163 1164 410 411 444 445 444 445 442 443 412 413 129 -33 0 402 403 404 405 -24 0 1153 1154 1155 1156 -8 0 1234 1235 1236 -4 0 -2 1002 -20 0 -4 1351 1284 1285 1286 -116 0 406 407 408 409 -24 0 1161 1162 1163 1164 -37 0 -4 1352 -63 0 402 403 404 405 -117 0 360 -3 0 -13 1353 2012 -53 0 406 407 408 409 -121 0 -13 1353 2012 -26 0 55 -111 0 323 -39 0 -13 1353 2012 -26 0 56 -76 0 323 324 -6 0 79 -26 0 79 -39 0 -13 1353 2012 -103 0 325 326 -6 0 79 -26 0 79 -17 0 59 60 -137 0 327 328 -6 0 79 -26 0 79 330 -16 0 59 60 -137 0 329 330 -6 0 79 -26 0 79 -17 0 59 60 1017 -144 0 79 -26 0 79 -17 0 59 60 -145 0 79 -26 0 79 -17 0 59 60 -139 0 322 -2 1725 -3 0 79 -26 0 79 -17 0 59 60 -123 0 59 60 -47 0 79 -17 0 59 60 -21 0 59 60 -100 0 59 60 -47 0 79 -17 0 59 60 -15 0 323 324 -4 0 59 60 -100 0 59 60 -15 0 59 60 -3 0 79 -44 0 59 60 -15 0 325 326 -4 0 59 60 -100 0 59 60 0 79 -13 0 59 60 -3 0 79 -26 0 79 -17 0 59 60 -15 0 327 328 -4 0 59 60 -100 0 59 60 0 79 -13 0 59 60 -3 0 79 -26 0 79 -17 0 59 60 -15 0 329 330 -4 0 59 60 -4 0 323 324 -92 0 323 324 59 60 0 79 -13 0 59 60 -3 0 79 -7 0 1731 1732 -4 0 1731 1732 -11 0 79 -17 0 59 60 -21 0 59 60 -4 0 325 326 -92 0 325 326 59 60 0 79 -13 0 59 60 -3 0 79 -7 0 1733 1734 -4 1725 1733 1734 -11 0 79 -17 0 59 60 -21 0 59 60 -4 0 327 328 -92 0 327 328 59 60 0 79 -7 0 402 403 404 405 -2 0 59 60 -3 0 79 -26 0 79 -17 0 59 60 -21 0 59 60 -4 0 329 330 -92 0 329 330 59 60 0 79 -7 0 406 407 408 409 -2 0 59 60 -3 0 79 -26 0 79 -17 0 59 60 -21 0 59 60 -98 0 322 0 59 60 0 79 -13 0 59 60 -3 0 79 -26 0 79 -17 0 59 60 -21 0 59 60 -9 0 -2 79 -89 0 59 60 0 79 -13 0 59 60 -3 0 79 -44 0 59 60 -21 0 59 60 -9 0 -2 79 -89 0 59 60 -15 0 59 60 -48 0 59 60 -21 0 59 60 -9 0 -2 79 -89 0 59 60 -59 0 322 -5 0 59 60 -18 0 402 403 404 405 -10 0 -2 79 -9 0 323 324 -145 0 59 60 -18 0 406 407 408 409 -10 0 -2 79 -9 0 325 326 -3 0 323 324 59 60 -138 0 59 60 -32 0 -2 79 -9 0 327 328 -3 0 325 326 59 60 -172 0 -2 79 -9 0 329 330 -3 0 327 328 -3 0 323 324 -100 0 59 60 -68 0 79 -14 0 329 330 -3 0 325 326 -100 0 59 60 -88 0 327 328 -190 0 329 330 -486 0 59 60 -190 0 59 60 -264 0 322 -20 0 -3 1719 -60 0 59 60 -15 0 59 60 -173 0 59 60 -15 0 59 60 -1512 0)
    )
    (tilemap
      (handle
        (scale_x 0)
        (scale_y 0)
        (offset_x 0)
        (offset_y 0)
      )
      (solid #f)
      (z-pos 99)
      (name "secret1")
      (path-ref "gen1772930129104989798174144")
      (width 6)
      (height 5)
      (tiles -4 0 1009 1011 -5 1009 1011 -5 1009 1011 -5 1009 1011 -5 1009 1011)
    )
    (tilemap
      (solid #f)
      (z-pos 100)
      (name "WaterBorder")
      (width 192)
      (height 64)
      (tiles -8956 0 1742 1743 -1908 0 1011 -14 0 1817 -176 0 1820 1724 -8 1725 -5 0 1008 -176 0 -9 1009 1820 1725 -4 0 1008 -185 0 1009 1820 1725 -3 0 1008 -186 0 1009 1011 -3 0 1012 -187 0 1011 -3 0 1817 -187 0 1015 -3 0 1817 -187 0 1011 -3 0 1817 -62 0)
    )
    (tilemap
      (solid #t)
      (z-pos 99)
      (name "Water")
      (width 192)
      (height 64)
      (tiles -10866 0 -16 201 -176 0 -16 200 -185 0 -7 200 -185 0 -7 200 -186 0 -6 200 -187 0 -5 200 -187 0 -5 200 -187 0 -5 200 -62 0)
    )
    (viciousivy
      (z-pos 50)
      (x 608)
      (y 400)
      (glinting #f)
    )
    (viciousivy
      (z-pos 50)
      (x 1698)
      (y 628)
      (glinting #f)
    )
    (viciousivy
      (z-pos 50)
      (x 3760)
      (y 720)
      (glinting #f)
    )
    (viciousivy
      (z-pos 50)
      (x 3968)
      (y 720)
      (glinting #f)
    )
    (wind
      (z-pos -99)
      (blowing #f)
      (speed-x 300)
      (speed-y -400)
      (acceleration 4)
      (affects-player #t)
      (width 32)
      (height 192)
      (name "wind1h")
      (x 1280)
      (y 832)
    )
    (wind
      (z-pos -99)
      (blowing #f)
      (speed-x -400)
      (speed-y -400)
      (acceleration 4)
      (affects-player #t)
      (width 32)
      (height 192)
      (name "wind1d")
      (x 1280)
      (y 1024)
    )
    (wind
      (z-pos -99)
      (blowing #f)
      (speed-x 400)
      (speed-y -400)
      (acceleration 4)
      (affects-player #t)
      (width 32)
      (height 192)
      (name "wind1c")
      (x 1248)
      (y 1024)
    )
    (wind
      (z-pos -99)
      (blowing #f)
      (speed-x 200)
      (speed-y -400)
      (acceleration 4)
      (affects-player #t)
      (width 32)
      (height 192)
      (name "wind1g")
      (x 1248)
      (y 832)
    )
    (wind
      (z-pos -99)
      (speed-x 400)
      (speed-y -400)
      (acceleration 4)
      (affects-player #t)
      (width 252)
      (height 192)
      (x 928)
      (y 224)
    )
    (wind
      (z-pos -99)
      (speed-x -400)
      (speed-y -400)
      (acceleration 4)
      (affects-player #t)
      (width 32)
      (height 192)
      (x 736)
      (y 736)
    )
    (wind
      (z-pos -99)
      (blowing #f)
      (speed-x -200)
      (speed-y -400)
      (acceleration 4)
      (affects-player #t)
      (width 32)
      (height 192)
      (name "wind1f")
      (x 1216)
      (y 832)
    )
    (wind
      (z-pos -99)
      (blowing #f)
      (speed-x -300)
      (speed-y -400)
      (acceleration 4)
      (affects-player #t)
      (width 32)
      (height 192)
      (name "wind1e")
      (x 1184)
      (y 832)
    )
    (wind
      (z-pos -99)
      (blowing #f)
      (speed-x -400)
      (speed-y -400)
      (acceleration 4)
      (affects-player #t)
      (width 32)
      (height 192)
      (name "wind1b")
      (x 1216)
      (y 1024)
    )
    (wind
      (z-pos -99)
      (speed-x 400)
      (speed-y -400)
      (acceleration 4)
      (affects-player #t)
      (width 32)
      (height 192)
      (x 704)
      (y 736)
    )
    (wind
      (z-pos -99)
      (speed-x 400)
      (speed-y -400)
      (acceleration 4)
      (affects-player #t)
      (width 252)
      (height 192)
      (x 800)
      (y 384)
    )
    (wind
      (z-pos -99)
      (speed-x 400)
      (speed-y -400)
      (acceleration 4)
      (affects-player #t)
      (width 252)
      (height 192)
      (x 672)
      (y 544)
    )
    (wind
      (z-pos -99)
      (blowing #f)
      (speed-x 400)
      (speed-y -400)
      (acceleration 4)
      (affects-player #t)
      (width 32)
      (height 192)
      (name "wind1a")
      (x 1184)
      (y 1024)
    )
    (wind
      (z-pos -99)
      (speed-x 0)
      (speed-y -800)
      (acceleration 4)
      (affects-player #t)
      (width 32)
      (height 192)
      (x 3072)
      (y 608)
    )
    (wind
      (z-pos -99)
      (speed-x 0)
      (speed-y -800)
      (acceleration 4)
      (affects-player #t)
      (width 32)
      (height 192)
      (x 3040)
      (y 608)
    )
    (wind
      (z-pos -99)
      (speed-x 0)
      (speed-y -800)
      (acceleration 4)
      (affects-player #t)
      (width 32)
      (height 192)
      (x 2336)
      (y 448)
    )
    (wind
      (z-pos -99)
      (speed-x 0)
      (speed-y -800)
      (acceleration 4)
      (affects-player #t)
      (width 32)
      (height 192)
      (x 2304)
      (y 448)
    )
    (wind
      (z-pos -99)
      (speed-x -300)
      (speed-y -800)
      (acceleration 4)
      (affects-player #t)
      (width 32)
      (height 192)
      (x 2304)
      (y 256)
    )
    (wind
      (z-pos -99)
      (speed-x 400)
      (speed-y -800)
      (acceleration 4)
      (affects-player #t)
      (width 32)
      (height 192)
      (x 2336)
      (y 256)
    )
    (wind
      (z-pos -99)
      (speed-x 300)
      (speed-y -800)
      (acceleration 4)
      (affects-player #t)
      (width 32)
      (height 192)
      (x 3040)
      (y 416)
    )
    (wind
      (z-pos -99)
      (speed-x -800)
      (speed-y 0)
      (acceleration 8)
      (affects-player #t)
      (width 192)
      (height 32)
      (x 4032)
      (y 736)
    )
    (wind
      (z-pos -99)
      (speed-x 400)
      (speed-y -800)
      (acceleration 4)
      (affects-player #t)
      (width 32)
      (height 192)
      (x 3072)
      (y 416)
    )
    (wind
      (z-pos -99)
      (speed-x -800)
      (speed-y 0)
      (acceleration 8)
      (affects-player #t)
      (width 192)
      (height 32)
      (x 4032)
      (y 704)
    )
    (wind
      (z-pos -99)
      (speed-x -800)
      (speed-y 0)
      (acceleration 8)
      (affects-player #t)
      (width 192)
      (height 32)
      (x 3072)
      (y 704)
    )
    (wind
      (z-pos -99)
      (speed-x -800)
      (speed-y -400)
      (acceleration 8)
      (affects-player #t)
      (width 192)
      (height 32)
      (x 3072)
      (y 736)
    )
    (wind
      (z-pos -99)
      (speed-x -800)
      (speed-y 0)
      (acceleration 8)
      (affects-player #t)
      (width 192)
      (height 32)
      (x 3456)
      (y 704)
    )
    (wind
      (z-pos -99)
      (speed-x -800)
      (speed-y 0)
      (acceleration 8)
      (affects-player #t)
      (width 192)
      (height 32)
      (x 3456)
      (y 736)
    )
    (wind
      (z-pos -99)
      (speed-x -800)
      (speed-y 0)
      (acceleration 8)
      (affects-player #t)
      (width 192)
      (height 32)
      (x 3264)
      (y 704)
    )
    (wind
      (z-pos -99)
      (speed-x -800)
      (speed-y -400)
      (acceleration 8)
      (affects-player #t)
      (width 192)
      (height 32)
      (x 3264)
      (y 736)
    )
    (wind
      (z-pos -99)
      (speed-x -800)
      (speed-y 0)
      (acceleration 8)
      (affects-player #t)
      (width 192)
      (height 32)
      (x 3648)
      (y 704)
    )
    (wind
      (z-pos -99)
      (speed-x -800)
      (speed-y -400)
      (acceleration 8)
      (affects-player #t)
      (width 192)
      (height 32)
      (x 3648)
      (y 736)
    )
    (wind
      (z-pos -99)
      (speed-x -800)
      (speed-y 0)
      (acceleration 8)
      (affects-player #t)
      (width 192)
      (height 32)
      (x 3840)
      (y 704)
    )
    (wind
      (z-pos -99)
      (speed-x -800)
      (speed-y 0)
      (acceleration 8)
      (affects-player #t)
      (width 192)
      (height 32)
      (x 3840)
      (y 736)
    )
  )
)
