(supertux-level
  (version 3)
  (name (_ "Tux the Builder"))
  (author "Wolfgang Becker")
  (license "GPL 2+ / CC-by-sa 3.0")
  (allow-item-pocket "inherit")
  (icon "")
  (icon-locked "")
  (statistics
    (enable-coins #t)
    (enable-secrets #t)
  )
  (sector
    (name "main")
    (ambient-light
      (color 1 1 1)
    )
    (background
      (color 1 1 1)
      (speed 0.5)
      (image-top "images/background/BlueRock_Forest/blue-top.jpg")
      (image "images/background/BlueRock_Forest/blue-middle.jpg")
      (image-bottom "images/background/BlueRock_Forest/blue-bottom.jpg")
    )
    (bonusblock
      (type "purple")
      (z-pos 51)
      (x 832)
      (y 384)
    )
    (camera
      (name "Camera")
      (mode "normal")
    )
    (firefly
      (z-pos 0)
      (x 3200)
      (y 704)
    )
    (firefly
      (z-pos 0)
      (x 7072)
      (y 704)
    )
    (fish-jumping
      (z-pos 50)
      (x 8032)
      (y 768)
      (glinting #f)
    )
    (fish-jumping
      (z-pos 50)
      (x 4256)
      (y 832)
      (glinting #f)
    )
    (infoblock
      (z-pos 51)
      (message (_ "-Portable Rocks:

!images/help/rockhowto1.png
!images/help/rockhowto2.png
!images/help/rockhowto3.png
"))
      (x 320)
      (y 704)
    )
    (mrbomb
      (z-pos 50)
      (direction "left")
      (x 3141)
      (y 808)
      (glinting #f)
    )
    (mrtree
      (z-pos 50)
      (direction "left")
      (x 2112)
      (y 766)
      (glinting #f)
    )
    (music
      (file "music/forest2.ogg")
    )
    (rock
      (z-pos 50)
      (x 3360)
      (y 576)
    )
    (rock
      (z-pos 50)
      (x 3488)
      (y 576)
    )
    (rock
      (z-pos 50)
      (x 3424)
      (y 576)
    )
    (rock
      (z-pos 50)
      (x 3424)
      (y 704)
    )
    (rock
      (z-pos 50)
      (x 3424)
      (y 672)
    )
    (rock
      (z-pos 50)
      (x 3488)
      (y 672)
    )
    (rock
      (z-pos 50)
      (x 3488)
      (y 704)
    )
    (rock
      (z-pos 50)
      (x 7488)
      (y 736)
    )
    (rock
      (z-pos 50)
      (x 7392)
      (y 768)
    )
    (rock
      (z-pos 50)
      (x 7392)
      (y 736)
    )
    (rock
      (z-pos 50)
      (x 7424)
      (y 768)
    )
    (rock
      (z-pos 50)
      (x 7456)
      (y 768)
    )
    (rock
      (z-pos 50)
      (x 7520)
      (y 704)
    )
    (rock
      (z-pos 50)
      (x 7520)
      (y 736)
    )
    (rock
      (z-pos 50)
      (x 7488)
      (y 768)
    )
    (rock
      (z-pos 50)
      (x 7488)
      (y 704)
    )
    (rock
      (z-pos 50)
      (x 7456)
      (y 736)
    )
    (rock
      (z-pos 50)
      (x 640)
      (y 672)
    )
    (snail
      (z-pos 50)
      (direction "left")
      (x 5152)
      (y 736)
      (glinting #f)
    )
    (spawnpoint
      (name "main")
      (x 96)
      (y 800)
    )
    (tilemap
      (solid #f)
      (z-pos -100)
      (name "Background")
      (width 305)
      (height 30)
      (tiles -1419 0 1168 1169 1170 -302 0 1174 1175 1176 1177 -67 0 1073 1074 1075 -110 0 1287 1288 -16 0 1073 1074 1075 -99 0 1179 1180 1181 1182 1183 -67 0 1081 1082 1083 1084 -109 0 1289 1290 -16 0 1081 1082 1083 1084 -98 0 1185 1186 1187 1188 1189 1190 -2 0 1287 1288 -61 0 1088 1089 1090 1091 1092 1093 -40 0 1073 1074 1075 -6 0 1168 1169 1170 -7 0 1073 1074 1075 -13 0 1168 1169 1170 -30 0 1291 1292 -15 0 1088 1089 1090 1091 1092 1093 -15 0 1168 1169 1170 -6 0 1073 1074 1075 -57 0 1073 1074 1075 -10 0 1191 1192 1193 1194 1195 1196 -2 0 1289 1290 -8 0 1073 1074 1075 -49 0 1095 1096 1097 1098 1099 1100 1101 -40 0 1081 1082 1083 1084 -5 0 1174 1175 1176 1177 0 1287 1288 -3 0 1081 1082 1083 1084 -12 0 1174 1175 1176 1177 -29 0 1293 1294 -14 0 1095 1096 1097 1098 1099 1100 1101 -15 0 1174 1175 1176 1177 -5 0 1081 1082 1083 1084 -56 0 1081 1082 1083 1084 -9 0 1197 1198 1199 1200 1201 1202 -2 0 1291 1292 -8 0 1081 1082 1083 1084 -48 0 1103 1104 1105 1106 1107 1108 1109 1110 -38 0 1088 1089 1090 1091 1092 1093 -3 0 1179 1180 1181 1182 1183 0 1289 1290 -2 0 1088 1089 1090 1091 1092 1093 -10 0 1179 1180 1181 1182 1183 -20 0 1073 1074 1075 -6 0 1295 1296 -14 0 1103 1104 1105 1106 1107 1108 1109 1110 -13 0 1179 1180 1181 1182 1183 -4 0 1088 1089 1090 1091 1092 1093 -54 0 1088 1089 1090 1091 1092 1093 -8 0 1203 1204 1205 1206 1207 1208 -2 0 1293 1294 -7 0 1088 1089 1090 1091 1092 1093 -47 0 1111 1112 1113 1114 1115 1116 1117 1118 -8 0 1168 1169 1170 -26 0 1095 1096 1097 1098 1099 1100 1101 -3 0 1185 1186 1187 1188 1189 1190 1291 1292 0 1095 1096 1097 1098 1099 1100 1101 -10 0 1185 1186 1187 1188 1189 1190 -3 0 1073 1074 1075 -13 0 1081 1082 1083 1084 -5 0 1297 1298 -14 0 1111 1112 1113 1114 1115 1116 1117 1118 -13 0 1185 1186 1187 1188 1189 1190 -2 0 1095 1096 1097 1098 1099 1100 1101 -53 0 1095 1096 1097 1098 1099 1100 1101 -8 0 1197 1198 1199 1200 1201 1202 -2 0 1295 1296 -6 0 1095 1096 1097 1098 1099 1100 1101 -47 0 1103 1104 1105 1106 1107 1108 1109 1110 -8 0 1174 1175 1176 1177 -25 0 1103 1104 1105 1106 1107 1108 1109 1110 -2 0 1191 1192 1193 1194 1195 1196 1293 1294 0 1103 1104 1105 1106 1107 1108 1109 1110 -9 0 1191 1192 1193 1194 1195 1196 -3 0 1081 1082 1083 1084 -4 0 1168 1169 1170 -4 0 1088 1089 1090 1091 1092 1093 -2 0 1287 1288 1299 1300 -14 0 1103 1104 1105 1106 1107 1108 1109 1110 -13 0 1191 1192 1193 1194 1195 1196 -2 0 1103 1104 1105 1106 1107 1108 1109 1110 -52 0 1103 1104 1105 1106 1107 1108 1109 1110 -7 0 1203 1204 1205 1206 1207 1208 -2 0 1297 1298 -6 0 1103 1104 1105 1106 1107 1108 1109 1110 -13 0 1719 -32 0 1111 1112 1113 1114 1115 1116 1117 1118 -7 0 1179 1180 1181 1182 1183 -25 0 1111 1112 1113 1114 1115 1116 1117 1118 -2 0 1197 1198 1199 1200 1201 1202 1295 1296 0 1111 1112 1113 1114 1115 1116 1117 1118 -9 0 1197 1198 1199 1200 1201 1202 -2 0 1088 1089 1090 1091 1092 1093 -3 0 1174 1175 1176 1177 -2 0 1095 1096 1097 1098 1099 1100 1101 -2 0 1289 1290 1297 1298 -3 0 1240 1241 1242 -8 0 1111 1112 1113 1114 1115 1116 1117 1118 -13 0 1197 1198 1199 1200 1201 1202 -2 0 1111 1112 1113 1114 1115 1116 1117 1118 -48 0 1240 1241 1242 0 1111 1112 1113 1114 1115 1116 1117 1118 -7 0 1209 1210 1211 1212 1213 1214 -2 0 1299 1300 -6 0 1111 1112 1113 1114 1115 1116 1117 1118 -9 0 67 -4 66 -32 0 1103 1104 1105 1106 1107 1108 1109 1110 -7 0 1185 1186 1187 1188 1189 1190 -24 0 1103 1104 1105 1106 1107 1108 1109 1110 -2 0 1203 1204 1205 1206 1207 1208 1297 1298 0 1103 1104 1105 1106 1107 1108 1109 1110 -9 0 1203 1204 1205 1206 1207 1208 0 1095 1096 1097 1098 1099 1100 1101 -2 0 1179 1180 1181 1182 1183 -2 0 1103 1104 1105 1106 1107 1108 1109 1110 0 1291 1292 1299 1300 -2 0 1243 1244 1245 1246 -2 0 1240 1241 1242 -3 0 1119 1120 1121 1122 1123 1124 1125 1126 -13 0 1203 1204 1205 1206 1207 1208 -2 0 1119 1120 1121 1122 1123 1124 1125 1126 -47 0 1243 1244 1245 1246 0 1103 1104 1105 1106 1107 1108 1109 1110 -8 0 2045 1219 1220 -4 0 1301 1302 -6 0 1119 1120 1121 1122 1123 1124 1125 1126 -9 0 -5 66 -23 0 1240 1241 1242 -6 0 1111 1112 1113 1114 1115 1116 1117 1118 -7 0 1191 1192 1193 1194 1195 1196 -24 0 1111 1112 1113 1114 1115 1116 1117 1118 -2 0 1209 1210 1211 1212 1213 1214 1299 1300 0 1111 1112 1113 1114 1115 1116 1117 1118 -5 0 1240 1241 1242 0 1197 1198 1199 1200 1201 1202 0 1103 1104 1105 1106 1107 1108 1109 1110 0 1185 1186 1187 1188 1189 1190 0 1111 1112 1113 1114 1115 1116 1117 1118 0 1293 1294 1297 1298 -2 0 1247 1248 1249 1250 0 1243 1244 1245 1246 -3 0 1127 1128 1129 1130 1131 1132 1133 1134 -13 0 1197 1198 1199 1200 1201 1202 -2 0 1127 1128 1129 1130 1131 1132 1133 1134 -19 0 1168 1169 1170 -25 0 1247 1248 1249 1250 0 1111 1112 1113 1114 1115 1116 1117 1118 -8 0 2046 1225 1226 -4 0 1303 1304 -6 0 1127 1128 1129 1130 1131 1132 1133 1134 -9 0 -5 1478 -22 0 1243 1244 1245 1246 -6 0 1119 1120 1121 1122 1123 1124 1125 1126 -7 0 1197 1198 1199 1200 1201 1202 -24 0 1103 1104 1105 1106 1107 1108 1109 1110 -4 0 1217 1218 -2 0 1301 1302 0 1119 1120 1121 1122 1123 1124 1125 1126 -4 0 1243 1244 1245 1246 0 1203 1204 1205 1206 1207 1208 0 1111 1112 1113 1114 1115 1116 1117 1118 0 1191 1192 1193 1194 1195 1196 0 1103 1104 1105 1106 1107 1108 1109 1110 0 1295 1296 1299 1300 -2 0 1251 1252 1253 1254 0 1247 1248 1249 1250 -5 0 1137 1138 1139 1140 -15 0 1203 1204 1205 1206 1207 1208 -4 0 1137 1138 1139 1140 -21 0 1174 1175 1176 1177 -24 0 1251 1252 1253 1254 0 1103 1104 1105 1106 1107 1108 1109 1110 -9 0 1217 1218 -4 0 1305 1306 -8 0 1137 1138 1139 1140 -11 0 -5 1478 -22 0 1247 1248 1249 1250 -6 0 1127 1128 1129 1130 1131 1132 1133 1134 -7 0 1203 1204 1205 1206 1207 1208 -24 0 1111 1112 1113 1114 1115 1116 1117 1118 -4 0 1223 1224 -2 0 1303 1304 0 1127 1128 1129 1130 1131 1132 1133 1134 -4 0 1247 1248 1249 1250 0 1197 1198 1199 1200 1201 1202 0 1119 1120 1121 1122 1123 1124 1125 1126 0 1197 1198 1199 1200 1201 1202 0 1111 1112 1113 1114 1115 1116 1117 1118 0 1297 1298 1301 1302 -2 0 1255 1256 1257 1258 0 1251 1252 1253 1254 -5 0 1145 1146 1147 1148 -15 0 1197 1198 1199 1200 1201 1202 -4 0 1145 1146 1147 1148 -20 0 1179 1180 1181 1182 1183 -24 0 1255 1256 1257 1258 0 1111 1112 1113 1114 1115 1116 1117 1118 -9 0 1223 1224 -4 0 1307 1308 -8 0 1145 1146 1147 1148 -11 0 -5 1478 -22 0 1251 1252 1253 1254 -8 0 1137 1138 1139 1140 -9 0 1197 1198 1199 1200 1201 1202 -24 0 1119 1120 1121 1122 1123 1124 1125 1126 -4 0 1217 1218 -2 0 1305 1306 -3 0 1137 1138 1139 1140 -6 0 1251 1252 1253 1254 0 1203 1204 1205 1206 1207 1208 0 1127 1128 1129 1130 1131 1132 1133 1134 0 1203 1204 1205 1206 1207 1208 0 1103 1104 1105 1106 1107 1108 1109 1110 0 1299 1300 1303 1304 -2 0 1259 1260 1261 1262 0 1255 1256 1257 1258 -5 0 1137 1138 1139 1140 -15 0 1203 1204 1205 1206 1207 1208 -4 0 1137 1138 1139 1140 -20 0 1185 1186 1187 1188 1189 1190 -23 0 1259 1260 1261 1262 0 1119 1120 1121 1122 1123 1124 1125 1126 -8 0 1228 1229 1230 -4 0 1309 1310 -8 0 1137 1138 1139 1140 -11 0 -5 1478 -22 0 1255 1256 1257 1258 -8 0 1145 1146 1147 1148 -9 0 1203 1204 1205 1206 1207 1208 -24 0 1127 1128 1129 1130 1131 1132 1133 1134 -4 0 1223 1224 -2 0 1307 1308 1822 1823 0 1145 1146 1147 1148 -6 0 1255 1256 1257 1258 0 1209 1210 1211 1212 1213 1214 -3 0 1137 1138 1139 1140 -3 0 1197 1198 1199 1200 1201 1202 0 1111 1112 1113 1114 1115 1116 1117 1118 0 1301 1302 1305 1306 -2 0 1263 1264 1265 1266 0 1259 1260 1261 1262 -5 0 1145 1146 1147 1148 -5 0 -5 1478 -5 0 1209 1210 1211 1212 1213 1214 -4 0 1145 1146 1147 1148 -11 0 -5 1478 -4 0 1191 1192 1193 1194 1195 1196 -23 0 1263 1264 1265 1266 0 1127 1128 1129 1130 1131 1132 1133 1134 -8 0 1234 1235 1236 -14 0 1145 1146 1147 1148 -11 0 -5 1478 -22 0 1259 1260 1261 1262 -8 0 1137 1138 1139 1140 -9 0 1209 1210 1211 1212 1213 1214 -10 0 1633 1634 -14 0 1137 1138 1139 1140 -5 0 1228 1229 1230 -2 0 1309 1310 1824 1825 0 1137 1138 1139 1140 -6 0 1259 1260 1261 1262 -3 0 1217 1218 -5 0 1145 1146 1147 1148 -3 0 1203 1204 1205 1206 1207 1208 0 1119 1120 1121 1122 1123 1124 1125 1126 0 1307 1308 1307 1308 -2 0 1267 1268 1269 1270 0 1263 1264 1265 1266 -5 0 1137 1138 1139 1140 -5 0 -5 1478 -7 0 1217 1218 -6 0 1137 1138 1139 1140 -11 0 -5 1478 -4 0 1197 1198 1199 1200 1201 1202 -23 0 1267 1268 1269 1270 -3 0 1137 1138 1139 1140 -27 0 1137 1138 1139 1140 -11 0 -5 1478 -6 0 402 403 404 405 -12 0 1263 1264 1265 1266 -8 0 1145 1146 1147 1148 -11 0 1217 1218 -11 0 1639 1640 1641 1642 -13 0 1145 1146 1147 1148 -5 0 1234 1235 1236 -7 0 1145 1146 1147 1148 -6 0 1263 1264 1265 1266 -3 0 1223 1224 -5 0 1137 1138 1139 1140 -3 0 1209 1210 1211 1212 1213 1214 0 1127 1128 1129 1130 1131 1132 1133 1134 0 1309 1310 1309 1310 -2 0 1271 1272 1273 1274 0 1267 1268 1269 1270 -5 0 1145 1146 1147 1148 -5 0 -5 1478 -7 0 1223 1224 -6 0 1145 1146 1147 1148 -11 0 -5 1478 -4 0 1203 1204 1205 1206 1207 1208 -23 0 1271 1272 1273 1274 -3 0 1145 1146 1147 1148 -27 0 1145 1146 1147 1148 -11 0 -5 1478 -6 0 406 407 408 409 -12 0 1267 1268 1269 1270 -8 0 1153 1154 1155 1156 -11 0 1223 1224 -11 0 1646 1647 1648 1649 -13 0 1137 1138 1139 1140 -15 0 1137 1138 1139 1140 -6 0 1267 1268 1269 1270 -2 0 1228 1229 1230 -5 0 1145 1146 1147 1148 -5 0 1217 1218 -5 0 1137 1138 1139 1140 -9 0 1275 1276 1277 1278 0 1271 1272 1273 1274 -5 0 1137 1138 1139 1140 -5 0 -5 1478 -7 0 1217 1218 -6 0 1137 1138 1139 1140 -11 0 -5 1478 -4 0 1209 1210 1211 1212 1213 1214 -23 0 1275 1276 1277 1278 -3 0 1137 1138 1139 1140 -27 0 1137 1138 1139 1140 -11 0 -5 1478 -4 0 402 403 450 451 452 453 404 405 -10 0 1271 1272 1273 1274 -8 0 1161 1162 1163 1164 -11 0 1217 1218 -11 0 1653 1654 1655 1656 -13 0 1145 1146 1147 1148 -15 0 1145 1146 1147 1148 -6 0 1271 1272 1273 1274 -2 0 1234 1235 1236 -5 0 1153 1154 1155 1156 -5 0 1223 1224 -5 0 1145 1146 1147 1148 -9 0 1279 1280 1281 1282 0 1275 1276 1277 1278 -5 0 1145 1146 1147 1148 -5 0 -4 1478 -8 0 1223 1224 -6 0 1145 1146 1147 1148 -11 0 -4 1478 -7 0 1217 1218 -25 0 1279 1280 1281 1282 -3 0 1145 1146 1147 1148 -27 0 1145 1146 1147 1148 -11 0 -5 1478 -4 0 406 407 454 455 456 457 408 409 -10 0 1275 1276 1277 1278 -23 0 1223 1224 -11 0 1660 1661 1662 1663 1664 1665 -11 0 1153 1154 1155 1156 -15 0 1153 1154 1155 1156 -6 0 1275 1276 1277 1278 -10 0 1161 1162 1163 1164 -5 0 1217 1218 -5 0 1153 1154 1155 1156 -9 0 1283 1284 1285 1286 0 1279 1280 1281 1282 -5 0 1153 1154 1155 1156 -5 0 -4 1478 -7 0 1228 1229 1230 1822 1823 -4 0 1153 1154 1155 1156 -11 0 -4 1478 -7 0 1223 1224 -25 0 1283 1284 1285 1286 -3 0 1153 1154 1155 1156 -27 0 1153 1154 1155 1156 -6 0 1822 1823 -3 0 -5 1478 -4 0 418 419 450 451 452 453 420 421 -10 0 1279 1280 1281 1282 -16 0 434 435 436 437 404 405 1228 1229 1230 -11 0 1667 1668 1669 1670 1671 1672 1673 -10 0 1161 1162 1163 1164 -15 0 1161 1162 1163 1164 -6 0 1279 1280 1281 1282 -19 0 1223 1224 -5 0 1161 1162 1163 1164 -14 0 1283 1284 1285 1286 -5 0 1161 1162 1163 1164 -5 0 -3 1478 -8 0 1234 1235 1236 1824 1825 -4 0 1161 1162 1163 1164 -11 0 -3 1478 -7 0 1228 1229 1230 -32 0 1161 1162 1163 1164 -27 0 1161 1162 1163 1164 -6 0 1824 1825 -3 0 -4 1478 66 -4 0 422 423 454 455 456 457 424 425 -10 0 1283 1284 1285 1286 -16 0 438 439 440 441 408 409 1234 1235 1236 -11 0 1674 1675 1676 1677 1678 1679 1680 -39 0 1283 1284 1285 1286 -18 0 1228 1229 1230 -86 0 1234 1235 1236 -95 0 76 -6 0 76 -22 0 442 443 444 445 412 413 -82 0 1234 1235 1236 -64 0 76 -11 0 76 -18 0 -2 76 -14 0 -2 76 -71 0 75 -6 0 75 -22 0 446 447 448 449 416 417 -149 0 75 -11 0 75 -18 0 -2 75 -14 0 -2 75 -71 0 75 -6 0 75 -177 0 75 -11 0 75 -18 0 -2 75 -14 0 -2 75 -71 0 75 -6 0 75 -49 0)
    )
    (tilemap
      (solid #t)
      (z-pos 0)
      (name "Interactive")
      (width 305)
      (height 30)
      (tiles -3891 0 62 0 62 1719 104 1719 1718 1721 -173 0 80 -34 0 80 -88 0 1419 66 1419 -2 66 -176 0 1348 -21 0 44 -3 0 44 -8 0 1348 -88 0 1420 66 1420 -2 66 -176 0 79 -34 0 79 -88 0 67 0 67 -2 66 -176 0 79 -17 0 -2 44 -9 0 44 -5 0 79 -88 0 67 321 66 0 321 -176 0 79 -17 0 1746 1747 -15 0 79 -61 0 1060 1002 1061 -24 0 67 -2 66 321 66 -176 0 79 -15 0 1760 1761 1748 1749 -10 0 44 -2 0 62 0 62 0 62 -55 0 1060 1002 1001 1063 1064 1006 1065 1066 1061 -22 0 67 -3 66 -168 0 1752 1753 -5 0 67 -4 66 -15 0 1750 1751 -10 0 27 -2 28 29 -2 67 -2 66 -53 0 1060 1063 1064 1006 1005 1067 -2 1009 1069 1070 1065 1066 1061 -20 0 67 66 0 67 321 -63 0 1311 -28 0 1060 1001 1002 1001 1002 1052 -46 0 317 318 -21 0 1754 1755 1756 1757 -3 0 67 -4 66 -29 0 67 -5 66 -12 0 102 -38 0 1060 1063 1064 1067 1068 -2 1013 1069 -4 1013 1069 1070 1048 1052 -19 0 67 66 321 66 -30 0 1060 1061 -32 0 1311 -24 0 1060 1001 1002 1063 1064 1005 1006 1005 1006 1054 -24 0 104 77 103 -2 77 -16 0 1051 319 320 1002 1001 1061 -18 0 1758 1759 -5 0 67 -34 0 67 0 67 0 67 -50 0 1045 1047 1067 1068 -11 1013 1050 1054 -19 0 67 66 321 -29 0 1060 1063 1064 1065 1066 1061 -5 0 1060 1061 -23 0 1311 -13 0 -2 83 -7 0 1060 1063 1064 1005 1006 1067 1068 1069 -3 1013 1056 1052 -44 0 1053 1006 1005 1006 1005 1065 1066 1061 -10 0 -2 83 102 -10 0 67 -4 0 1061 -29 0 67 0 67 0 67 -42 0 -3 83 -5 0 1053 1049 -3 1013 1020 1021 1022 1020 1021 1022 -5 1013 1056 1052 -29 0 -4 83 -16 0 1045 1047 1067 1068 1069 1070 1065 1066 1002 1001 1002 1063 1064 1065 1066 1061 -21 0 1311 -21 0 1045 1047 1067 1068 -5 1013 1009 1010 1013 1058 1054 -13 0 1060 1002 1001 1002 1001 1002 1061 -23 0 1051 1055 -4 1013 1069 1070 1065 1066 1061 -21 0 67 -3 66 1013 1065 1066 1052 -27 0 67 321 66 321 66 -10 0 1060 1003 -21 0 1000 1061 -14 0 1051 1055 -4 1013 1023 1024 1031 1032 1024 1025 1010 -4 1013 1058 1054 -49 0 1053 1049 -4 1013 1069 1070 1006 1005 1006 1067 1068 1069 1070 1048 1052 -8 0 1060 1002 1001 1002 1061 -7 0 133 -3 0 1311 -17 0 1053 1049 -2 1013 1020 -3 1021 1022 1013 1014 -2 1013 1056 1061 -10 0 1060 1063 1064 1006 1005 1006 1005 1006 1065 1066 1001 1002 1001 1002 1001 1002 1001 1052 -12 0 317 318 1053 1057 1013 1010 -4 1013 1069 1070 1065 1066 1061 -19 0 67 -2 66 -2 1013 1069 1070 1054 -11 0 62 -15 0 67 -4 66 -8 0 1060 1063 1064 1007 67 27 -7 28 29 67 27 -7 28 29 67 1004 1065 1066 1061 -12 0 1053 1057 -2 1013 1020 1021 1032 -3 1024 1029 1028 -6 1013 1056 1061 -21 0 66 -25 0 1060 1055 -11 1013 1010 -2 1013 1050 1054 -6 0 1060 1063 1064 1006 1005 1006 1065 1066 1061 -5 0 133 -2 0 132 1311 0 1001 1002 1001 1002 -2 1001 1002 1001 1002 1001 1002 1001 1002 1001 1002 1001 1055 -3 1013 1023 -3 1024 1025 -4 1013 1058 1065 1066 1061 -7 0 1045 1047 1067 1068 -3 1013 1020 1021 1022 1070 1005 1006 1005 1006 1005 1006 1005 1054 -6 0 1060 1002 1001 1002 1001 1002 319 320 1055 -5 1013 1020 1021 1022 1013 1069 1070 1065 1066 1001 1002 1001 1002 1001 1002 1001 1002 1001 1002 1001 1002 1001 1002 1001 1002 1001 1002 67 -2 66 1013 1010 -2 1013 1056 1001 1002 1001 1002 1001 1002 1001 1002 1001 -3 62 1001 1002 1001 1003 -11 0 67 -4 66 -6 0 1060 1063 1064 1067 1068 1011 340 342 -7 0 340 341 342 -7 0 340 342 1008 1069 1070 1065 1066 1001 1002 1001 1002 1001 1002 1001 1002 1001 1002 1001 1055 -3 1013 1023 -2 1024 1029 1030 1024 1031 1021 1022 -5 1013 1058 1048 1002 1001 1002 1001 1002 1001 1002 1001 1002 1001 1002 1001 1002 1001 1002 1001 1002 67 66 321 -2 66 1002 -2 321 1001 1002 1001 1002 1001 1002 1001 1002 1001 1003 -6 0 1000 1002 1001 1002 1001 1063 1064 1057 1013 1010 -6 1013 1020 1021 1022 -4 1013 1056 1052 -3 0 1060 1063 1064 1067 1068 -4 1013 1070 1065 1066 1001 1002 1001 1002 133 1002 1001 132 1311 1002 1005 1006 1005 1006 -2 1005 1006 1005 1006 1005 1006 1005 1006 1005 1006 1005 1057 -3 1013 1023 1024 1029 1027 1028 -5 1013 1069 1070 1065 1066 1002 1003 -4 0 1053 1049 -4 1013 1014 1023 1024 1025 -4 1013 1020 1021 1022 1013 1056 1061 -3 0 1060 1063 1064 1006 1005 1006 1005 1006 1005 1006 1057 -5 1013 1023 1024 1025 -3 1013 1069 1070 1005 1006 1005 1006 1005 1006 1005 1006 1005 1006 1005 1006 1005 1006 1005 1006 1005 1006 1067 -5 1013 1021 1022 1005 1006 1005 1006 1005 1006 1005 1006 1005 1006 1005 1006 1005 1006 1005 1007 -11 0 67 -4 66 0 1060 1001 1002 1001 1063 1064 1067 -3 1068 1015 67 1000 1003 -7 0 321 -8 0 1006 67 1012 -2 1013 1069 1070 1005 1006 1005 1006 1005 1006 1005 1006 1005 1006 1005 1057 -3 1013 1026 1027 1030 1031 1032 1029 1030 1024 1025 -6 1013 1050 1006 1005 1006 1005 1006 1005 1006 1005 1006 1005 1006 1005 1006 1005 1006 1005 1006 67 -4 66 1006 1005 1006 1005 1006 1005 1006 1005 1006 1005 1006 1005 1007 -6 76 1004 1006 1005 1006 1005 1067 1068 -9 1013 1023 1024 1025 -4 1013 1058 1054 0 1060 1045 1047 1067 1068 -3 1013 1020 1021 1022 1013 1069 1070 1005 1006 1005 1006 1005 1006 1005 1006 1005 1006 -8 1013 1020 1021 1022 -4 1013 1014 -3 1013 1020 1032 1029 1028 -2 1013 1009 1010 -5 1013 1069 1070 1006 1007 -3 0 1051 1055 -4 1013 1010 1013 1026 1027 1028 -3 1013 1020 1032 1024 1025 1013 1058 1065 1066 1002 1063 1064 1067 1068 -10 1013 1010 -2 1013 1026 1027 1028 1010 -19 1013 1014 -5 1013 1010 1020 1029 1030 -5 1013 -3 1014 -8 1013 1011 -11 76 67 -4 66 1063 1064 1005 1006 1005 1067 -3 1068 1009 1010 1011 67 1004 1007 -7 76 67 -8 76 1818 67 1817 -4 1013 1009 -11 1013 1009 1010 -3 1013 1023 -2 1024 1025 1026 1027 1028 -2 1013 1009 1010 -4 1013 1010 -29 1013 1010 -2 1013 1011 -6 75 1008 -15 1013 1026 1030 1031 1021 1022 -3 1013 1056 1001 1002 1047 1049 -3 1013 1020 1021 1032 1024 1025 -14 1013 1014 1013 1010 -2 1013 1014 1013 1023 1024 1025 -2 1013 1009 1010 -2 1013 1014 1013 1023 1024 1025 -4 1013 1014 -7 1013 1010 1011 -3 0 1053 1057 -7 1013 1010 -4 1013 1026 1030 1024 1025 1014 1013 1069 1070 1006 1067 1068 -3 1013 1010 -4 1013 1014 -14 1013 1014 -6 1013 1010 -4 1013 1010 -9 1013 1023 1031 1032 1014 1013 -3 1014 -6 1013 -2 1010 -3 1013 1015 -11 75 67 -4 66 1067 1068 1069 1009 1010 1068 1014 1020 1021 1022 -2 1014 1013 1014 1011 -7 75 67 -8 75 1012 -4 1013 1009 -3 1013 1009 -2 1013 1010 -7 1013 1014 -3 1013 1023 1024 1029 1028 1013 1010 -4 1013 1014 -16 1013 1010 -6 1013 1010 -7 1013 1010 -5 1013 1015 -6 75 1012 -7 1013 1010 -5 1013 1010 -2 1013 1026 1030 1024 1025 -3 1013 1058 1005 1006 1049 -4 1013 1023 1024 1029 1027 1028 -5 1013 1010 -15 1013 1026 1027 1028 -3 1013 1014 -4 1013 1026 1027 1028 1014 -11 1013 1014 1015 -2 0 1051 1055 -3 1013 1014 -10 1013 1026 1027 1028 -23 1013 1014 -28 1013 1026 1027 1028 -7 1013 1010 -8 1013 1011 -11 75 67 -2 66 1068 1069 1068 1069 1068 1013 1014 1069 1068 1023 1024 1025 1013 1014 1013 1014 1015 -7 75 67 -8 75 1008 -5 1013 1010 -17 1013 1026 1027 1028 -29 1013 1010 -15 1013 1011 -6 75 1008 -17 1013 1026 1027 1028 -11 1013 1026 1027 1028 -15 1013)
    )
    (tilemap
      (solid #f)
      (z-pos 100)
      (name "Foreground")
      (width 305)
      (height 30)
      (tiles -1181 0 1311 -3 0 1311 -3 0 -2 1311 -5 0 -3 1311 -3 0 1311 -2 0 1311 -3 0 1311 -3 0 1311 -3 0 1311 -268 0 1311 0 1311 0 1311 -3 0 1311 0 1311 -6 0 1311 -2 0 -2 1311 0 1311 0 1311 0 1311 0 1311 0 1311 0 1311 0 1311 -269 0 1311 0 1311 0 1311 -3 0 -2 1311 -6 0 1311 -3 0 1311 -4 0 1311 0 1311 0 1311 0 1311 0 1311 0 -2 1311 -268 0 -5 1311 -3 0 1311 0 1311 -5 0 1311 -2 0 1311 -4 0 1311 -2 0 1311 0 1311 0 1311 0 1311 0 1311 0 1311 -268 0 1311 0 1311 -2 0 1311 0 -2 1311 -2 0 1311 -3 0 1311 -2 0 1311 -3 0 -3 1311 -2 0 1311 -3 0 1311 -3 0 1311 -1453 0 322 0 1358 1360 1358 1360 -299 0 323 324 1364 1366 1364 1366 -299 0 325 326 1358 1359 1360 -300 0 327 328 1364 1365 1366 -300 0 329 330 323 324 -301 0 323 324 325 326 -301 0 325 326 327 328 322 -174 0 1419 0 1419 0 1419 -30 0 1419 0 1419 0 1419 -86 0 327 328 329 330 -175 0 1420 0 1420 0 1420 -30 0 1420 323 1420 0 1420 -86 0 329 330 322 -146 0 1002 1001 -64 0 325 -2 326 -87 0 1358 1360 323 324 -177 0 1051 1063 1066 1061 -30 0 327 -2 328 -87 0 1364 1366 325 326 -63 0 1643 1644 1645 1656 -81 0 317 318 -27 0 1053 1067 1070 1065 1066 1052 -120 0 327 328 -63 0 1650 1651 1652 1663 1664 1665 -79 0 319 320 -26 0 1060 1055 -2 0 1069 1070 1054 -120 0 329 330 -63 0 1657 1658 1659 1670 1671 1672 1673 -44 0 317 318 -25 0 1001 1002 -32 0 1063 1064 1057 -4 0 1056 1001 1002 1001 1002 1001 1002 1001 1002 1001 1002 1001 1002 1001 1002 1001 1003 -38 0 322 -8 0 1819 -37 0 1046 -16 0 1001 1002 1001 1002 1001 0 1001 1002 -61 0 1666 1677 1678 1679 1680 -44 0 319 320 -59 0 1067 0 1020 -3 1021 1022 1058 1005 1006 1005 1006 1005 1006 1005 1006 1005 1006 1005 1006 1005 1006 1005 1007 -24 0 317 318 -21 0 1818 -5 0 317 318 -47 0 1005 1006 1005 1006 1005 -62 0 1006 1005 1006 1005 1006 1005 1006 -17 0 317 318 -87 0 1020 1032 1024 1029 1030 1025 -14 0 317 318 -16 0 1060 -8 0 319 320 -2 0 1724 -9 0 201 -9 0 1724 -4 0 319 320 -35 0 317 318 -101 0 319 320 -87 0 1026 1027 1030 1031 1032 1025 -14 0 319 320 -14 0 1060 1063 1064 -22 0 200 -51 0 319 320 -192 0 1026 1027 0 1028 -28 0 1060 1063 1064 1067 -23 0 200 -137 0)
    )
    (viciousivy
      (z-pos 50)
      (x 9250)
      (y 740)
      (glinting #f)
    )
    (viciousivy
      (z-pos 50)
      (x 8962)
      (y 868)
      (glinting #f)
    )
    (viciousivy
      (z-pos 50)
      (x 8674)
      (y 708)
      (glinting #f)
    )
    (viciousivy
      (z-pos 50)
      (direction "left")
      (x 5858)
      (y 804)
      (glinting #f)
    )
    (viciousivy
      (z-pos 50)
      (direction "left")
      (x 6562)
      (y 548)
      (glinting #f)
    )
    (viciousivy
      (z-pos 50)
      (direction "left")
      (x 1762)
      (y 644)
      (glinting #f)
    )
    (viciousivy
      (z-pos 50)
      (direction "left")
      (x 2498)
      (y 676)
      (glinting #f)
    )
    (viciousivy
      (z-pos 50)
      (direction "left")
      (x 2818)
      (y 804)
      (glinting #f)
    )
    (zeekling
      (z-pos 50)
      (direction "left")
      (x 5632)
      (y 512)
      (glinting #f)
    )
  )
)
