(supertux-level
  (version 3)
  (name (_ "Welcome to the Forest"))
  (author "Christoph Sommer")
  (license "GPL 2+ / CC-by-sa 3.0")
  (allow-item-pocket "inherit")
  (icon "")
  (icon-locked "")
  (statistics
    (enable-coins #t)
    (enable-secrets #t)
  )
  (sector
    (name "main")
    (ambient-light
      (color 1 1 1)
    )
    (background
      (scroll-offset-y 150)
      (color 1 1 1)
      (speed 0.5)
      (image-top "images/background/BlueRock_Forest/blue-top.jpg")
      (image "images/background/BlueRock_Forest/blue-middle.jpg")
      (image-bottom "images/background/BlueRock_Forest/blue-bottom.jpg")
    )
    (camera
      (name "Camera")
      (mode "normal")
    )
    (door
      (z-pos -99)
      (sector "main")
      (locked #f)
      (spawnpoint "wall2")
      (x 8080)
      (y 1600)
    )
    (door
      (z-pos -99)
      (sector "main")
      (locked #f)
      (spawnpoint "wall2")
      (x 3800)
      (y 1404)
    )
    (door
      (z-pos -99)
      (sector "main")
      (locked #f)
      (spawnpoint "wall1")
      (x 3992)
      (y 1404)
    )
    (firefly
      (z-pos 0)
      (x 4473.051)
      (y 1576.838)
    )
    (firefly
      (z-pos 0)
      (x 6112)
      (y 928)
    )
    (firefly
      (z-pos 0)
      (x 9312)
      (y 1104)
    )
    (mrtree
      (z-pos 50)
      (direction "left")
      (x 7104)
      (y 1022)
      (glinting #f)
    )
    (mrtree
      (z-pos 50)
      (direction "left")
      (x 8224)
      (y 1022)
      (glinting #f)
    )
    (music
      (file "music/forest.music")
    )
    (secretarea
      (width 536.8745)
      (height 312.9138)
      (x 7616)
      (y 1440)
    )
    (secretarea
      (width 268)
      (height 316)
      (x 9744)
      (y 832)
    )
    (sequencetrigger
      (sequence "stoptux")
      (width 28)
      (height 188)
      (x 12256)
      (y 1536)
    )
    (sequencetrigger
      (sequence "endsequence")
      (width 444)
      (height 188)
      (x 11840)
      (y 1536)
    )
    (spawnpoint
      (name "main")
      (x 160)
      (y 1856)
    )
    (spawnpoint
      (name "wall1")
      (x 3808)
      (y 1440)
    )
    (spawnpoint
      (name "wall2")
      (x 4000)
      (y 1440)
    )
    (tilemap
      (solid #f)
      (z-pos -100)
      (name "Background")
      (width 384)
      (height 64)
      (tiles -1173 0 1073 -1942 0 1246 -2077 0 85 86 87 88 -380 0 89 90 91 92 -1139 0 85 86 87 88 -19 0 85 86 87 88 -8 0 85 86 87 88 -20 0 85 86 87 88 -321 0 89 90 91 92 -8 0 85 86 87 88 -7 0 89 90 91 92 -8 0 89 90 91 92 -20 0 89 90 91 92 -306 0 85 86 87 88 -23 0 89 90 91 92 -353 0 89 90 91 92 -421 0 85 86 87 88 -19 0 85 86 87 88 -261 0 85 86 87 88 -92 0 89 90 91 92 -8 0 85 86 87 88 -7 0 89 90 91 92 -236 0 85 86 87 88 -21 0 89 90 91 92 -24 0 85 86 87 88 -14 0 85 86 87 88 -19 0 85 86 87 88 -35 0 89 90 91 92 -162 0 85 86 87 88 -24 0 85 86 87 88 -24 0 85 86 87 88 -25 0 89 90 91 92 -49 0 89 90 91 92 -14 0 89 90 91 92 -8 0 85 86 87 88 -7 0 89 90 91 92 -201 0 89 90 91 92 -24 0 89 90 91 92 -24 0 89 90 91 92 -108 0 89 90 91 92 -222 0 85 86 87 88 -24 0 85 86 87 88 -35 0 85 86 87 88 -20 0 85 86 87 88 -19 0 85 86 87 88 -266 0 89 90 91 92 -24 0 89 90 91 92 -21 0 85 86 87 88 -10 0 89 90 91 92 -9 0 85 86 87 88 -7 0 89 90 91 92 -8 0 85 86 87 88 -7 0 89 90 91 92 -17 0 85 86 87 88 -228 0 85 86 87 88 -28 0 85 86 87 88 -20 0 85 86 87 88 -10 0 89 90 91 92 -23 0 89 90 91 92 -19 0 89 90 91 92 -17 0 85 86 87 88 -7 0 89 90 91 92 -228 0 89 90 91 92 -28 0 89 90 91 92 -20 0 89 90 91 92 -81 0 89 90 91 92 -42 0 141 142 -45 0 402 403 404 405 -333 0 143 144 -29 0 402 403 404 405 402 403 404 405 -8 0 406 407 408 409 402 403 404 405 -360 0 406 407 408 409 406 407 408 409 -6 0 402 403 428 429 412 413 406 407 408 409 -10 0 402 403 404 405 -312 0 1348 -3 0 1348 -25 0 402 403 404 405 410 411 426 427 428 429 420 421 -6 0 406 407 432 433 402 403 428 429 420 421 -10 0 406 407 408 409 -312 0 79 -3 0 79 -10 0 -2 1002 -13 0 406 407 408 409 414 415 430 431 432 433 424 425 -10 0 430 431 432 433 424 425 -10 0 410 411 412 413 0 -2 1002 -19 0 402 403 404 405 402 403 404 405 -16 0 402 403 404 405 -262 0 79 -3 0 79 -89 0 406 407 408 409 406 407 408 409 -16 0 406 407 408 409 -262 0 79 -3 0 79 -85 0 402 403 404 405 410 411 426 427 428 429 420 421 -16 0 410 411 412 413 -258 0 1348 -3 0 1348 -3 0 79 -85 0 406 407 408 409 414 415 430 431 432 433 424 425 -14 1351 -257 0 1073 1074 1075 -4 0 79 -3 0 79 -3 0 79 -97 0 -14 1352 -252 0 1169 1170 -3 0 1081 1082 1083 1084 -3 0 79 -3 0 79 -3 0 79 -87 0 -24 1353 -251 0 1174 1175 1176 1177 0 1088 1089 1090 1091 1092 1093 -2 0 79 -3 0 79 -3 0 79 -87 0 -24 1353 -250 0 1179 1180 1181 1182 1183 1095 1096 1097 1098 1099 1100 1101 -2 0 79 -3 0 1348 -3 0 1348 -87 0 -24 1353 -54 0 1168 1169 1170 -108 0 1073 1074 1075 -82 0 1185 1186 1187 1188 1189 1103 1104 1105 1106 1107 1108 1109 1110 0 79 -3 0 79 -3 0 79 -86 0 -25 1353 -54 0 1174 1175 1176 1177 -107 0 1081 1082 1083 1084 -15 0 1240 1241 -10 0 -3 1478 -3 0 -3 1478 -45 0 1191 1192 1193 1194 1195 1111 1112 1113 1114 1115 1116 1117 1118 0 79 -3 0 79 -3 0 79 -85 0 -19 1353 -54 0 1073 1074 1075 -3 0 1179 1180 1181 1182 1183 -92 0 1240 1241 -12 0 1088 1089 1090 1091 1092 1093 -13 0 1243 1244 1245 1246 -9 0 3280 -2 3277 -3 0 -2 3277 3278 -45 0 1197 1198 1199 1200 1201 1119 1120 1121 1122 1123 1124 1125 1126 0 79 -3 0 79 -3 0 79 -85 0 -17 1353 -56 0 1081 1082 1083 1084 -2 0 1185 1186 1187 1188 1189 1190 -85 0 1073 -4 0 1243 1244 1245 1246 -10 0 1095 1096 1097 1098 1099 1100 1101 -13 0 1247 1248 1249 1250 -9 0 3280 -2 3277 -3 0 -2 3277 3278 -45 0 1203 1204 1205 1206 1207 1127 1128 1129 1130 1131 1132 1133 1134 0 1348 -3 0 1348 -3 0 79 -84 0 -16 1353 -57 0 1088 1089 1090 1091 1092 1093 0 1191 1192 1193 1194 1195 1196 -4 0 130 -51 0 1073 1074 1075 -31 0 1247 1248 1249 1250 -10 0 1103 1104 1105 1106 1107 1108 1109 1110 -12 0 1251 1252 1253 1254 -7 0 141 142 3280 -2 3277 -3 0 -2 3277 3278 141 142 -43 0 1209 1210 1211 1212 1213 -2 0 1137 1138 1139 1140 -3 0 79 -3 0 79 0 1612 1613 79 -43 0 -14 1353 68 -2 64 -24 0 -14 1353 -12 0 -5 1353 -17 0 402 403 404 405 -20 0 1095 1096 1097 1098 1099 1100 1101 0 1197 1198 1199 1200 1201 1202 -4 0 129 -51 0 1081 1082 1083 1084 -30 0 1251 1252 1253 1254 -10 0 1111 1112 1113 1114 1115 1116 1117 1118 -12 0 1255 1256 1257 1258 -7 0 143 144 3280 -2 3277 -3 0 -2 3277 3278 143 144 402 403 404 405 -40 0 2045 1219 1220 -3 0 1145 1146 1147 1148 -3 0 1349 -3 0 1349 0 1614 1615 1349 -6 1351 -37 0 -15 1353 -2 64 -24 0 -12 1353 -11 0 -9 1353 -16 0 406 407 408 409 -20 0 1103 1104 1105 1106 1107 1108 1109 1110 1203 1204 1205 1206 1207 1208 -4 0 129 -14 0 1073 1074 1075 -9 0 1073 1074 1075 -21 0 1088 1089 1090 1091 1092 1093 -5 0 1240 1241 -4 0 1073 1074 1075 -15 0 1255 1256 1257 1258 -10 0 1119 1120 1121 1122 1123 1124 1125 1126 -12 0 1259 1260 1261 1262 -21 0 407 408 409 402 403 404 405 -36 0 2046 1225 1226 -3 0 1153 1154 1155 1156 -12 0 -6 1352 -31 1353 2012 -5 0 -16 1353 64 -24 0 -10 1353 -2 0 -5 1353 -4 0 -11 1353 2012 -15 0 418 419 412 413 402 403 404 405 -16 0 1111 1112 1113 1114 1115 1116 1117 1118 1209 1210 1211 1212 1213 1214 -4 0 129 -14 0 1081 1082 1083 1084 -8 0 1081 1082 1083 1084 -9 0 1240 1241 -8 0 1095 1096 1097 1098 1099 1100 1101 -4 0 1243 1244 1245 1246 -3 0 1081 1082 1083 1084 -6 0 402 403 404 405 -4 0 1259 1260 1261 1262 -10 0 1127 1128 1129 1130 1131 1132 1133 1134 -12 0 1263 1264 1265 1266 -23 0 427 406 407 408 409 402 403 404 405 -33 0 1217 1218 -3 0 1161 1162 1163 1164 -12 0 -37 1353 2012 -5 0 -16 1353 64 -24 0 -32 1353 2013 -15 0 422 423 416 417 406 407 408 409 -16 0 1119 1120 1121 1122 1123 1124 1125 1126 0 2045 1219 1220 -6 0 129 -14 0 1089 1090 1091 1092 1093 -2 0 1240 1241 -2 0 1088 1089 1090 1091 1092 1093 -7 0 1243 1244 1245 1246 -7 0 1103 1104 1105 1106 1107 1108 1109 1110 -3 0 1247 1248 1249 1250 -2 0 1088 1089 1090 1091 1092 1093 -5 0 406 407 408 409 -4 0 1263 1264 1265 1266 -12 0 1137 1138 1139 1140 -14 0 1267 1268 1269 1270 -4 0 402 403 404 -18 0 433 416 417 406 407 408 409 -33 0 1223 1224 402 403 404 405 -15 0 -37 1353 2012 -4 0 2007 -14 1353 -3 1478 -24 0 -32 1353 2012 -15 0 410 411 426 427 428 429 420 421 -16 0 1127 1128 1129 1130 1131 1132 1133 1134 0 2046 1225 1226 -6 0 129 -14 0 1097 1098 1099 1100 1101 0 1243 1244 1245 1246 1095 1096 1097 1098 1099 1100 1101 -7 0 1247 1248 1249 1250 -7 0 1111 1112 1113 1114 1115 1116 1117 1118 -3 0 1251 1252 1253 1254 0 1095 1096 1097 1098 1099 1100 1101 -5 0 418 419 412 413 402 403 404 405 1267 1268 1269 1270 -3 0 1348 -3 0 1348 -4 0 1153 1154 1155 1156 -15 0 1280 1281 -5 0 406 407 408 -20 0 427 428 429 420 421 -32 0 1228 1229 1230 406 407 408 409 -15 0 -37 1353 2012 -4 0 2007 -14 1353 -3 1478 -24 0 -32 1353 2013 -41 0 1137 1138 1139 1140 -4 0 1217 1218 -6 0 129 -6 0 402 403 404 405 402 403 404 405 1105 1106 1107 1108 1109 1110 1247 1248 1249 1250 1103 1104 1105 1106 1107 1108 1109 1110 -6 0 1251 1252 1253 1254 -7 0 1119 1120 1121 1122 1123 1124 1125 1126 -3 0 1255 1256 1257 1258 0 1103 1104 1105 1106 1107 1108 1109 1110 -4 0 422 423 416 417 406 407 408 409 0 1280 1281 1628 1629 -2 0 79 -3 0 79 -4 0 1161 1162 1163 1164 0 -11 1351 -3 0 1284 1285 -5 0 418 419 412 -22 0 433 424 425 -32 0 1234 1235 1236 -19 0 -37 1353 2012 -4 0 2007 -14 1353 -3 1478 -24 0 -32 1353 2013 -41 0 1145 1146 1147 1148 -4 0 1223 1224 -6 0 129 -6 0 406 407 408 409 406 407 408 409 1113 1114 1115 1116 1117 1118 1251 1252 1253 1254 1111 1112 1113 1114 1115 1116 1117 1118 -6 0 1255 1256 1257 1258 -7 0 1127 1128 1129 1130 1131 1132 1133 1134 -3 0 1259 1260 1261 1262 0 1111 1112 1113 1114 1115 1116 1117 1118 402 403 404 405 410 411 426 427 428 429 420 421 0 1284 1285 1630 1631 -2 0 1349 -3 0 1349 -4 0 1161 1162 1163 1164 0 -11 1352 -62 0 402 403 404 405 -26 0 -37 1353 2012 -4 0 2007 -14 1353 -3 1478 -24 0 -32 1353 2013 -41 0 1153 1154 1155 1156 -3 0 1228 1229 1230 -6 0 129 -2 0 402 403 404 405 410 411 426 427 428 429 420 421 1121 1122 1123 1124 1125 1126 1255 1256 1257 1258 1119 1120 1121 1122 1123 1124 1125 1126 -6 0 1259 1260 1261 1262 -9 0 1137 1138 1139 1140 -5 0 1263 1264 1265 1266 0 1119 1120 1121 1122 1123 1124 1125 1126 406 407 408 409 414 415 430 431 432 433 424 425 -21 0 -12 1353 -51 0 1001 -2 1002 -7 0 406 407 408 409 -26 0 -37 1353 -5 0 2007 -14 1353 1478 1353 -29 0 -21 1353 -49 0 1161 1162 1163 1164 -3 0 1234 1235 1236 -6 0 129 -2 0 406 407 408 409 414 415 430 431 432 433 424 425 1129 1130 1131 1132 1133 1134 1259 1260 1261 1262 1127 1128 1129 1130 1131 1132 1133 1134 -6 0 1263 1264 1265 1266 -3 0 402 403 404 405 -2 0 1145 1146 1147 1148 -5 0 1267 1268 1269 1270 0 1127 1128 1129 1130 1131 1132 1133 1134 410 411 426 427 428 429 442 443 444 445 412 413 -21 0 -12 1353 -91 0 -37 1353 -5 0 2007 -16 1353 -31 0 -17 1353 -82 0 1137 1138 1139 1140 -2 0 1263 1264 1265 1266 -2 0 1137 1138 1139 1140 -8 0 1267 1268 1269 1270 -3 0 406 407 408 409 -2 0 1153 1154 1155 1156 -6 0 1280 1281 -4 0 1137 1138 1139 1140 -2 0 414 415 430 431 432 433 446 447 448 449 416 417 -21 0 -12 1353 -91 0 -37 1353 -5 0 2007 -49 0 1353 1354 -9 1353 1354 1353 -84 0 1145 1146 1147 1148 -2 0 1267 1268 1269 1270 -2 0 1145 1146 1147 1148 -7 0 141 142 1280 1281 -4 0 410 -5 0 1161 1162 1163 1164 0 402 403 404 405 0 1284 1285 402 403 404 405 1145 1146 1147 1148 -35 0 -12 1353 -91 0 -37 1353 -57 0 -9 1353 -82 0 322 329 330 0 1153 1154 1155 1156 -3 0 1280 1281 -3 0 1153 1154 1155 1156 -7 0 143 144 1284 1285 -22 0 406 407 408 409 1153 1154 1155 1156 -35 0 -12 1353 -91 0 -37 1353 -58 0 -7 1353 -87 0 1161 1162 1163 1164 -3 0 1284 1285 402 403 404 1161 1162 1163 1164 -33 0 410 411 412 413 1161 1162 1163 1164 -36 0 -11 1353 -37 0 -54 76 -7 1353 -87 76 0 -7 1353 0 -86 76 -93 0 -11 1353 -37 0 -148 75 0 -7 1353 0 -86 75 -141 0 -148 75 0 -7 1353 0 -86 75 -141 0 -148 75 0 -7 1353 0 -86 75 -141 0 -148 75 0 -7 1353 0 -86 75 -141 0 -148 75 0 -7 1353 0 -86 75)
    )
    (tilemap
      (solid #t)
      (z-pos 0)
      (name "Interactive")
      (width 384)
      (height 64)
      (tiles -11441 0 102 -271 0 301 303 -379 0 27 -3 28 29 -394 0 317 318 -20 0 1000 -4 1002 1003 -4 0 1000 1001 -3 1002 1003 -20 0 317 318 -12 0 1000 -4 1002 1061 -21 0 1000 1001 1002 1061 -263 0 -3 44 -10 0 1000 1001 -3 1002 319 320 -20 1002 1036 -4 1006 1007 -4 0 1004 1005 -3 1006 1037 1001 -19 1002 319 320 -4 1002 1003 -7 0 1004 -4 1006 1065 1066 1061 -19 0 1004 1005 1006 1065 1066 1061 -274 0 1004 1005 -25 1006 1040 -4 1009 1015 -4 0 1008 -4 1009 1041 1005 -25 1006 1007 -7 0 1008 -4 1009 1069 1070 1065 1066 1061 -17 0 1008 -2 1009 1069 1070 1065 1066 1061 -258 0 27 -3 28 29 -9 0 1008 -31 1009 1011 -4 0 1008 -31 1009 1015 -7 0 1008 -6 1009 1069 1070 1065 1066 1061 -15 0 1012 -4 1009 1069 1070 1065 1066 1061 -270 0 1008 -2 1009 1013 -6 1009 1013 -6 1009 1013 -6 1009 1013 -7 1009 1015 -4 0 1008 -3 1009 1020 1022 -26 1009 1011 -7 0 1008 -8 1009 1069 1070 1065 1066 -2 1002 1003 -11 0 1012 -6 1009 1069 1070 1065 1066 1003 -259 0 -3 44 -6 0 1008 -31 1009 1011 -4 0 1008 -3 1009 1026 1028 -26 1009 1015 -7 0 1008 -10 1009 1069 1070 -2 1006 1007 -11 0 1016 -8 1009 1069 1070 1007 -268 0 1012 1013 -30 1009 1015 -4 0 1012 -31 1009 1011 -7 0 1008 -9 1009 1018 1017 1018 1017 1018 1019 -12 0 1012 -9 1009 1011 -258 0 27 -3 28 29 -5 0 1008 1009 1013 -6 1009 1013 -6 1009 1013 -6 1009 1013 -8 1009 1011 -4 0 1008 1009 1014 -8 1009 1014 -20 1009 1015 -7 0 1008 -7 1009 1017 1019 -18 0 1008 -2 1009 1014 -6 1009 1015 112 -185 0 68 69 -5 0 68 69 -73 0 1012 1013 1009 1013 -6 1009 1013 -6 1009 1013 -6 1009 1013 -7 1009 1015 -4 0 1012 -31 1009 1011 -7 0 1008 -5 1009 1018 1019 -15 0 -4 44 0 1008 -9 1009 1011 -186 0 68 -7 64 69 -60 0 -3 44 -10 0 1008 -23 1009 1014 -7 1009 1011 -4 0 1012 -15 1009 1014 -15 1009 1015 -7 0 1008 -4 1009 1019 -15 0 1060 -6 1002 1034 -9 1009 1015 -186 0 68 -7 64 69 -73 0 1012 1013 -6 1009 1014 -23 1009 1015 -4 0 1012 -31 1009 1011 -7 0 1008 -3 1009 1019 -14 0 1060 1063 1064 -3 1006 1005 -2 1006 1040 -9 1009 1011 -189 0 68 64 69 -62 0 27 -3 28 29 -9 0 1008 1009 1013 -6 1009 1013 -6 1009 1013 -6 1009 1013 -8 1009 1011 -4 0 1008 1013 -30 1009 1015 -7 0 1008 -2 1009 1011 -13 0 1060 1063 1064 1067 1068 -16 1009 1011 112 -188 0 68 64 69 -76 0 1012 1013 1009 1013 -6 1009 1013 -6 1009 1013 -6 1009 1013 -7 1009 1015 -4 0 1012 -31 1009 1011 -7 0 1008 -2 1009 1019 -11 0 1060 1063 1064 1067 -18 1009 1018 1019 -189 0 68 64 69 -76 0 1008 -31 1009 1011 -4 0 1012 -10 1009 1018 1017 1018 1017 1018 -16 1009 1015 -7 0 1008 1014 1015 -10 0 1060 1063 1064 1067 1068 -11 1009 1018 1017 1018 -4 1009 1019 -185 0 1000 1001 -4 1002 68 64 69 -6 1002 1061 -52 0 1060 -11 1002 1003 -4 0 1012 1013 -30 1009 1015 -4 0 1008 -7 1009 1018 1017 1019 -4 0 68 1016 -15 1009 1011 -7 0 1008 1009 1011 -8 0 1000 1063 1064 1067 -11 1009 1017 1018 1019 -3 0 1016 1009 1013 1011 -149 0 -5 44 -32 0 1004 1005 -9 1006 1005 -3 1006 1065 1066 1061 -48 0 1060 1063 1064 -9 1006 1005 1006 1007 -4 0 1008 1009 1013 -8 1009 1013 -6 1009 1013 -13 1009 1011 -4 0 1012 -6 1009 1019 -7 0 68 64 1012 -14 1009 1015 -7 0 1008 1014 1015 -8 0 1004 1067 -2 1009 1017 -2 1018 -6 1009 1017 1019 -7 0 1016 1017 1019 -2 0 83 102 -2 83 -180 0 1008 -14 1009 1069 1070 1065 1066 1061 -44 0 1060 1063 1064 1067 1068 -11 1009 1011 -4 0 1012 1013 1009 1013 -8 1009 1013 -10 1009 -9 1017 1019 -4 0 1008 -5 1009 1019 -8 0 68 64 1008 -14 1009 1011 -7 0 1008 1009 1011 -3 0 -2 44 -3 0 1016 1017 1018 1019 -3 0 1016 1018 1017 1018 1017 1019 -4 0 -4 44 -152 0 340 -4 338 341 339 -31 0 1012 1020 1022 -14 1009 1069 1070 1065 1066 1061 -40 0 1060 1063 1064 1067 -14 1009 1015 -4 0 1008 -19 1009 -2 1017 1019 -14 0 1012 1009 1018 1017 1018 1019 -11 0 1012 -7 1009 1014 -6 1009 1015 -7 0 1008 1009 1015 -46 0 1000 1001 -6 1002 1003 -83 0 -2 44 -79 0 1008 1026 1028 -16 1009 1069 1070 1065 1066 1061 -8 0 -2 83 -16 0 83 102 -8 0 1060 1063 1064 1067 1068 -13 1009 1013 1009 1015 -4 0 1012 1013 -14 1009 -3 1017 1019 -17 0 1016 1019 -9 0 83 128 83 -3 0 1008 -14 1009 1011 -7 0 1008 1009 1011 -34 0 1000 1001 -3 1002 1003 -6 0 1004 1005 -6 1006 1007 -6 0 -3 44 -120 0 1569 0 1000 1001 -8 1002 1003 -9 0 1000 1001 -11 1002 1034 -20 1009 1069 1070 1065 1066 1002 1003 -30 0 1000 1002 1063 1064 1067 -18 1009 1011 -4 0 1008 -13 1009 1017 1019 -9 0 1723 -6 1725 1726 -21 0 1008 -14 1009 1015 -7 0 1008 1009 1035 -2 1002 1061 -21 0 1060 -9 1002 1036 1005 -3 1006 1007 -6 0 1008 -7 1009 1015 -5 0 1000 1001 -2 1002 1003 -72 0 -2 83 102 83 -32 0 1000 1001 -8 1002 0 1572 1002 1036 1005 -7 1006 1005 1007 -9 0 1004 -2 1005 -10 1006 1040 1013 -21 1009 1069 1070 1006 1007 -4 0 -4 44 -7 0 1569 -6 0 -4 44 -4 0 1004 1006 1067 1068 -9 1009 1014 -7 1009 1013 1009 1011 -4 0 1008 -12 1009 1019 -8 0 1723 -2 1725 1817 -6 1009 1820 -19 0 1723 1725 1817 -14 1009 1011 -7 0 1008 1009 1041 -2 1006 1065 1066 1061 -17 0 1060 1063 1064 -9 1006 1040 -4 1009 1011 -6 0 1008 -7 1009 1011 -5 0 1004 1005 -2 1006 1007 -108 0 1004 1005 -11 1006 1040 -9 1009 1011 -9 0 1016 -37 1009 1010 1011 -3 0 1000 1001 -3 1002 1003 -3 0 1000 -2 0 1572 1002 1003 -3 0 1000 1001 -3 1002 1003 -3 0 1008 -22 1009 1011 -4 0 1016 -11 1017 1019 -5 0 1723 -3 1725 1817 -9 1009 1011 -4 0 1723 -2 1724 -12 1725 1817 -16 1009 1015 -7 0 1008 -4 1009 1069 1070 1065 1066 1061 -13 0 1060 1063 1064 1067 -15 1009 1015 -6 0 1008 -7 1009 1015 -5 0 1008 -3 1009 1011 -5 0 1000 1001 -32 1002 -69 0 1008 -22 1009 1011 -6 0 102 83 -2 0 1012 -30 1009 1013 -3 1009 1013 -2 1009 1011 -3 0 1004 1005 -3 1006 1007 -3 0 1004 1005 -3 1006 1007 -3 0 1004 1005 -3 1006 1007 -3 0 1012 1013 1014 -9 1009 1014 -8 1009 1013 1009 1011 -21 0 1723 1817 -13 1009 1011 -4 0 1817 -24 1009 1014 -6 1009 1011 -7 0 1008 -6 1009 1069 1070 1065 1066 1061 -9 0 1060 1063 1064 1067 1068 -16 1009 1011 -6 0 1012 -7 1009 1011 -5 0 1008 -3 1009 1015 -5 0 1004 1005 -32 1006 -31 0 1060 -6 1002 1061 -7 0 317 318 -7 0 1000 1001 -12 1002 1034 -14 1009 1020 -3 1021 1022 -3 1009 1035 1001 -2 1002 1003 -6 0 1008 -37 1009 1011 -3 0 1008 -4 1009 1011 -3 0 1008 -4 1009 1011 -3 0 1008 -4 1009 1011 -3 0 1008 -22 1009 1011 -19 0 1723 1725 1817 -14 1009 1015 -4 0 1012 -31 1009 1015 -7 0 1008 -8 1009 1069 1070 1065 1066 1003 -5 0 1000 1063 1064 1067 -19 1009 1015 -6 0 1008 -2 1009 1014 -4 1009 1015 -5 0 1008 -3 1009 1011 -5 0 1008 -33 1009 -29 0 1060 1063 1064 -6 1006 1065 1066 -6 1002 319 320 1003 -6 0 1004 1005 -12 1006 1040 -12 1009 1014 1009 1023 -3 1024 1031 1021 1022 1009 1041 1005 -2 1006 1007 -6 0 1012 -29 1009 1014 1013 1014 -2 1009 1014 -2 1009 1011 -3 0 1012 -4 1009 1011 -3 0 1012 -4 1009 1011 -3 0 1012 -4 1009 1011 -3 0 1012 -2 1009 1010 -19 1009 1820 1726 -8 0 -10 1724 1817 -16 1009 1011 -4 0 1012 -15 1009 1014 -15 1009 1011 -7 0 1008 -10 1009 1069 1070 1007 -5 0 1004 1067 1068 -20 1009 1011 -6 0 1012 -7 1009 1011 -5 0 1008 -3 1009 1015 -5 0 1012 -33 1009 -22 0 1060 -5 1002 1063 1064 1067 1068 -6 1009 1069 1070 -7 1006 1005 1007 0 -4 44 0 1008 -28 1009 1026 1027 1030 -3 1024 1025 -5 1009 1011 0 -4 44 0 1008 -37 1009 1011 -3 0 1012 1009 1014 -2 1009 1011 -3 0 1012 -4 1009 1011 -3 0 1012 -4 1009 1011 -3 0 1012 1014 -18 1009 1013 -3 1009 1820 1724 1725 -6 1724 1817 -10 1009 -5 1013 -11 1009 1011 -4 0 1012 -31 1009 1015 -7 0 1008 -12 1009 1015 -5 0 1012 -16 1009 1014 -5 1009 1015 -6 0 1008 -7 1009 1015 -5 0 1008 -3 1009 1011 -5 0 1012 -33 1009 -21 1002 1063 1064 -5 1006 1067 1068 -9 1009 1014 -8 1009 1035 -6 1002 1034 -30 1009 1026 -3 1027 1028 -5 1009 1035 1001 -5 1002 1034 -29 1009 1014 -3 1009 1014 -3 1009 1011 -3 0 1008 1009 1013 -2 1009 1011 -3 0 1008 1009 1013 -2 1009 1011 -3 0 1008 1009 1013 -2 1009 1011 -3 0 1008 -28 1009 -2 1013 -10 1009 1013 -6 1009 1013 -11 1009 1015 -4 0 1008 -8 1009 1014 -22 1009 1011 -7 0 1008 -12 1009 1011 -5 0 1012 -22 1009 1011 -6 0 1012 -7 1009 1011 -5 0 1008 -3 1009 1015 -5 0 1008 -14 1009 1014 -18 1009 -21 1006 1067 1068 -6 1009 1069 -18 1009 1041 -6 1006 1040 -40 1009 1041 1005 -5 1006 1040 -13 1009 1014 -23 1009 1011 -3 0 1012 1014 -3 1009 1011 -3 0 1012 1014 -3 1009 1011 -3 0 1012 1014 -3 1009 1011 -3 0 1008 -13 1009 1014 1009 1014 1013 1014 -12 1009 1013 -6 1009 1013 -6 1009 1013 -6 1009 1013 -7 1009 1011 -4 0 1008 -17 1009 1013 -13 1009 1015 -7 0 1008 -7 1009 1014 -4 1009 1015 -5 0 1008 -22 1009 1015 -6 0 1012 -7 1009 1015 -5 0 1008 -2 1009 1014 1011 -5 0 1012 -25 1009 1014 -144 1009 1014 -3 1009 1011 -3 0 1012 -2 1009 1013 1014 1011 -3 0 1012 -2 1009 1013 1014 1011 -3 0 1012 1009 1014 1013 1014 1011 -3 0 1012 -18 1009 1014 1013 1009 1014 -6 1009 1020 1021 1022 -6 1009 1013 -6 1009 1013 -3 1009 1014 -2 1009 1013 -7 1009 1015 -4 0 1012 -31 1009 1011 -7 0 1008 -12 1009 1011 -5 0 1012 1013 -21 1009 1011 -6 0 1008 -7 1009 1011 -5 0 1008 -3 1009 1015 -5 0 1012 -4 1009 1014 -169 1009 1011 -3 0 1012 -4 1009 1011 -3 0 1012 -4 1009 1015 -3 0 1012 -4 1009 1015 -3 0 1008 -3 1009 1013 1014 1009 1014 1009 1013 -2 1009 1013 -16 1009 1023 1024 1025 -28 1009 1011 -4 0 1012 -19 1009 1014 -11 1009 1015 -7 0 1008 -12 1009 1015 -5 0 1008 -22 1009 1015 -6 0 1012 -7 1009 1015 -5 0 1008 -3 1009 1011 -5 0 1008 -174 1009 1011 -3 0 1012 -4 1009 1011 -3 0 1012 -4 1009 1015 -3 0 1012 -4 1009 1015 -3 0 1008 -3 1009 1013 1014 1009 1014 1009 1013 -2 1009 1013 -16 1009 1026 1027 1028 -28 1009 1015 -4 0 1012 -31 1009 1011 -7 0 1008 -12 1009 1011 -5 0 1012 1013 -21 1009 1011 -6 0 1012 -7 1009 1011 -5 0 1008 -3 1009 1015 -5 0 1012 -20 1009 1014 -153 1009 1011 -3 0 1012 -4 1009 1011 -3 0 1012 -4 1009 1015 -3 0 1012 -4 1009 1015 -3 0 1008 -3 1009 1013 1014 1009 1014 1009 1013 -2 1009 1013 -17 1009 1013 -6 1009 1013 -6 1009 1013 -6 1009 1013 -8 1009 1011 -4 0 1012 -31 1009 1015 -7 0 1008 -12 1009 1015 -5 0 1008 -22 1009 1015 -6 0 1008 -7 1009 1015 -5 0 1008 -3 1009 1011 -5 0 1016 -33 1009)
    )
    (tilemap
      (solid #f)
      (z-pos 100)
      (name "Foreground")
      (width 384)
      (height 64)
      (tiles -17018 0 1419 -383 0 1420 -382 0 -3 1002 -381 0 -2 1006 -1876 0 -3 1002 -1500 0 -2 1002 -3024 0)
    )
    (tilemap
      (solid #f)
      (z-pos -10)
      (name "DecorationBack")
      (width 384)
      (height 64)
      (tiles -12530 0 416 417 -382 0 420 421 -366 0 1936 1937 -382 0 1940 1941 -2253 0 1190 -104 0 1942 -278 0 1196 -104 0 1946 -278 0 1202 -383 0 1208 -383 0 1214 -71 0 1942 -377 0 402 403 404 405 -2 0 1946 -377 0 406 407 408 409 -45 0 1939 -313 0 323 324 -8 0 1945 -10 0 410 411 412 413 402 403 404 405 -41 0 1943 -313 0 325 326 -8 0 1949 -6 0 1950 1951 -2 0 414 415 416 417 406 407 408 409 -41 0 1947 -307 0 1942 -5 0 327 328 -15 0 402 403 404 405 410 411 426 427 428 429 420 421 -349 0 1946 -5 0 329 330 -15 0 406 407 408 409 414 415 430 431 432 433 424 425 -345 0 1950 1951 -8 0 402 403 404 405 -13 0 410 411 426 427 428 429 442 443 444 445 412 413 -333 0 323 324 -10 0 1954 1955 -8 0 406 407 408 409 -13 0 414 415 430 431 432 433 446 447 448 449 416 417 -77 0 1942 -255 0 325 326 -126 0 1946 -148 0 360 -7 0 402 403 404 -96 0 327 328 -10 0 402 403 404 405 360 -268 0 406 407 408 -96 0 329 330 -10 0 406 407 408 409 -269 0 410 411 412 -100 0 322 -191 0 405 -88 0 414 415 416 -2200 0)
    )
    (tilemap
      (solid #f)
      (z-pos 10)
      (name "DecorationFront")
      (width 384)
      (height 64)
      (tiles -12902 0 1938 -375 0 1953 -3 0 1936 1937 -32 0 1942 -349 0 1940 1941 -17 0 1938 -14 0 1946 -717 0 1938 -1636 0 1953 -1484 0 1938 -334 0 1953 -84 0 1938 -1035 0 1938 -384 0 1939 -382 0 1953 1943 -309 0 1953 -20 0 1953 -52 0 1947 -10 0 1938 -71 0 1953 -188 0 1945 -19 0 1942 -363 0 1949 -19 0 1946 -67 0 1953 -156 0 1953 -48 0 1950 1951 -13 0 1944 -93 0 1953 -190 0 1938 -63 0 1938 -19 0 1954 1955 -13 0 1948 -84 0 1953 -261 0 1953 -14 0 1938 -21 0 1952 -162 0 1953 -66 0 1953 -221 0 1938 -68 0 1938 -120 0 1953 -49 0 1953 -65 0 1953 -16 0 1950 1951 -8 0 1953 -13 0 1945 -10 0 1953 -13 0 1950 1951 -133 0 1953 -199 0 1954 1955 -22 0 1949 -24 0 1954 1955 -258 0 1938 -20 0 1938 -48 0 1938 -12 0 1938 -39 0 1938 -27 0 1938 -142 0 1938 -264 0 1953 -301 0 1953 -364 0)
    )
    (viciousivy
      (z-pos 50)
      (direction "left")
      (x 1410)
      (y 1796)
      (glinting #f)
    )
    (viciousivy
      (z-pos 50)
      (direction "left")
      (x 2338)
      (y 1668)
      (glinting #f)
    )
    (viciousivy
      (z-pos 50)
      (direction "left")
      (x 3586)
      (y 1636)
      (glinting #f)
    )
    (viciousivy
      (z-pos 50)
      (direction "left")
      (x 6210)
      (y 1476)
      (glinting #f)
    )
    (viciousivy
      (z-pos 50)
      (direction "left")
      (x 7330)
      (y 1636)
      (glinting #f)
    )
    (viciousivy
      (z-pos 50)
      (direction "left")
      (x 9698)
      (y 1316)
      (glinting #f)
    )
    (viciousivy
      (z-pos 50)
      (direction "left")
      (x 10082)
      (y 1604)
      (glinting #f)
    )
    (viciousivy
      (z-pos 50)
      (direction "left")
      (x 11744)
      (y 1696)
      (glinting #f)
    )
  )
)
