(supertux-level
  (version 3)
  (name (_ "Forest Ball"))
  (author "Vaesea")
  (license "CC-BY-SA 4.0 International")
  (allow-item-pocket "on")
  (icon "")
  (icon-locked "")
  (sector
    (name "main")
    (ambient-light
      (color 1 1 1)
    )
    (decal
      (z-pos 2)
      (sprite "/images/worldmap/shared/tower.png")
      (x 1664)
      (y 1056)
    )
    (level
      (z-pos 50)
      (level "welcoming_forest.stl")
      (x 24)
      (y 66)
    )
    (level
      (z-pos 50)
      (x 20)
      (y 61)
    )
    (level
      (z-pos 50)
      (x 20)
      (y 71)
    )
    (level
      (z-pos 50)
      (x 26)
      (y 74)
    )
    (level
      (z-pos 50)
      (x 26)
      (y 58)
    )
    (level
      (z-pos 50)
      (level "climbing_vines.stl")
      (x 28)
      (y 62)
    )
    (level
      (z-pos 50)
      (level "island_trees.stl")
      (x 29)
      (y 70)
    )
    (level
      (z-pos 50)
      (x 33)
      (y 68)
    )
    (level
      (z-pos 50)
      (x 33)
      (y 64)
    )
    (level
      (z-pos 50)
      (level "to_sky.stl")
      (x 33)
      (y 60)
    )
    (level
      (z-pos 50)
      (x 33)
      (y 72)
    )
    (level
      (z-pos 50)
      (level "granito_abode.stl")
      (x 39)
      (y 66)
    )
    (level
      (z-pos 50)
      (level "dark_cave.stl")
      (x 43)
      (y 66)
    )
    (level
      (z-pos 50)
      (x 48)
      (y 64)
    )
    (level
      (z-pos 50)
      (x 48)
      (y 68)
    )
    (level
      (z-pos 50)
      (x 53)
      (y 66)
    )
    (level
      (z-pos 50)
      (level "wallstone.stl")
      (x 61)
      (y 66)
    )
    (level
      (z-pos 50)
      (x 95)
      (y 62)
    )
    (level
      (z-pos 50)
      (level "welcome_ghost_forest.stl")
      (x 72)
      (y 66)
    )
    (level
      (z-pos 50)
      (x 83)
      (y 64)
    )
    (level
      (z-pos 50)
      (level "ghostly_skulls.stl")
      (x 89)
      (y 59)
    )
    (level
      (z-pos 50)
      (x 91)
      (y 54)
    )
    (level
      (z-pos 50)
      (x 87)
      (y 44)
    )
    (level
      (z-pos 50)
      (x 77)
      (y 42)
    )
    (level
      (z-pos 50)
      (x 67)
      (y 40)
    )
    (level
      (z-pos 50)
      (x 53)
      (y 37)
    )
    (level
      (z-pos 50)
      (x 74)
      (y 40)
    )
    (level
      (z-pos 50)
      (x 83)
      (y 43)
    )
    (level
      (z-pos 50)
      (level "forest_intro.stl")
      (auto-play #t)
      (x 17)
      (y 66)
    )
    (level
      (z-pos 50)
      (level "ghost_tree.stl")
      (sprite "/images/worldmap/common/shroom.sprite")
      (x 46)
      (y 37)
    )
    (music
      (file "/music/forest/forestmap.music")
    )
    (special-tile
      (z-pos 50)
      (blocking #f)
      (map-message (_ "Tropical Island will be added soon!"))
      (passive-message #t)
      (sprite "/images/worldmap/common/invisible.png")
      (x 43)
      (y 37)
    )
    (teleporter
      (z-pos 50)
      (worldmap "/levels/world1/worldmap.stwm")
      (spawnpoint "back")
      (message (_ "Go back to Icy Island?"))
      (x 14)
      (y 66)
    )
    (tilemap
      (solid #f)
      (z-pos 0)
      (width 100)
      (height 100)
      (tiles -3465 9 654 -18 655 656 -59 9 654 -20 655 633 -2 559 1807 1808 -3 559 1809 559 766 1800 766 1801 1802 1803 1804 1805 1806 614 656 -58 9 649 -4 559 766 559 766 -3 559 766 559 1809 -5 559 1807 1808 -3 559 1816 1817 -3 559 1818 559 771 766 771 1810 1811 1812 1813 1814 1815 559 614 656 -57 9 649 -4 559 771 766 771 -3 559 771 766 1818 -2 559 1863 -2 559 1816 1817 -3 559 1825 1826 -5 559 1863 771 559 1819 1820 1821 1822 1823 1824 559 766 614 656 -56 9 649 -5 559 771 -2 559 766 -2 559 771 -6 559 1825 1826 -3 559 1834 1835 -5 559 766 559 1827 1828 1829 1830 1831 1832 1833 559 771 559 614 656 -55 9 649 -7 559 766 771 766 -5 559 766 -2 559 1834 1835 -3 559 1843 1844 -5 559 771 559 1836 1837 1838 1839 1840 1841 1842 766 -3 559 614 656 -54 9 649 -6 559 766 771 766 771 766 -3 559 766 771 766 559 1843 1844 -12 559 1845 1846 1847 1848 1849 -2 559 771 -2 559 1809 559 614 656 -53 9 649 559 1809 -4 559 771 766 771 766 771 -2 559 766 771 766 771 -4 559 766 -6 559 561 562 563 559 1854 1855 1856 1857 1841 -5 559 1818 -2 559 614 656 -52 9 649 559 1818 -5 559 771 559 771 -3 559 771 766 771 559 1864 -2 559 766 771 766 -3 559 568 569 570 571 572 573 -6 559 1864 -7 559 614 656 -51 9 648 -11 594 606 -2 559 771 -5 559 771 766 771 -2 559 1864 577 578 579 580 581 582 -3 559 766 -4 559 1807 1808 -5 559 614 656 -62 9 648 -5 594 606 -3 559 771 -2 559 766 559 586 587 588 589 590 591 592 -2 559 771 -2 559 766 559 1816 1817 -6 559 614 656 -67 9 648 606 -3 559 1809 766 771 766 -3 559 598 599 600 601 602 -4 559 771 559 1825 1826 -7 559 614 656 -67 9 648 606 -2 559 1818 771 766 771 766 -2 559 607 608 609 610 611 -2 559 766 -3 559 1834 1835 559 1864 559 -2 1864 -3 559 614 656 -67 9 648 606 -3 559 771 559 771 -2 559 616 617 618 -4 559 771 -3 559 1843 1844 1921 559 1863 -4 559 766 559 614 656 -67 9 648 -17 594 606 -10 559 771 -2 559 652 -85 9 648 606 -9 559 766 -2 559 652 -86 9 648 606 -2 559 1864 -2 559 766 -2 559 771 -2 559 652 -87 9 649 -5 559 771 -5 559 652 -87 9 649 -2 559 766 -5 559 1863 -2 559 652 -87 9 649 559 766 771 766 -7 559 652 -87 9 649 766 771 1809 771 766 559 1863 559 1807 1808 559 652 -87 9 649 771 766 1818 766 771 559 766 559 1816 1817 559 652 -20 9 794 -33 804 795 -32 9 649 766 771 766 771 -2 559 771 559 1825 1826 559 652 -19 9 794 839 888 845 897 888 845 897 888 845 897 888 845 897 888 845 897 888 845 565 566 845 897 888 845 897 888 845 897 888 845 897 888 845 897 800 -32 9 649 771 766 771 -2 559 766 -2 559 1834 1835 559 652 -18 9 794 839 845 816 817 845 816 817 845 816 817 845 816 817 845 816 817 845 816 817 574 575 817 845 871 872 873 874 875 876 877 878 845 816 817 845 838 804 795 -30 9 649 766 771 -3 559 771 -2 559 1843 1844 559 652 -17 9 794 839 897 845 888 897 845 565 566 845 888 897 845 888 897 845 888 897 845 888 897 583 584 897 845 880 881 882 883 884 885 886 887 845 888 897 845 888 897 800 -30 9 649 771 -6 559 1863 -3 559 652 -17 9 791 888 845 897 888 845 897 574 575 897 888 845 897 888 845 897 888 845 897 888 845 897 888 845 897 889 890 891 892 893 894 895 896 897 888 845 897 888 845 838 804 795 -15 9 654 -12 655 633 559 1864 -9 559 652 -17 9 791 816 817 845 816 817 845 583 584 845 816 817 845 816 817 845 816 817 845 816 817 845 816 817 845 898 899 900 901 902 903 904 905 845 816 817 845 565 566 845 816 800 -14 9 654 633 -2 559 1807 1808 559 766 -3 559 766 559 766 -3 559 -2 564 559 561 562 563 564 -2 559 652 -17 9 791 888 897 845 888 897 845 888 -2 897 888 -2 845 888 897 845 888 897 845 888 897 845 888 897 -2 845 907 908 909 910 911 912 913 845 888 897 845 574 575 845 888 838 795 -12 9 654 633 559 1809 559 1816 1817 766 771 766 -2 559 771 766 771 766 -2 564 559 564 569 570 571 572 573 -2 559 652 -17 9 791 888 845 897 888 845 897 888 -2 845 816 817 897 888 845 897 888 845 897 888 845 897 888 845 897 888 845 897 565 566 897 888 845 897 888 845 897 583 584 897 888 845 800 -11 9 654 633 -2 559 1818 559 1825 1826 771 766 771 -3 559 771 559 771 564 -2 559 577 578 579 580 581 582 -2 559 652 -17 9 791 816 817 845 816 817 845 816 817 845 888 897 845 816 817 845 816 817 845 816 817 845 816 817 845 816 817 845 574 575 845 816 817 845 816 817 845 816 817 845 816 817 838 -9 804 -2 655 633 -5 559 1834 1835 559 771 -6 559 564 -3 559 586 587 588 589 590 591 592 559 652 -17 9 791 888 897 845 888 897 845 888 897 845 888 897 845 888 897 845 888 897 845 888 565 566 888 897 845 888 897 845 583 584 845 888 897 845 888 897 845 888 897 845 888 897 845 888 897 845 888 897 845 -3 888 -8 559 1843 1844 1800 1801 1802 1803 1804 1805 1806 564 559 766 559 766 -3 559 598 599 600 601 602 652 -17 9 791 888 845 897 888 845 897 888 845 897 888 845 897 888 845 897 888 845 897 888 574 575 888 845 897 888 845 897 888 845 897 888 845 897 888 845 897 888 845 897 888 845 897 888 845 897 888 845 897 -3 888 -11 559 1810 1811 1812 1813 1814 1815 559 766 771 766 771 766 -2 559 607 608 609 610 611 652 -17 9 791 817 845 816 817 845 816 817 845 816 817 -2 845 816 817 845 816 817 845 816 583 584 816 817 845 816 817 845 816 817 845 816 817 845 816 817 845 816 817 845 816 817 845 816 817 845 816 817 845 -3 816 -7 559 766 -3 559 1819 1820 1821 1822 1823 1824 766 771 766 771 766 771 -2 559 766 617 618 -2 559 652 -17 9 791 897 565 566 897 845 888 897 845 888 897 -2 845 888 897 845 888 897 845 888 897 845 888 897 845 888 897 845 888 897 845 888 897 845 888 897 845 888 565 566 888 897 809 -9 801 -2 594 606 -4 559 771 766 559 1827 1828 1829 1830 1831 1832 1833 771 766 771 766 771 -2 559 766 771 766 -3 559 652 -17 9 791 845 574 575 845 897 888 845 897 888 845 -2 897 888 845 897 888 845 897 888 845 897 888 845 897 888 845 897 888 845 897 888 845 897 888 845 897 888 574 575 888 845 800 -11 9 648 606 -2 559 -2 766 771 559 1836 1837 1838 1839 1840 1841 1842 1809 771 559 771 559 1864 766 771 766 771 766 -2 559 652 -17 9 791 817 583 584 817 845 816 817 845 816 817 -2 845 816 817 845 816 817 845 816 817 845 816 817 845 816 817 845 816 817 871 872 873 874 875 876 877 878 583 584 816 809 801 -12 9 648 606 559 -2 771 -2 559 1845 1846 1847 1848 1849 -2 559 1818 -3 559 1863 559 771 766 771 559 771 559 615 653 -17 9 791 897 845 888 897 845 888 897 845 888 897 -2 845 888 897 845 888 897 845 888 897 845 888 897 845 888 897 845 888 897 880 881 882 883 884 885 886 887 897 845 888 800 -14 9 648 606 -4 559 1854 1855 1856 1857 1841 -6 559 1864 -2 559 771 -3 559 615 653 -18 9 791 845 897 888 845 897 888 845 897 888 845 -2 897 888 845 897 888 845 897 888 845 897 888 845 897 888 845 897 888 845 889 890 891 892 893 894 895 896 845 897 809 801 -15 9 648 -22 594 653 -19 9 791 817 845 816 817 845 816 817 845 816 817 -2 845 816 817 845 816 817 845 816 817 845 816 817 845 565 566 845 816 817 898 899 900 901 902 903 904 905 817 845 800 -59 9 791 897 845 888 897 845 888 897 845 888 897 -2 845 888 897 845 888 897 845 888 897 845 888 897 845 574 575 845 888 897 845 907 908 909 910 911 912 913 809 801 793 -59 9 792 818 897 888 845 897 888 845 897 888 845 -2 897 888 845 897 888 845 897 888 845 897 888 845 897 583 584 897 888 845 897 888 845 897 888 845 897 888 800 -62 9 791 845 816 817 565 566 817 845 816 817 -2 845 816 817 845 816 817 845 816 817 845 565 566 845 816 817 845 816 817 845 809 -6 801 793 -62 9 791 845 888 897 574 575 897 845 888 897 -2 845 888 897 845 888 565 566 888 897 845 574 575 845 888 897 845 888 897 809 793 -69 9 792 818 888 845 583 584 845 897 888 845 -2 897 888 845 897 888 574 575 888 845 897 583 584 897 888 845 897 888 809 793 -71 9 791 816 817 845 816 817 845 816 817 -2 845 816 817 845 816 583 584 816 817 845 816 817 845 816 817 845 809 793 -72 9 792 818 897 845 888 897 845 888 897 -2 845 888 897 845 888 897 845 888 897 845 888 897 845 888 897 809 793 -74 9 792 -23 801 793 -738 9 -5 558 -2 9 -4 558 -89 9 558 -6 9 558 -3 9 558 -88 9 558 -6 9 558 -3 9 558 -88 9 -5 558 -2 9 -4 558 -93 9 558 -2 9 558 -3 9 558 -92 9 558 -2 9 558 -3 9 558 -88 9 -5 558 -2 9 -4 558 -508 9)
    )
    (tilemap
      (solid #t)
      (z-pos 1)
      (width 100)
      (height 100)
      (tiles -3743 0 2064 2065 -3 2020 2011 -3 0 2010 2020 2011 -93 0 2014 2011 0 2010 2015 0 2014 2011 -2 0 2010 -2 2020 2011 -87 0 2014 2020 2015 -3 0 2014 -2 2020 2015 -2 0 2014 2011 -99 0 2021 -2 0 2010 -10 2020 2011 -85 0 2014 -2 2020 2015 -10 0 2021 -99 0 2014 -5 2020 2011 0 2010 -2 2020 2011 -94 0 2014 2020 2015 -2 0 2021 -99 0 2021 -99 0 2021 -99 0 2021 -99 0 2014 2011 -99 0 2021 -99 0 2014 2011 -99 0 2021 -99 0 2014 2011 -99 0 2014 2011 -99 0 2021 -99 0 2021 -27 0 820 0 819 -2 0 819 0 819 -8 0 820 -55 0 2021 -27 0 829 0 828 0 819 828 819 828 819 820 -6 0 829 -7 0 820 -46 0 2010 2015 -27 0 819 -3 0 828 0 828 0 828 829 -6 0 819 -7 0 829 -46 0 2021 -26 0 820 819 828 2010 -12 2020 2011 819 828 -3 0 819 -10 0 820 -2 0 843 844 -34 0 2010 2015 -25 0 819 829 828 819 2021 -6 0 819 0 819 0 819 0 2021 828 -4 0 828 -10 0 829 -2 0 852 853 -34 0 2032 2040 2031 -24 0 828 0 819 828 2021 -4 0 819 0 828 819 828 819 828 819 2012 -5 2020 2011 819 0 819 -7 0 843 844 0 861 862 843 844 -32 0 2021 0 2034 -2 2040 2031 -22 0 819 828 819 2021 -4 0 828 -2 0 828 0 828 0 828 2021 -3 0 819 0 2021 828 0 828 0 819 -2 0 819 0 820 852 853 -3 0 852 853 -30 0 2010 2020 2015 -4 0 2034 2031 -20 0 820 828 819 828 2021 -3 0 2010 -8 2020 2017 819 -2 0 828 0 2021 -4 0 828 0 819 828 819 829 861 862 -3 0 861 862 -30 0 2021 -7 0 2042 -20 0 829 819 828 819 2021 -3 0 2021 0 819 846 847 848 849 850 851 2021 828 -4 0 2021 0 819 -4 0 828 0 828 -2 0 843 844 -2 0 820 -31 0 2021 -28 0 819 828 820 828 2014 -3 2020 2017 819 828 855 856 857 858 859 860 2012 -5 2020 2017 819 828 -3 0 819 2010 -3 2020 2011 852 853 820 819 829 -23 0 2010 -7 2020 2015 -28 0 828 0 829 -5 0 2021 828 819 864 865 866 867 868 869 2021 -5 0 2021 828 -4 0 828 2021 0 820 0 2021 861 862 829 828 -23 0 2010 2015 -34 0 2064 2065 -8 2020 2017 0 828 0 819 820 -3 0 2021 -5 0 2012 -6 2020 2017 819 829 819 2012 -27 2020 2015 -40 0 819 -4 0 2021 0 820 819 828 829 0 820 0 2021 -5 0 2021 -3 0 819 -2 0 2021 828 0 828 2021 843 844 -3 0 819 -59 0 820 -2 0 828 2010 -3 2020 2017 819 829 828 -3 0 829 0 2012 -5 2020 2017 0 820 0 828 -2 0 2014 -3 2020 2015 852 853 -2 0 819 828 -59 0 829 -3 0 2021 820 -2 0 2021 828 -7 0 2021 0 843 844 -2 0 2021 0 829 -9 0 861 862 -2 0 828 -64 0 2021 829 -2 0 2014 -8 2020 2017 0 852 853 -2 0 2021 -4 0 820 -72 0 819 -2 0 2021 0 843 844 0 843 844 0 843 844 0 843 844 2021 0 861 862 -2 0 2021 819 0 820 0 829 -71 0 819 828 -2 0 2021 0 852 853 819 852 853 820 852 853 819 852 853 2012 -5 2020 2015 828 0 829 -73 0 828 0 820 0 2021 0 861 862 828 861 862 829 861 862 828 861 862 2021 843 844 -6 0 843 844 -74 0 829 819 2014 -12 2020 2015 852 853 0 819 -4 0 852 853 -75 0 828 -2 0 843 844 846 847 848 849 850 851 -4 0 861 862 0 828 -4 0 861 862 843 844 -72 0 820 -3 0 852 853 855 856 857 858 859 860 -14 0 852 853 -72 0 829 819 -2 0 861 862 864 865 866 867 868 869 -5 0 820 -4 0 843 844 -2 0 861 862 -73 0 828 -10 0 820 -4 0 829 -4 0 852 853 -77 0 819 0 819 -2 0 820 -5 0 829 -9 0 861 862 -77 0 828 0 828 -2 0 829 -1975 0)
    )
    (tilemap
      (solid #f)
      (z-pos 2)
      (width 100)
      (height 100)
      (tiles -5989 0 2021 -4010 0)
    )
    (worldmap-spawnpoint
      (z-pos 50)
      (name "main")
      (x 15)
      (y 66)
    )
  )
  (tileset "images/worldmap.strf")
)
