(supertux-level
  (version 3)
  (name (_ "Mountain Of Snow"))
  (author "Sophie \"Vaesea\" Ball")
  (license "CC-BY-SA 4.0 International")
  (allow-item-pocket "inherit")
  (icon "")
  (icon-locked "")
  (statistics
    (enable-coins #t)
    (enable-secrets #t)
  )
  (sector
    (name "main")
    (ambient-light
      (color 1 1 1)
    )
    (background
      (color 1 1 1)
      (speed 0.5)
      (image-top "/images/background/bluemountain-top.png")
      (image "/images/background/bluemountain-middle.png")
      (image-bottom "/images/background/bluemountain-bottom.png")
    )
    (background
      (scroll-offset-x 960)
      (scroll-offset-y 672)
      (color 1 1 1)
      (speed 1.5)
      (image-top "/images/background/fog.png")
      (image "/images/background/fog.png")
      (image-bottom "/images/background/fog.png")
      (z-pos 300)
    )
    (bouncingsnowball
      (z-pos 50)
      (direction "left")
      (x 2528)
      (y 736)
      (glinting #f)
    )
    (bouncingsnowball
      (z-pos 50)
      (direction "left")
      (x 2432)
      (y 736)
      (glinting #f)
    )
    (camera
      (name "Camera")
      (mode "normal")
    )
    (goldbomb
      (z-pos 50)
      (direction "left")
      (x 1664)
      (y 800)
      (glinting #t)
    )
    (haywire
      (z-pos 50)
      (direction "left")
      (x 1792)
      (y 800)
      (glinting #f)
    )
    (mrbomb
      (z-pos 50)
      (direction "left")
      (x 1536)
      (y 800)
      (glinting #f)
    )
    (mrbomb
      (z-pos 50)
      (direction "left")
      (sprite "/images/creatures/mr_bomb/old/mr_bomb.sprite")
      (x 1408)
      (y 800)
      (glinting #f)
    )
    (mrbomb
      (z-pos 50)
      (direction "left")
      (sprite "/images/creatures/mr_bomb/old/mr_bomb.sprite")
      (x 3072)
      (y 768)
      (glinting #f)
    )
    (mrbomb
      (z-pos 50)
      (direction "left")
      (sprite "/images/creatures/mr_bomb/old/mr_bomb.sprite")
      (x 3040)
      (y 640)
      (glinting #f)
    )
    (mrbomb
      (z-pos 50)
      (direction "left")
      (sprite "/images/creatures/mr_bomb/old/mr_bomb.sprite")
      (x 3008)
      (y 512)
      (glinting #f)
    )
    (music
      (file "/music/forest/greatgigantic.music")
    )
    (particles-clouds
    )
    (snowball
      (z-pos 50)
      (direction "left")
      (x 3136)
      (y 896)
      (glinting #f)
    )
    (snowball
      (z-pos 50)
      (direction "left")
      (x 3040)
      (y 896)
      (glinting #f)
    )
    (snowball
      (z-pos 50)
      (direction "left")
      (x 2944)
      (y 896)
      (glinting #f)
    )
    (spawnpoint
      (name "main")
      (x 64)
      (y 832)
    )
    (tilemap
      (solid #f)
      (z-pos -100)
      (width 150)
      (height 35)
      (tiles -5250 0)
    )
    (tilemap
      (solid #f)
      (z-pos 100)
      (width 150)
      (height 35)
      (tiles -5250 0)
    )
    (tilemap
      (solid #t)
      (z-pos 0)
      (width 150)
      (height 35)
      (tiles -2274 0 7 9 -148 0 27 29 -66 0 202 -2 0 202 -146 0 47 -2 83 47 -227 0 202 -2 0 202 -146 0 47 -2 83 47 -64 0 7 9 -2 0 7 9 -144 0 27 29 83 102 27 29 -225 0 202 -4 0 202 -144 0 47 83 27 29 83 47 -35 0 2703 2704 2705 2706 2707 2704 2705 2706 2707 2704 2705 2706 2707 2704 2705 2706 2707 3318 -9 0 7 9 -4 0 7 9 -88 0 3317 2704 2705 2706 2707 2704 2705 2706 2707 2704 2705 2706 2707 2704 2705 2706 2707 2704 2705 2706 2707 2708 -5 0 2719 2720 2721 2722 2723 2720 2721 2722 2723 2720 2721 2722 2723 2720 2721 2722 2723 3326 3327 3328 -7 0 27 29 -4 83 27 29 -86 0 3323 3324 3325 2720 2721 2722 2723 2720 2721 2722 2723 2720 2721 2722 2723 2720 2721 2722 2723 2720 2721 2722 2723 2724 -5 0 2735 2736 2737 2738 2739 2736 2737 2738 2739 2736 2737 2738 2739 2736 2737 2738 2739 3337 3338 3339 3340 3318 -65 0 2703 2704 2705 2706 2707 2704 2705 2706 2707 2704 2705 2706 2707 2704 2705 2706 2707 2704 2705 2706 2707 3313 3314 3315 3314 3315 3314 3315 3316 2704 2705 2706 2707 3333 3334 3335 3336 2736 2737 2738 2739 2736 2737 2738 2739 2736 2737 2738 2739 2736 2737 2738 2739 2736 2737 2738 2739 2740 -5 0 2743 2744 2679 2680 2681 2682 2679 2680 2681 2682 2679 2680 2681 2682 2679 2680 2681 2682 3348 3349 3350 3326 3327 3328 -63 0 2719 2720 2721 2722 2723 2720 2721 2722 2723 2720 2721 2722 2723 2720 2721 2722 2723 2720 2721 2722 2723 3319 3320 3321 3320 3321 3320 3321 3322 2720 2721 2722 2723 3343 3344 3345 3346 2682 2679 2680 2681 2682 2679 2680 2679 2680 2681 2682 2681 2682 2679 2680 2681 2682 2679 2680 2749 2750 -5 0 2759 2760 2695 2696 2697 2698 2695 2696 2697 2698 2695 2696 2697 2698 2695 2696 2697 2698 2697 2696 2697 3337 3338 3339 3340 3313 3314 3315 3314 3315 3314 3315 3314 3315 3314 3315 3316 2708 -49 0 2735 2736 2737 2738 2739 2736 2737 2738 2739 2736 2737 2738 2739 2736 2737 2738 2739 2736 2737 2738 2739 2736 2737 2738 2739 2736 2737 2738 2739 2736 2737 2738 2739 2738 2739 2738 2739 2698 2695 2696 2697 2698 2695 2696 2695 2696 2697 2698 2697 2698 2695 2696 2697 2698 2695 2696 2765 2766 -5 0 2743 2744 2711 2712 2713 2714 2711 2712 2713 2714 2711 2712 2713 2714 2711 2712 2713 2714 2713 2712 2713 3347 3348 3349 3350 3319 3320 3321 3320 3321 3320 3321 3320 3321 3320 3321 3322 2724 -49 0 2743 2744 2679 2680 2681 2682 2679 2680 2681 2682 2679 2680 2681 2682 2679 2680 2681 2682 2679 2680 2681 2682 2679 2680 2681 2682 2679 2680 2681 2682 2679 2680 2681 2682 2679 2680 2681 2682 2679 2680 2681 2682 2679 2680 2679 2680 2681 2682 2681 2682 2679 2680 2681 2682 2679 2680 2749 2750 -5 0 2759 2760 2727 2728 2729 2730 2727 2728 2729 2730 2727 2728 2729 2730 2727 2728 2729 2730 2737 2738 2737 2738 2737 2738 2737 2736 2737 2738 2739 2736 2737 2738 2739 2736 2737 2738 2739 2740 -49 0 2759 2760 2695 2696 2697 2698 2695 2696 2697 2698 2695 2696 2697 2698 2695 2696 2697 2698 2695 2696 2697 2698 2695 2696 2697 2698 2695 2696 2697 2698 2695 2696 2697 2698 2695 2696 2697 2698 2695 2696 2697 2698 2695 2696 2695 2696 2697 2698 2697 2698 2695 2696 2697 2698 2695 2696 2765 2766 -5 0 2743 2744 2679 2680 2681 2682 2679 2680 2681 2682 2679 2680 2681 2682 2679 2680 2681 2682 2679 2680 2681 2682 2679 2680 2681 2682 2679 2680 2681 2682 2679 2680 2681 2682 2679 2680 2749 2750 -49 0 2743 2744 2711 2712 2713 2714 2711 2712 2713 2714 2711 2712 2713 2714 2711 2712 2713 2714 2711 2712 2713 2714 2711 2712 2713 2714 2711 2712 2713 2714 2711 2712 2713 2714 2711 2712 2713 2714 2711 2712 2713 2714 2711 2712 2711 2712 2713 2714 2713 2714 2711 2712 2713 2714 2711 2712 2749 2750 -5 0 2759 2760 2695 2696 2697 2698 2695 2696 2697 2698 2695 2696 2697 2698 2695 2696 2697 2698 2695 2696 2697 2698 2695 2696 2697 2698 2695 2696 2697 2698 2695 2696 2697 2698 2695 2696 2765 2766 -49 0 2759 2760 2727 2728 2729 2730 2727 2728 2729 2730 2727 2728 2729 2730 2727 2728 2729 2730 2727 2728 2729 2730 2727 2728 2729 2730 2727 2728 2729 2730 2727 2728 2729 2730 2727 2728 2729 2730 2727 2728 2729 2730 2727 2728 2727 2728 2729 2730 2729 2730 2727 2728 2729 2730 2727 2728 2765 2766 -5 0 2743 2744 2711 2712 2713 2714 2711 2712 2713 2714 2711 2712 2713 2714 2711 2712 2713 2714 2711 2712 2713 2714 2711 2712 2713 2714 2711 2712 2713 2714 2711 2712 2713 2714 2711 2712 2749 2750 -49 0 2743 2744 2711 2712 2713 2714 2711 2712 2713 2714 2711 2712 2713 2714 2711 2712 2713 2714 2711 2712 2713 2714 2711 2712 2713 2714 2711 2712 2713 2714 2711 2712 2713 2714 2711 2712 2713 2714 2711 2712 2713 2714 2711 2712 2711 2712 2713 2714 2713 2714 2711 2712 2713 2714 2711 2712 2749 2750 -5 0 2759 2760 2727 2728 2729 2730 2727 2728 2729 2730 2727 2728 2729 2730 2727 2728 2729 2730 2727 2728 2729 2730 2727 2728 2729 2730 2727 2728 2729 2730 2727 2728 2729 2730 2727 2728 2765 2766 -49 0)
    )
  )
)
